c: Arabi ayların kısaltmalarında Cemaziyel Evvel ayının kısaltılmış hali.
câ: Yer. Mekân. Mevki.
câ-yî behîştî: Cennet gibi yer.
câ-yî îştîbah: Tereddüt edilecek nokta.
câ-yî mülahaza: Düşünülecek nokta. Mülahaza edilecek mes'ele.
câ-yî penah: Sığınılacak yer.
câ-yî rahat: Rahat edilecek yer.
ca'ab: Bileyci.
caadet: Etli, semiz ve kıllı kişi. * Su kenarında biter bir ot. * Bir kabile adı.
caadet: Kıvırcıklık.
ca'am: Tama' etmek.
caar: Sırtlan.
ca'b: Kazmak. * Atmak.
ca'be: Ok torbası, sadak.
cabe: Bir cevap.
cabeca: Yer yer. Ara sıra. Yerden yere. Bazı yerlerde.
ca'ber(e): (C.: Ceâbir) Kısa boylu kimse.
cabet: Cevap vermek.
câbî: (Cibâyet. den) Eskiden Evkaf gelirlerini ve zekâtları toplayan tahsildar.
câbîr: Cebredici, zorla yaptıran.* Galib gelen. * şefkatsiz, merhametsiz. * Tekebbür ve taazzüm eden. * Aziz ve kavi olan. * Tıb: Kırıkçı, çıkıkçı. * Cebir ilminin ilk kurucusu olan müslüman âlimi.
câbîr-ül-ensarî: Câbir Bin Abdullah El-Ensari (R.A.) da denir. Meşhur sahabelerdendir. Bizzat Resul-i Ekrem'den (A.S.M.) ilim ve feyiz almış ve zamanında Medine-i Münevvere'nin müftüsü olmuştur. En çok hadis rivayetiyle meşhur olan altı sahabeden biridir. 1540 hadis rivayet etmiştir. 19 gazada hazır bulunmuştur. Hicri 73 tarihinde 94 yaşında Medine-i Münevvere'de vefât etmiştir. Akabe biatinde bulunan 70 Ensar'dan Medine'de en son vefat eden bu zattır.
cabîye: (C.: Cevâbi) Cemaat. * îçinde su toplanan büyük havuz. * şam diyarında bir şehir adı.
cablus: Dalkavukluk, yaltaklanma. * Dalkavukluk eden, yaltaklanan.
cablusî: Dalkavukluk, yaltaklanıcılık.
ca'ca': (C.: Ceâci) Taşsız yer. * Zindan.
ca'caa: Değirmen sesi. * îsteklerde zorluk vermek. * Devenin çökermesi. * çökmüş deveyi kaldırmak.
ca'cere: (C.: Ceâcir) Hamurdan çeşitli şekiller yapıp, pekmez içinde pişirip yerler.
cadd: (Câdde) Ciddi, çalışkan, azimli.
ca'd: Kıvırcık saç, şa're.
cadde: Geniş, işlek, büyük yol. Anayol. şah-rah.
cadde-î kübra: Büyük cadde. * Mc: En selâmetli yol. Kur'an yolu. Sahabe ve Peygamber vârisi olan büyük zatların, müçtehidlerin yolu.
cadi: Avrupa'da putperestlik çağından beri gelen bir inanca göre, şeytanın gücünü kullanarak büyü yolu ile insanlara kötülük eden, felâketler getiren kadın. Bu bâtıl inanç yüzünden birçok yaşlı masum kadın, cadı diye Hristiyanların kurduğu Engizisyon mahkemeleri kararıyla yakılmıştır.
cadî: Safran.
cadî: (C. Cüdât) Sâil, dilenci.
cadîb(e): Kusur görücü. Başkalarının noksan taraflarını gören.
cadîl: Gürbüz, kuvvetli, kavi, metin.
cadîs(e): Viran, harap, yıkık. * çorak, kurak, işlenmemiş, ekilmemiş toprak, gelir getirmeyen boş arazi.
cadu: Büyücü, cadı. * Hortlak, gulyabani. * Acuze, çirkin kocakarı. * çok güzel söz.
cadu-fenn: Büyücü, sihirbaz.
cadu-ger: Büyücü, sihirbaz.
cadu-suhen: Sihirlercesine söz söyleyen.
ca'f: Atmak, yere vurmak.
cafcaf: Ahlâksız, iffetsiz kadın.
ca'fer: Küçük akarsu, çay.
ca'ferî: şiilerden îmam-ı Ca'fer-i Sâdık Hazretlerine bağlı olduklarını iddia edenler.Bütün mânâsıyla îslâmiyet'e bağlı olup şeriatın emirlerine göre amel eden ve âl-i Beyt'in büyük bir dini şahsiyeti olan îmam-ı Ca'fer-i Sâdık Hazretlerine bağlılık iddiasının doğru olması için, o zat gibi olmağa ve Hz. Muhammed'in (A.S.M.) sünnetlerini yaşamağa gayret göstermek lâzımdır.
ca'fer-î sâdik: (Bak: îmam-ı Cafer-i Sâdık)CA'FERîYYE: Caferi tarikatı.
cafî: Cefa eden, eziyet veren.
cafîl: Yürürken çabuk olan kimse.
cafûn: Karpuz.
cager: Kuş kursağı.
cah: (Câhe) Makam, mansıb. Kadr, itibar.
cahan: Yediği fayda etmeyip geç büyüyen çocuk.
cahar: Kuyunun içinin geniş olması.
cahb: (C.: Echibe) Ebücehil karpuzu. * Korkudan dolayı kederli olmak.
cahcah: (C.: Cehâcih) Ulu, şerif kişi.
cahcaha: Gönlünde olan sırrını gizlemek. * çağırmak. * Su sesi.
cahd: Bile bile inkâr etme.
cahd-i mutlak, cahd-i müstağrak: Arab gramerinde menfi olan iki geniş zaman sigası. Muzari fiillerinin başına (Lem; $ ) ve (Len $) getirilerek olur.
cahdel: Semiz.
cahdem: (C.: Cehâdim) Ekin tarlası.
cahder: Kısa boylu.
cahf: Tekebbürlenmek, kibirlenmek, gururlanmak.
cahf: övünme, fahr. * şeref.
cahfel: Dudakları kalın olan kimse. * Asker. * Zenginlik.
cahfele: (C.: Cehâfil) At dudağı.
cahh: Ayakları uzun, yeşil çekirge.* Adamın beli bükülüp eğilmek.
câhiz: Asıl ismi Amr îbn-ül Bahr olan ve gözünün hadekası çıkık olduğu için bu isimle anılan büyük bir Arab edibi. * Patlak gözlü adam.
cahî: (Cahiye) Aşikar, aleni, açık, meydanda ve herkesin gözleri önünde olan.
cahîd: Mânen, kavlen, kalemen ve maddeten cihad eden. Mücâhid olan. Din düşmanı ile elinden geldiği kadar mânen, kavlen, kalemen ve maddeten cenkeden, vuruşan. Mümkün olduğu kadar gayretle çalışan. Kur'an ve îman hakikatlarının neşrinde çalışmak suretiyle mücahede eden.
cahîd: Bildiği halde inkâr eden. Ayak direyen.
cahîf: Kişinin kendi yanında olan şeylerin çokluğundan fahirlenmesi.
cahîf: Uykusunda dişini öttürmek. * çok fazla hafiflik üzerine olmak. * Nefis, ruh. * însanın karnından çıkan ses. * Kısa. * çok asker.
cahîl: Tecrübesiz. Bilgisiz. Genç. Toy. * Allah'ı unutmuş olan. Gafil. (Dünya ve kâinatta Allah'ın bunca eserleri sergilenip dururken bunların sanatkârını ve yaratıcısını tanımamak cahilliğin en akılsızcasıdır.)
cahîl-î anûd: înatçı cahil.
cahîlane: Câhillikle, câhilce, câhil kimseye yakışır şekilde.
cahîle: (C.: Cevâhil) Değirmen çarkı.
cahîlîyyet: Cahilliğe âit. * îslâmiyet'ten önceki câhiliye devrine âit. Cahiliyet sadece îslâmiyet öncesine ait değildir. Bu gün "tabiatçılık, maddecilik" gibi çeşitli adlarla eski puta tapıcılık daha da yobazlaşarak devam ediyor. Allah'ı inkâr ederken tabiatı ve maddeyi onun yerine koyarak kendilerine yeni putlar dikiyor ve kendi yaptıkları bu putlara kendileri tapıyor. (Bak: Yobaz.)
cahîm: çok sıcak yer.
cahîm: şiddetli ve kat kat birbiri üzerine yanan ateş. çukur yerde yanan ateş. * Cehennem'in bir tabakası.
cahîmî: Cehennem gibi.
cahîyen: Aşikâr olarak, alenen.
cahîz: Cesur, cesaretli, yiğit.
cahl: çekirge gibi bir büyük arı. * Büyük kırba. * Ters yuvarlayan bir böcek.
cahma': Gözleri büyük ve çok kırmızı olan kadın.
cahme: Nazar değdiren göz. * Kat kat ve şiddetli yanan ateş.
cahmerîş: (C.: Cehâmir) çok yaşlı kadın. * Eşek sıpası.
cahre: şiddet ve kıtlık yılı. * Yemek.
cahreme: Darlık. * Kötü ahlâk.
cahsuk: Orak.
cahş: (C.: Cihaş-Cuhşâ) Eşek sıpası. * Kolan eşeğinin erkeği.
cahşe: Eşek sıpasının dişisi. * çobanın eline dolayıp eğerdiği ip.
cahûd: (Cahd. dan) îsrarla inkâr eden. Muannidce, isnat edilen bir sözü kabul etmeyen. * Yahudi.
cahûf: Mağrur, kibirli, kendini beğenmiş.
cahzem: Gözleri büyük olan kimse.
caîbe: (C.: Cevâib) Halkın ağzında gezen haber.
caîl: Yapan, bir şey veren, kılan. * Yaratıcı. (Bak: Ca'l)
caîl: Cevelân eden. Yerinde durmayıp hareket eden.
caîr: Mâni, engel. * Eğri. * çok, kesir. * Eziyet eden. Cevreden. Zulmeden.
caîz: Mümkün, olur, olabilir. * Fık: Yapılması sahih ve mübah olan herhangi bir fiil veya akit.
caîze: (Cevaz. dan) (C.: Cevaiz) Azık, yol yiyeceği. * Hediye, armağan, bahşiş. * Edb: Eskiden takdim olunan medhiyeli bir şiire veya bir san'at eserine karşılık olarak verilen para, hediye ve bahşişler.
caka: (Argo) Gösteriş, çalım. Caka, mal mülk, giyim, kuşam, yahut hareket davranış yoluyla olabilir. îslâm'da gösterişin her şekli haram ve günahtır. Bugün bazı kimseler ve aileler gösteriş belâsı yüzünden maddi sıkıntılara düşmekte, israfa sürüklenmektedir. îşledikleri günahın cezasını bu dünyada da çekiyorlar.
ca'l: Yaratmak, halk. * Almak. * îş işlemek. Yapmak. * Bu kelime Kur'ân-ı Kerim'de onüç vecihle kullanılmıştır:1- Tafak ve ahz (inşâ ve ikbal) mânasına; bir işi işlemeğe müteveccih olup başlamak ve işler olmak.2- Halketmek, yaratmak.3- Kavl ve irsal.4- Tehiyye ve tesviye (tanzim ve düzeltme).5- Takdir.6- Tebdil.7- Bir şeyi bir şeye dâhil etmek.8- Bir şeyi kalbe ilka ve îlhâm eylemek.9- îtikat.10- Tesmiye.11- Bir şeyi diğer bir şeyden icad ve tekvin.12- Bir şeyi bir sıfat ve hâletten diğer bir sıfat ve hâlete döndürmek, kılmak, tasyir.13- Bir nesne üzerine hükmeylemek gerek hak ve gerek bâtıl olsun - vaz'eylemek bir hususu bir kimse ile bir vecih üzere şartlaşmak ve azv ve nisbet eylemek ve hükm-ü şer'i. (L.R.)
câl: Akıl. * Rey. * Kuyu duvarı.
cal': (Câli') Terbiyesiz. Kötü konuşan.
ca'le: (C.: Cüul) Küçük hurma ağacı.
cale: Nehrin bir kenarından diğer kenarına geçebilmek için ağaçtan, sazdan veya şişirilmiş tulumlardan yapılan sal.
ca'lî: Uydurma, samimi olmayan, sahte, düzme ve taklid.
cal(î): Tuzak, ağ. * Misvak ağacı.
calî': Açık-saçık kadın. Hayasız kadın. * Utanmaz, utanması kıt olan adam.
calîb: çekici. Celbedici. Kendi tarafına çekip getirici olan.
câlîb-î dîkkat: Dikkat çeken.
câlîb-î merhamet: Merhamet çeken.
calîf: Deri soyan, kabuk soyan.
calîfe: Deri ile eti birlikte koparan yara.
calînos: (Kalinos) yun. îlk devirlerde yaşamış olan bir Yunan Filozofunun adı.
calîs: (C.: Cüllâs) Oturan, oturucu, cülûs eden. Tahta çıkan.
ca'lîyyat: Yapmacık hareketler, sahte, düzme hâller.
ca'lîyyet: Yapmacık (olmak.)
calîz: Sebze bahçesi, bostan. Kavun karpuz tarlası.
calût: (Bak: Yûşâ A.S.)
cam: Cam, şişe, bardak, sırça.
cam-i gevherî: Billur kadeh.
cam-i memlû: Dolu kadeh.
cam-i seher òò: Güneş, şems.
cam-i sîm: Sevgilinin çenesi.
cam-i tehî: Boş kadeh.
cam-i zerrîn: Altın kadeh. * Tas: Allah âşıkının kalbi. * Bir kasaba adı. * Bir şarab adı.
ca'ma: Yaşlı deve.
came: Evde giyilen bol elbise. Elbise, çamaşır. Sevb, libas.
came-duz: Terzi, elbise diken.
came-gî: Hâdim ve hizmetçilere verilen ücret ve elbise parası. * Tüfek fitili. * Elbiselik kumaş.* Hizmetkâr, hademe, hâdim.
came-î fena: Kefen.
came-î hassa: Tar: Osmanlı padişahlarının verdikleri elbiselik kumaşlar.
came-î hayat: Hayat elbisesi, ömür.
came-î îdî: Bahar çiçekleri. Kırmızı renkli elbise. * Bayram elbisesi.
came-î nevruzî: Rengârenk elbise. * Bahar geldiğinde açan çeşitli çiçekler.
camedar: Elbiseyi muhafaza eden kimse. * Vestiyer.
camehab: Yatak.
camekân: Elbise soyunulacak yer. * Camlık.
cameşuy: (C.: Câmeşuyân) çamaşırcı, çamaşır yıkayan.
camger: Cam yapan sanatkâr, camcı ustası.
camgûl: Külhanbeyi.
camhane: Cam fabrikası.
camî: (Molla Cami) Hi: 817-898 Büyük bir îslâm müellifidir. Asıl adı: Abdurrahman'dır. Yüze yakın eser vermiştir.
camî: îslâm mâbedi. îbadet yeri olan bina. * Cem'edici, toplayıcı, içine alan. * Cem'etmiş, toplamış bulunan, hâvi ve muhit olan. * Resûl-i Ekrem Aleyhissalâtu Vesselâm bütün evvel ve âhir güzel isim ve ahlâkı kendisinde cem'ettiğinden dolayı ona verilen bir isimdir. * Ehl-i Hadis ıstılahınca da; Buhâri Hadis kitabları gibi, babların sekizini birden cem' eden büyük hadis kitablarına da Câmi denir veya Sünen ismi verilir.
camî-î emevî: şam şehrinde büyük bir câmidir.
camî-î kebîr: Büyük cami.
camî-î kur'an: Kur'an-ı Kerim'i toplayan mânâsında olup, Halife Hz. Osman (R.A.) kasdedilir.
camî-ül ezher: Mısır'daki en büyük üniversitenin adı.
camî-ül huruf: Kitap te'lif eden, müellif, yazar.
camî-ül kelîm: Vecize. Kısa olup çok mânaya gelen söz.
camî-ül mehasîn: Güzel vasıfları huyları kendinde toplamış bulunan.
camîa: Topluluk. Birlik. Kütle. * Dâr-ül fünûn.
camîd: (Câmide) Ruhsuz, sert, katı madde. Cansız.
camîh: Başı sert hayvan.
camîîyyet: Câmi'lik, toplayıcılık. * çok şeylerle alâkalılık. * Pek ziyâde mânâları ve şeyleri hâvi olmak.(Evet hayatın öyle bir câmiiyyeti var; âdeta umum kâinata tecelli eden ekser Esmâ-i Hüsnâ'yı kendinde gösteren bir câmi âyine-i ehadiyyettir. Bir cisme hayat girdiği vakit, küçük bir âlem hükmüne getirir; âdetâ kâinat şeceresinin bir nevi fihristesini taşıyan bir nevi çekirdeği hükmüne geçiyor. Nasılki bir çekirdek, onun ağacını yapabilen bir kudretin eseri olabilir; öyle de en küçük bir zihayatı halkeden, elbette umum kâinatın Hâlikıdır. L.)
camîl: çobanla olan deve sürüsü.
camîs: Cansız, camid. * Letâfeti gitmiş olan elbise.
camît: Eski ve Ortaçağlarda Giresun ile Samsun arasında kalan dağlık mıntıkaya verilen ad. Osmanlılar zamanında bu kelime Canik olarak kullanılmıştır.
ca'mus: (C.: Ceâmis) Pis, necis.
camus: Su sığırı. Manda. Kömüş.
can: Yaşayış. Diride olan kudret, kuvvet. Hayat cevheri. Madde ilimleri, maddenin; hayat ilimleri (biyolojik ilimler) hayatın ne olduğunu açıklıyamamışlardır. Aslında bunların konusu da madde, hayat ve ruhun kendisi değil, bunların tezahürleri yani olay haline gelen tesirleridir. Deney ilimlerinin vazifesi bu olaylar arasındaki ilişkinin değişmeyen tarafını bulmaktır. Bunun ötesinde ilmin söyleyeceği bir sözü yoktur. Buna rağmen bazı kendini bilmez cahiller, ilim adını kötüye kullanarak ilmin sustuğu yerde kendileri konuşuyor ve hayat ve ruhu madde ile açıklamaya kalkışıyorlar. Oysa maddenin de ne olduğunu biliyor değildirler. Biz müslümanlar madde gibi hayat ve ruhun da Allah'ın kudretinin eserleri olduğunu biliyor, birini diğerinin yerine koymuyoruz. Allah görünen ve görünmeyen âlemler yaratmıştır. Onun kudretinin ve yaratmasının sınırı yoktur. Madde, yarattıklarının sadece bir çeşitidir. Varlığı maddeden ibaret sanmak aklı gözüne inmiş olan akılsızların batıl bir inancıdır. * Mc: Sevgili, dost.
can-aferîn: Yaratıcı.
can-aver: Zihayat, canlı, yaşayan. Hayatdar. * Domuz, canavar, hınzır. * Zararlı hayvan.
can-azar: Can yakan, can inciten, eziyet veren. Acı çektiren.
can-bahş: Hayat bağışlayan, can veren. Sevgili. Cenâb-ı Hak. Allah.
can-efşan: Bir dâvâ uğrunda canını veren, canını feda eden.
can-fersa: Can dayanamıyacak derecede.
can-geza: Ruh sıkıcı, can sıkıcı. Tehlikeli olan, öldürücü.
can-gîr: Can sıkıcı, ruh sıkıcı.
can-güzar: Cana dokunan, candan geçer olan.
can-nîsar: Canını harcayan, canını fedâ eden.
can-sîtan: Can çıkarıcı, ruh alıcı. însana bela olan. Güzel.
can-şîken: Azrâil (A.S.)
cana: Ey sevgili! Ey can!
canan: Sevgili, güzel, sâhib-i cemâl. * Canlar, ruhlar.
canavar: Can alıcı, kahredici. * Vahşi, yırtıcı hayvan. Kurt.
canbaz: (C.: Canbazan) Can ile oynayan, canını tehlikeye koyan, canbaz. * Hayvan alış-verişi ile uğraşan kimse. * Aldatan, hilekâr, hile yapan. * Eskiden atlı fedai asker.
canbeleb: ölecek halde, canı dudakta.
candade: Bir şeye candan bağlanmış. Can vermiş, candan bağlanan.
candane: Tepe ile alın arasındaki yer, bıngıldak. Beyin.
candar: Diri, canlı, zihayat, ziruh. * Silâhlı kimse. * Muhafız, koruyucu, emniyet memuru. * Yol yiyeceği, azık.
cane: Silah.
canfeza: Gönüle ferahlık veren, can artıran. * Ayın 23. gününe verilen ad.
can-gâh: Can evi. * Can azaltıcı.
canhiraş: Dayanamıyacak derecede acı ve keder veren.
canî: Candan sevilen.
canî: Cinayet işlemiş olan. Birisini öldürmüş veya yaralamış bulunan. Caniler nasıl haksız yere insanı öldürüyorlar ve onların hayatlarına son veriyorlarsa; kâfirler, inkârcılar, dinsizler de birer cani sayılırlar. çünkü Allah'ın eserleri olan canlı ve cansız varlıklar onun sonsuz kudretini, ilmini, iradesini, rahmetini ilân edip dururlarken inkârcılar bunları tesadüfün, maddenin, tabiatın ve sebeplerin eseri sayıyor ve mânasız, gayesiz şeylermiş gibi göstererek onları mânen öldürüyor, sayısız cinayetler işliyorlar. Demek ki inkârcıların bu cinayetlerinin hesabını verecekleri bir mahkeme var ve olacaktır. (Bak: Ceza)
canîb:Yan, yön. Cihet, taraf. Yüksek taraf.
canîbeyn: îki taraf, iki cânib, iki yan.
canîh(a): (Cünha. dan) Suç işlemiş, mücrim, cinayet işleyen.
canîha: Bir tarafa meyleden veya bir cenahı tutan. * Göğüs altındaki iyeği.
canîşîn: Birinin yerine geçen, birinin yerine vekâlet eden. Vekil.
cankurtaran: t. ölüm tehlikesinde olanları kurtarmak için kullanılan vasıta. * Hasta ve yaralıları hastahaneye taşıyan otomobil. Ambulans.
cann: Ateşten mahlûk cinlerin babası olan. * Bir beyaz yılan cinsi. * Cin taifesi. însanlardan evvel yaratılan bir nevi mahlûklar, cinler. (Bak: Cinn)
canperver: Kalbi ferahlandıran. Ruha hoş gelen.
canrüba: Gönül alan, gönül kapan dilber.
cansîper: (Cansupâr): Canını feda eden.
cansîperane: Canını feda edercesine.
cansuz: Can yakıcı, yürek tutuşturan.
canşîkâf: Can yaralayıcı, can yırtıcı.
canşîkâr: öldürücü. * Mc: Can avlayan veya öldüren. Sevgili, mahbub.
ca'r: Yırtıcı kuşların pisliği.
car: Faydasız bağırıp çağırmayı ve gevezeliği ifade eder ve ekseriya mükerrer kullanılır.
câr: Kadınların, elbisenin üstünde örtündükleri çarşaf. (Bak: çarşaf)
câr: çeken, sürükleyen. * Komşu. * Medet eden, yardımcı. * Müşteri.
câr-i zîl kurbâ: Yakın komşu.
câr-ül cünüb: Yabancı kimse. Akrabadan olmayan.
carî: Akan, akıcı. * Geçmekte olan. * însanlar arasında mer'i ve muteber ve mütedavil olan.
carîf: Yıkıp harap etmek.
carîh: Yaralayan. Yara açan. * Cerheden, çürüten. * Avcı hayvan.
carîha: (Müe.) Yaralayan. * Kol, ayak gibi her bir vücud azâsı.
carîm: Cürüm ve kabahat sahibi. Suçlu. * Ailesinin maişetini kazanan. * Kesen. * Hurma toplayan.
carîn: Aşınmış ve eskimiş bez.* Belirsiz yol. * Yılan yavrusu.
carîs: Yaygaracı, geveze, terbiyesiz, güldürücü. çala çaldıran.
carîye: Geçer olan, akıcı olan. Seyreden giden. * Güneş, şems. * Gemi. * Cenab-ı Hakk'ın in'âm eylediği rızık ve nimet. * Genç ve iyi hizmet eden kadın. Muharebede îslâm düşmanlarından esir edilen kadın hizmetçi.
carr: çeken, çekici. Sürükleyici. * Harf-ı cer.
carre: Komşu kadını. * Yularından çekilen deve.
carşeb: çarşaf, cilbab.
carû(b): Süpürge.
cârûb-zen: Süpürücü, çöpçü.
carud: Nasrani rüesasından olup şam'ın da reislerindendi. Kitablarında Hz. Peygamber'in (A.S.M.) vasıflarını görüp imân edenlerdendir. Asr-ı Saâdetten önce yaşamıştır.
carûr: Sel arkı.
carûre: Kapı ökçesinin yeri.
ca's: Pis, necis.
caselîk: Katolik. Başpiskopos, başpapaz, büyük papaz, patrik.
casîm: şam diyarında bir köyün adı.
casîr: (Cesaret. den) Cesaret eden, cesur, cesaretli.
casîye: Diz çökmüş.* Topluluk, cemaat. * Yığın, taş yığını.
câsîye suresî: Kur'an-ı Kerim'in 45. sûresi olup Mekke-i Mükerreme'de nâzil olmuştur. şeriat, Dehir Suresi de denir.
caslîk: (Cesâlik) Nasrâniler hakimi. * çokluk, kesret.
cass: Alçı taşı. * Kireç.
cassas: Sıvacı, kireççi.
cast: üzüm teknesi. üzümün sıkıldığı yer.
casûm: Korkulu rü'ya, kâbus.
ca'sûs: (C.: Ceâsis) Kötü huylu, kısa boylu.
casus: (C.: Cevâsis) Hafiye. Gizli sırları haber veren. Kendi asıl şahsiyetini gizleyip, kendini iyi şahsiyet şeklinde göstererek ve gizli yollarla bir devletin askeri, siyasi ve mâli durumlarına dair haberleri başka bir devlet menfaatına olarak toplayıp bildiren kimse.
casus: Karpuz.
caşîrîyye: Kuşluk vakti yenen yemek. Kuşluk yemeği.
caub: Kısa adam.
ca'v: Deve ve koyun tersini toplamak.
cavers: Buğdaylar arasında biten bir cins sarı darı.
câvîd: (Câvidân, câvidâne, câvidâni) Sermedi, sonu olmayan, sonsuz, dâimi, lâyemut.
câvîdâne: Câvidân, ebedi, sonsuza âit, sonsuza müteallik.
cây: Yer, makam, mevki.
cay-baş: îkâmet yeri, oda, ev. Yurt, mekân, mesken.
cay-gâh: Mevki, makam, rütbe. * Yer, mekân.
cay-gîr: Yerleşen, yer tutan, yerleşmiş.
cây-i dîkkat: Dikkat edilecek nokta. Dikkat edilecek yer veya şey.
cây-i hayret: Hayret edilecek yer veya şey.
cây-i karar: Dinlenme, durma yeri.
cây-i mülâhaza: Düşünülecek nokta, düşünülecek yer.
cay-mend: Yerinden kalkmayan, üşenen, tenbel. Rahatını bozmayan.
cay-nîşîn: Yer tutan. Birinin yerine geçen.
cayî': (C.: Ciya') Aç, acıkmış; aç olan.
cayîd: Cömert, sahi.
cayîfe: Karın içine geçmiş olan yara.
cayîha: şiddet. * Kıtlık. * Yemişe gelen âfet.
cayîr: Cevir ve cefâ eden. Eziyet veren.
caymak: t. Vazgeçmek. Sözünden dönmek.
ca'z: Yoğun, kalın nesne.
ca'zerî: Kısa boylu, galiz, sitemkâr kimse.
cazgir: Yağlı güreşlerde pehlivanları seyircilere takdim edip dualarını okuyarak onları meydana çıkaran kimse.
cazî: Ayaklarını dikip parmakları üzerine oturan kişi.
cazî': üzüm çardağının üzerinde enine konulan, üzerine de üzüm çubukları serilen ağaç.
cazîb: çekici, cazibeli. * Hoş görünüşlü olup dikkati çeken.
cazîbe: çekme kuvveti. * Mc: Letafet zamanı. Hüsn-ü cemal.(Hareket harareti, hararet kuvveti, kuvvet câzibeyi tevlid eder gibi bir âdet-i îlâhiyye, bir kanun-u Rabbanidir. Mek.)
cazîbe kanunu: Madde âleminde geçerli olan Cenab-ı Hakk'ın tekvini bir kanunudur. Bu kanuna göre iki madde birbirini aralarındaki mesafe ile ters orantılı; kütle ve miktarlarıyla orantılı olarak çeker.
cazîbedar: çekici, câzibeli.
cazîm: Kat'i karar veren. * Gr: Cezmedici, cezmeden. Arabça bir kelimenin başına gelen bazı harfler o kelimenin sonunu sâkin okutur, o harfe de "câzim" denir. Meselâ "Lem yezuk" aslında (Yezuku) idi. Başına "lem" harfi geldiğinden " Yezuk" diye sâkin okundu.)
cazîye: Doğurduktan sonra sütü azalmaya başlayan hayvan.
cazû: Cadı. Büyücü, sihirbaz.
cazz: Semiz,iri gövdeli adam.
ce'b: Kesbetmek, elde etmek, kazanmak. * Yaban eşeğinin büyüğü. * Kırmızı toprak boya. * Göbek.
ceb': (C.: Cebeât) Kızıl mantar.* (C.: Ecbu) Nakir dedikleri ağzı dar kap ki, içine su koyarlar. * Tehir etmek, sonraya bırakmak.
cebabîre: Cebrediciler. Mütekebbirler. Zâlimler.
cebae: üstünde birşey düzeltilen ağaç.
ceban: Korkak, ürkek.
cebanet: Korkaklık, ürkeklik. Korkulmayacak şeylerden bile korkmak. (Bak: Sırat-ı müstakim)
cebb: Bir kimsenin zekerini ve hayasını kesip hadım etmek. * Devenin hörgücünü kesmek.* Kökünden kesmek.
cebban: (C.: Cebâbin) Peynirci.
cebban(e): Sahrâ. Bayram namazını kılacak yer. * Mezarlık.
cebbar: (Sıfat-ı îlahiyedendir) îstediğini mutlak yapan, dilediğine muktedir olan. Büyüklük, azamet ve kudret sahibi. îmar eden Cenab-ı Hak. Kullarını ıslah edip tevbeye götüren Allah Teâlâ Hz.leri (C.C.) * Zâlim, gaddar, müstebid, mütemerrid insanlar da bu sıfatla tavsif edilir. Meselâ; Cengiz, cebbar ve gaddar bir devlet adamı idi. * Koz: Gökyüzünün cenubunda bulunan bir yıldız kümesi.
cebbarane: Cebbarcasına. Cebbar olana yakışacak tarzda.
cebbarî: Cebbara mensub, cebbarlık, cebredicilik. Cebbarlık eden.
cebceb: çok hasta deve yavrusu.
cebe: Zincir veya halkadan örme zırh. Cevşen.
cebe': Kuyu içinden çıkan toprak ki, etrafına öbek öbek dökerler.
cebe-pûş: Zırh giyen.
cebecî: Eski Osmanlı împaratorluğunun ordusunun zırhlı sınıfına mensub nefer.
cebel: Dağ, yüksek tepe. * Mc: Bir kavmin meşhuru ve büyüğü, âlim ve fâzıl kimse.
cebel-î arafat: Arafat Dağı.
cebel-ün nur: Mekke dağlarından, Hira veya Hırra veya Harra Dağı. Peygamberimize (A.S.M.) ilk vahyin geldiği dağ.
cebelîstan: Dağlık, dağlık yer.
ceber (ceberîye): (Ceberiyyun) Cüz'i iradeyi inkâr eden bir fırka-i dalle. Hak yolundan çıkmış, dalâlete düşmüş bir fırka. Bunların zıdları da Mu'tezile'dir.
ceberut: Azametin daha dâimisi ve bâtınisi. Büyüklük. Hâkimlik. Kudret, celadet. Fart-ı kibir ve azamet.
cebha': Büyük alınlı kadın.
cebhane: Barut, kurşun, gülle, top, tüfek ve benzerleri gibi levazımat-ı harbiye ve bunların bulunduğu yer.
cebhe: Yüz, ön taraf. Harp sahası. Muharebe edilen yer. * Alın. * Bir binanın veya o cinsten bir şeyin ön tarafı. * Gökteki ayın menzillerinden birisinin ismi olup arslan suretinin cephesidir, dört yıldız arslan alnına benzetilmiştir. * Bir kavmin ve cemaatin seyyidi.
cebhe-sâ: Yüz süren.
cebîn: (Cebân) Korkak. Cesaretsiz. * Alın.
cebîn-sâ(y): Alın sürücü, alın süren.
cebîr: Zabtetmek. Zor. Kuvvet. * Bir şeyi ıslah ve tamir etmek, düzeltmek. * Bâtıl bir fırka. * Mat: Harflerle yapılan hesab. * Tıb: Fevkalâde ameliyat, kırık kemiği sarıp bütünlemek. Kırık veya çıkık uzva sarılan tahtalar.
cebîre: çıkık veya kırık olan bir uzva sarılan tahtalar.
cebîre: Halkın bir işe hazırlık yapması.
cebl: îhtira, ibda. Yoktan yaratma.
cebr-î mâfat: Kaybedilen bir şeyin yerine başka bir şey bularak, onunla avunma.
cebr-î noksân: Noksanı tamamlama, eksiği ikmâl etme.
cebraîl: (Cebril, Cibril) Cenab-ı Hakk'ın emirlerini Peygamberlere (A.S.) bildiren büyük melek. Peygamberimiz Resul-i Ekrem'e (A.S.M.) Kur'ân-ı Azimüşşân'ı vahiyle getiren melek (A.S.).
cebre: Kemik sarmakta kullanılan ağaç. * Tahta parçaları.
cebren: Zorla. Cebir ve kuvvet istimali ile. Kuvvet kullanarak.
cebrî: Zorla icra olunan, rızası olmadan zorla yaptırılan. * Cebriye fırkasından olan.
cebrîye: Cüz'i irâdeyi inkâr edenlerin bâtıl mezhebi.
cebub: Sağlam yer. Muhkem. * Yeryüzü. * Katı ve galiz yer.
cebz: çekmek, cezb.
ce'cee: Geri durdurmak. * Deveyi suya çağırmak. * Eşek boncuğu denilen bir boncuk.
ced': Burun, kulak, el kesmek. * Hapsetmek.
ced'a: Kestikten sonra geri kalan nesne. * Hapsetmek.
ceda: Bol yağmur, rahmet. * Hediye, ihsan. în'âm. * Avantaj, kazanç.
ceda': Kıtlık ve şiddet senesi.
cedale(t): Yer. Arz. Dünya. * Hurma koruğu, ham hurma.
cedavî: Hizmetçi aylığı.
cedavîl: (Cedvel. C.) Cedveller. * Su yolları. * Listeler.
cedaye: Geyik.
cedb: Kısırlık. * Kusur.
cedced: Pek düz yer.
cedd: Babanın babası veya ananın babası. * Büyüklük, azimlik. * Kat'edip geçmek. * Tâli'li olmak. * Kesmek.
cedd-î emced: En büyük cedd. En yaşlı, en büyük baba.
cedda': Küçük memeli kadın. * Susuz çöl.
ceddat: (Cedde. C.) Nineler. Büyük anneler, anneanneler, babaanneler.
cedde: (C.: Ceddât) Büyük vâlide. Annâne, nine. * Yeni olmak.
cedde-î fâsîde: Ananın anası, anneanne.
cedde-î sahîha: Babanın anası, babaanne.
ceded: Yassı, düz yer.
cedef: (C.: Ecdâf) Makbere, kabir, mezar. * Yemen diyarından gelir bir otun adı. (Bir kimse bu otu yese su içmeye muhtaç olmaz.)
cedel: Konuşmada kavga etme. Niza. Hakkı bulmak için olmayıp, galib görünmek için çekişme. (Diyalektik) * Man: Meşhur veya müsellem mukaddemelerden terekküb eden kıyastır.
cedel-gâh: çekişme yeri. * Mc: Dünya.
cedelî: Tartışmaya, münakaşaya ait. Münakaşacı. Tartışmacı.
cedeme: (C.: Cüdem) Yaramaz dişi koyun. * Kısa boylu erkek.
cederî: Vücutta çıkan çiçek hastalığı.
cedes: Kabir, mezar.
cedgare: Reyler, tedbirler, çeşit çeşit yol.
cedh: Bir şeyi başka bir şeyle karıştırmak. * Sütü su ile karıştırmak.
cedî: Güneş medarının oniki burcundan birisi. Oğlak burcu. (Güneşin cenuba doğru inişinin en aşağı derecesini bildirir.) * Keçinin erkek yavrusu, erkek oğlak.
cedîb: Kıtlık olan yer.
cedîd: Yeni, kullanılmamış.
cedîdan: Gece ile gündüz. * Yenilenen iki şey. Yenilenenler.
cedîl: Devenin boynuna taktıkları ip.
cedîle: Kabile. * Nâhiye. * Kuş kafesi.
cedîr: Lâyık, münasib, uygun. * Nihâyet, son. * Etrafı duvarlı yer.
cedîyye: (C.: Cedâyâ) Gövdeye yapışan kan.
cedl: Yaratmak, halk. * Kuvvet. * Sağlam bükmek. * Azâ, organ, uzuv.
cedr: (Cidr) Duvar. Hâil, perde, zar. * Bir ot adı.
cedûd: (C.: Cedâyid-Cüdüd) Sütü çekilmiş koyun.
cedva: Bol yağmur, rahmet. * Armağan hediye.
cedvar: Nebâtattan zerâvende benzer bir ottur ve mâcun yapılır.
cedvel: Liste. * Su kanalı. Kanal. * Doğru, düz çizgiler çizmeğe mahsus âlet.
cedy: (C.: Cidâ-Ecd) Oğlak. * Burç adı.
cedye: (C. Cedâyât) Eyer altına konulan keçe.
ceey: Su içmesi için deveyi çağırmak.
ce'f: Düşmek.
cef': Kenara çerçöp atmak. * Zâyi ve bâtıl olmak. * Koparmak. * Bir kabı eğip içindekini dökmek.
cefa: Eziyet. Sıkıntı. Zulüm. * Bir şey yerinde durmayıp bir tarafa ayrılmak.
cefa ender cefa: Cefa içinde cefa. Azab içinde azab veya ayrılık.
cefa-dîde: Cefa çekmiş, cefa görmüş.
cefa-keş: Eziyete dayanan, cefa çeken, acıya katlanan.
cefa-pîşe: Gaddar, cebbar, zâlim. * Sevgili, mâşuk, sevilen.
cefaf: Kuru olma, kuruma.
cefakar: Eziyet eden, cefa eden. * Halk arasında: Eziyet çeken, cefa çekmiş mânalarında da kullanılır.
cefale: însan topluluğu.
cefaset: Hazımsızlık ıztırabı, sindirim zorluğu.
cefcaf: Hayâsız, ahlâksız kadın.
cefcef: Yüce, yüksek yer. * Katı yel.
ceff: Kurumak.
ceffah: Mütekebbir kimse, gururlu kişi.
ceffar: (Cefr. den) Cifirci. Cifir yapan kimse.
ceffe: Kalabalık, kütle. * Kalabalığın verdiği uğultu.
ceffe-l kalem: Düşünmeksizin, birden, hemen. * Kalemin yazısı kurumuş, silinmez. * Kat'i olan şey.
ceffet: Cemaat, topluluk, çok adet.
cefh: Fahirlenmek, mütekebbirlenmek, gururlanmak, kibirlenmek.
cefîf: Kuru, kurumuş.
cefîr: Ok koyulan kap, mahfaza.
cefl: Yağmuru yağmış bulut.
cefla: Umumi ziyafet.
cefn: Göz kapağı. * Asma çubuğu. * Bıçak ve kılıç kını.
cefnak: Gözleri büyük, rengi sarıya yakın bir kuşun adı.
cefne: (C.: Cifân) Su kabı, tekne, teşt. Büyük çanak.
cefr: Dört aylık keçi oğlağı. * Geniş ve örülmemiş kuyu. (Bak: Cifr)
cefv: Kaba muâmele.
cefve: Cefa, azar.
cefvet: Nezaketsizlik, kabalık, saygısızlık.
cehabîze: Hakikatlerden, gerçeklerden haberi olanlar.
cehad: Sağlam, katı yer.
cehad: Nimet az olmak. * Ot uzamayıp kalmak. * Su az olmak.
cehadet: Tezlik, acelecilik.
cehalet: Bilmezlik, nâdanlık, ilimden ve her nevi müsbet mâlûmatdan habersiz olma. Cahillik.
ceham: Yağmur vermeyen bulut.
cehamet (cühumet): Yüz pörtümek, donuk yüzlü olmak.
cehan: Cihân, dünya, küre-i arz, arz. * Sıçrayan, fırlayan, acele ve çabuk hareket eden.
ceharet: Sesin yüksek olması. Ses yüksekliği.
cehbez: (C.: Cehâbize) Basiretli, ileri görüşlü kimse.
cehcehe: çağırmak. * Irak etmek, uzaklaştırmak.
cehd: Fazla çalışma. Güç ve kuvvetini sarfetme. însanın nefsine hâkim olması. * Azim, gayret, fedakârlık.* Takat.
cehele: (Cahil. C.) Câhiller. îlimden mahrum olanlar. Bilmeyenler. Nâdanlar.
cehemîyye: Cebriye'den Cehm bin Safvan mezhebi üzere "Cennet ve Cehennem fânidir, iman mârifettir ve ikrar değildir" diyen bir tâife.
cehende: Fırlıyan, sıçrayan. * Sıçramış, fırlamış.
cehende-gî: Fırlayış, sıçrayış.
cehennem: Allah yerine, tabiat, madde, sebepler vb. yaratılmış şeyleri ilâh kabul eden; Allah'a kul olacaklarına, arzularına ve heveslerine, başka insanlara ve mahlukata kul olanların işledikleri cürüm ve suçtan dolayı îlâhi adaletle ceza görecekleri yer. Cehennem'in varlığını bütün geçmiş peygamberler ve onların yolundan giden bütün âlimler ve evliyalar kesin bir bilgi olarak bildirmişlerdir. Esasen Allah'ın adaleti cehennemi gerektirir. Ezenlerle ezilenler, haklılarla haksızlar, zâlimlerle mazlumlar, iyilerle kötüler, inananlarla inanmıyanlar, Allah'a kul olanlarla kula kul olanlar eşit olamaz. Allah'ın adaleti iyilere mükâfat, kötülere cezayı gerektirir. înkarcılar hayatı mânasız bulmakla, ölümü de kendilerini ve bütün sevdiklerini yok eden ebedi bir idam saymakla daha hayatta iken cehennemin müjdecisi olan ruh bunalımını yaşıyorlar. îçki, kumar, zevk, eğlence, sefahet onları ruh bunalımından kurtaramıyor. çağımız insanının huzursuzluğu ve mutsuzluğu, inançsızlıktan kaynaklanıyor. Onların bu halleri, inançsızlığın cezasının Cehennem olacağını gösteriyor.Cehennem'in yedi tabakasının isimleri: Sair, Sakar, Cahim, Hutame, Lâzı, Hâviye, Derk-i esfel.(Cehennem, azab yeri olan ateşin ism-i alemidir ve müennestir. Arabca "cehnam" kelimesinden me'huz, bu da cehm'den müştaktır. Cehm, galiz ve müstekreh olmak; cehnam, dibi görünmez derin kuyu demektir. E.T.)(Cehennem nerededir?Elcevap: $Cehennemin yeri, bâzı rivâyatla "Tahtel-Arz" denilmiştir. Başka yerlerde beyan ettiğimiz gibi Küre-i Arz, hareket-i seneviyesiyle ileride mecma-ı haşir olacak bir meydanın etrafında bir daire çiziyor. Cehennem ise, Arzın o medar-ı senevisi altındadır demektir. Görünmemeleri ve hissedilmemeleri, perdeli ve nursuz ateş olduğu içindir. Küre-i Arzın seyahat ettiği mesafe-i azimede pek çok mahlukat var ki, nursuz oldukları için görünmezler. Kamer, nuru çekildikçe vücudunu kaybettiği gibi, nursuz çok küreler, mahluklar gözümüzün önünde olup göremiyoruz.Cehennem ikidir. Biri suğra, biri kübrâdır. îleride suğra, kübrâya inkılâb edeceği ve çekirdeği hükmünde olduğu gibi, ileride ondan bir menzil olur. Cehennem-i Suğrâ, yerin altında, yâni merkezindedir. Kürenin altı, merkezidir. îlm-i Tabakat-ül-Arz'ca malûmdur ki: Ekseriya her otuzüç metre hafriyatta, bir derece-i hararet tezayüd eder. Demek merkeze kadar nısf-ı kutr-u arz, altı bin küsur kilometre olduğundan, ikiyüz bin derece-i harareti câmi; yâni ikiyüz def'a ateş-i dünyeviden şedit ve rivayet-i hadise muvâfık bir ateş bulunuyor. şu Cehennem-i Suğrâ, Cehennem-i Kübrâya ait çok vezaifi, dünyada ve Alem-i Berzah'da görmüş ve ehâdislerle işaret edilmiştir. âlem-i âhirette, Küre-i Arz nasılki sekenesini medar-ı senevisindeki meydân-ı haşre döker; öyle de: îçindeki Cehennem-i Suğrâ'yı dahi Cehennem-i Kübrâ'ya emr-i îlâhi ile teslim eder. Ehl-i îtizâl'in bâzı imamları; "Cehennem sonradan halkedilecektir" demeleri, hâl-i hâzırda tamamiyle inbisat etmediğinden ve sekenelerine tam münasip bir tarzda inkişaf etmediğinden galattır ve gabavettir. Hem perde-i gayb içindeki âlem-i âhirete ait menzilleri dünya gözümüzle görmek ve göstermek için, ya kâinatı küçültüp iki vilâyet derecesine getirmeli, veyahut gözümüzü büyütüp yıldızlar gibi gözlerimiz olmalı ki yerlerini görüp tâyin edelim. $ âhiret âlemi'ne ait menziller, bu dünyevi gözümüzle görülmez. Fakat bâzı rivâyâtın işaretiyle âhiretteki Cehennem bu dünyamızla münasebetdardır. Yazın şiddet-i hararetine $ denilmiştir. Demek bu dünyevi küçücük ve sönük akıl gözüyle o büyük Cehennem görülmez. Fakat îsm-i Hakim'in nuriyle bakabiliriz. şöyle ki: Arzın medâr-ı senevisi altında bulunan Cehennem-i Kübrâ, yerin merkezindeki Cehennem-i Suğrâyı güya tevkil ederek bâzı vazaifini gördürmüş. Kadir-i Zülcelâl'in mülkü pek çok geniştir, hikmet-i îlâhiye nereyi göstermiş ise Cehennem-i Kübrâ oraya yerleşir. Evet, bir Kadir-i Zülcelâl ve emr-i Künfeyekün'e mâlik bir Hâkim-i Zülkemal gözümüzün önünde kemâl-i hikmet ve intizam ile Kamer'i Arz'a bağlamış; azamet-i kudret ve intizam ile Arzı Güneş'e rabtetmiş ve Güneş'i seyyârâtiyle beraber arzın sür'at-i seneviyesine yakın bir sür'at ile ve haşmet-i rububiyetiyle, bir ihtimale göre şems-üş şümûs tarafına bir hareket vermiş ve donanma elektrik lâmbaları gibi yıldızları, saltanat-ı rububiyetine nurani şâhidler yapmış; onunla saltanat-ı rububiyetini ve azamet-i kudretini göstermiş bir Zât-ı Zülcelâl'in kemâl-i hikmetinden ve azamet-i kudretinden ve saltanat-ı rububiyetinden uzak değildir ki Cehennem-i Kübrâ'yı elektrik lâmbalarının fabrikasının kazanı hükmüne getirip âhirete bakan semânın yıldızlarını onunla iş'al etsin; hararet ve kuvvet versin. Yâni, âlem-i nur olan Cennet'ten yıldızlara nur verip, Cehennem'den nar ve hararet göndersin. Aynı halde o Cehennem'in bir kısmını ehl-i azâba mesken ve mahbes yapsın. Hem bir Fâtır-ı Hakim ki: Dağ gibi koca bir ağacı, tırnak gibi bir çekirdekte saklar. Elbette o Zât-ı Zülcelâl'in kudret ve hikmetinden uzak değildir ki, Küre-i Arz'ın kalbindeki Cehennem-i Suğrâ çekirdeğinde Cehennem-i Kübrâ'yı saklasın.Elhasıl: Cennet ve Cehennem, şecere-i hilkatten ebed tarafına uzanıp eğilerek giden bir dalın iki meyvesidir. Meyvenin yeri ise, dalın müntehasındadır. Hem şu silsile-i kâinatın iki neticesidir. Neticelerin mahalleri, silsilenin iki tarafındadır. Süflisi, sakili aşağı tarafında; nuranisi, ulvisi yukarı tarafındadır. Hem şu seyl-i şuunatın ve mahsûlat-ı mâneviye-i arziyenin iki mahzenidir. Mahzenin mekânı ise, mahsûlâtın nev'ine göre, fenası altında, iyisi üstündedir. Hem ebede karşı cereyan eden ve dalgalanan mevcudat-ı seyyalenin iki havzıdır. Havzın yeri ise, seylin durduğu ve tecemmu' ettiği yerdedir. Yâni habisâtı ve muzahrefâtı esfelde, tayyibâtı ve sâfiyâtı âlâdadır. Hem lütuf ve kahrın, rahmet ve azametin iki tecelligâhıdır. Tecelligâhın yeri ise, heryerde olabilir. Rahmân-ı Zülcemâl ve Kahhâr-ı Zülcelâl nerede isterse tecelligâhını açar.Amma Cennet ve Cehennem'in vücudları ise, Onuncu ve Yirmisekizinci ve Yirmidokuzuncu Sözlerde gayet kat'i bir surette isbat edilmiştir. şurada yalnız bu kadar deriz ki: Meyvenin vücudu dal kadar ve neticenin silsile kadar ve mahzenin mahsulât kadar ve havzın ırmak kadar ve tecelligâhın, rahmet ve kahrın vücudları kadar kat'i ve yakindir. M.)
cehennem-î suğrâ: Küçük cehennem.
cehennem-nümun: Cehennem gibi çok azab verici.
ceher: Gündüzleyin bir şeyi görememek. (O kimseye "echer" derler)
cehîr: (Cehr. den) (C.: Cüherâ) Yüksek sesle, bağırarak ve açık olarak söylenen. * Güzel, dikkate değer.
cehîr-üs savt: çok ve kuvvetli ses.
cehîş: Halktan uzak olan.
cehîz: Karnından çocuk düşüren.
cehl: Câhillik, bilmemezlik, ilimden mahrum olmaklık, nâdanlık, tecrübesizlik, gençlik.
cehl-î basît: Bilmediğini bilmek sûretiyle olan câhillik.
cehl-î mürekkeb: Bilmemekle beraber, bilmediğini de bilmemek.
cehlîstan: Cehâlet âlemi. Cahilliğin olduğu yer.
cehr: Görünmek, zâhir olmak. * Açıktan ve yüksek sesle olan söylemek veya okumak. * Tecvid'de: Harf hareke ile okunduğu zaman, mahreçte aralık kalmıyarak nefesin akmayıp, küllisi veya ekserisi hapsolmuş bir şekilde sesin çıkmasına denir.
cehre: Açıkta ve belli olan şeyler. * Pamuk ve ipek sarılan masura.
cehren: Açıktan, alenen.
cehret: Görünmek, zahir olmak.
cehreten: Aşikâr sûrette, aleni bir şekilde, açıktan açığa.
cehrî: Aleni ve yüksek sesle vâki olan şey.
cehş (cühüş): Medet edişmek. Başka kimseye sığınıp arkalanmak.
cehûd: Cıfıt, yahudi.
cehûf: Kuyudan suyu alıp yukarı çekmeye mahsus kova.
cehûl: Pek çok câhil. (însan hayvanların aksine olarak hayata lâzım her şeye karşı câhildir. Her şeyi öğrenmeğe mecburdur. Hadsiz eşyaya muhtaç olduğu için sigayı mübalâğâ ile cehûldur. M.)
cehûlâne: Pek câhilcesine.
cehûş: Oğlan, sabi.
cehva': Açık.
cehve: însanın dübür yeri.
cehvere: Zâhir olmak, görünmek.
cehyer: Dişi ayı.
cehzam: Başı büyük, yuvarlak yüzlü kişi. * Esed, arslan.
celâ: Parlak, ruşen. Zâhir, açık.
celâ': Gurbete düşmek, memleketinden ayrı olmak. şehrinden ve meskeninden çıkmak. * Başkalarını çıkarmak. * Açık haber. * Ruşen olmak, parlamak.
celâ-yi vatan: Doğduğu yerden ayrılma.
cel'ab: Medine yakınında bir dağ. * Gözü çok iyi görmek.
celab: Salkım küpe.
cel'abe: çok kuvvetli dişi deve.
celabîb: (Cilbâb. C.) Kadının bütün vücudunu örten ve dıştan giyilip bol olan çarşaf nevi. Yaşmaklar. Baş ve yüz örtüleri, ferâceler. (Bak: Tesettür)
celacîl: (Cülcül. C.) Küçük çanlar, ufak çıngıraklar.
cel'ad: Yoğun gövdeli şişman, kaba kimse.
celadet: Yiğitlik. Bahadırlık. Kuvvet ve şiddetlilik. Muhkemlik. Salâbet, metânet.
celafet: Kabalık, yontulmamışlık.
celah: Başın iki tarafından saçın dökülmesi. * Devenin ağaç yemesi.
celahîz: Kaba, ağır.
celaîl: (Celile. C.) Celiller, büyük olanlar, yüceler.
celal: (Celâlet) Nihâyet derecede büyüklük. Azamet. Hiddetlilik, hışım. * îlm-i Kelâm'da: Cenâb-ı Hakk'ın kahrının ve azametinin tecellisi, Cenâb-ı Hakk'ın nev'deki tecellisi. Cenâb-ı Hak, vahdaniyyetine delil olacak çok şeyler yarattığından veyâ ihâtadan âli ve celil olduğu veya hislerle idrâk edilmekten celil olduğundan Celâl denir.(Arkadaş! Cenâb-ı Hakk'ın sıfât-ı ezeliyye âleminde biri celâli, diğeri cemâli iki türlü tecellisi vardır. Celâl ile Cemâlin sıfât-ı ef'âl âleminde tecellisinden; lütuf ve kahr, hüsün ve heybet tezâhür eder. Ef'âl âlemine tecelli edince; tahliye $ ile tahliye $ (tezyin ile tenzih) doğar. Asar ve a'mal âleminden âlem-i âhirete intiba' edince; lütuf, cennet ve nur olarak; kahr da, cehennem ve nâr olarak tecelli eder. Sonra âlem-i zikre inikâs edince; biri hamd, diğeri tesbih olmak üzere iki kısma ayrılır. Sonra âlem-i kelâmda tecelli edince, kelâmın emir ve nehye taksimine sebep olur. Sonra âlem-i irşada intikal edince; irşadı tergib ve terhib, tebşir ve inzâra taksim eder. Sonra vicdana tecelli edince, recâ ve havf husule gelir. Sonra irşâdın iktizâsındandır ki, havf ile recâ arasındaki muvâzene devamla muhafaza edilsin ki, recâ ile doğru yollara sülûk edilsin, havf ile de eğri yollara gidilmesin. Ne Allah'ın (C.C.) rahmetinden me'yus, ne de azabından emin olunsun. î.î.)
cela'la': Kirpi.
celaleddîn-î harzemşah : (Vefâtı M.: 1231) Mengü berdi (Allah verdi) ismi de verilir. Harzemşah soyunun 7nci ve son hükümdarıdır. Tarihte cesaret ve irfanı ile tanınmıştır. O zamanın deccalı olan Cengiz'in kahır ve şiddeti karşısında îrân ve Turân korku ve zillete düştüğünde Celâleddin, Cengiz'in ordularını müteaddit defalar mağlub etmiştir. Kendisine pederinden şehzadelikten başka bir şey kalmadığı halde Harzem'de, Hind'de, Irak'ta, Azerbeycan'da dört devletin meydana gelmesine muvaffak oldu. Küçük küçük kuvvetlerle üç milyon askere sâhib Tatar devletine karşı yirmiden ziyade zafer kazandı. Moğol taarruzlarından birisinde bir dağa çekildiği sırada bir çapulcu taifesi tarafından sırtından hançerlenerek şehid edildi. (R. Aleyh)(Meşhurdur ki: Bir zaman îslâm kahramanlarından ve Cengiz'in ordusunu müteaddit defa mağlub eden Celaleddin-i Harzemşah harbe giderken vüzerâsı ve etbaı ona demişler: "Sen muzaffer olacaksın; Cenab-ı Hak seni galip edecek." O demiş: "Ben Allah'ın emriyle, cihad yolunda hareket etmeye vazifedarım, Cenab-ı Hakk'ın vazifesine karışmam, muzaffer etmek veya mağlub etmek onun vazifesidir." îşte o zât bu sırr-ı teslimiyeti anlamasıyla hârika bir surette çok defa muzaffer olmuştur. M.N.)
celaleddîn-î süyûtî: (Hi: 849 - 911) Abdurrahman bin Ebu Bekir Muhammed adı ile de anılır. Hadis imamı ve müctehid bir zattır. Mısırlıdır. Süyût şehrinde doğdu. Mısır'da vefat etti. Zamanının büyük îslâm allâmelerindendir. Asıl adı: Ebû Bekir oğlu Abdurrahman'dır. Tefsir, fıkıh, hadis ilmine dair eserleri vardır. Celaleddin Muhammed bin Ahmed Mısri'nin, îsrâ Sûresine kadar yaptığı (Hi: 864'de vefat edince yarıda bıraktığı) tefsiri tamamlamıştır ve Celaleyn Tefsiri denmiştir.
celalî: Celal ismine dâir. îlâhi ve celale müteallik. Celal adlı kimselerle alâkalı olan. * Hicri XI. Asırdan önce Anadolu'da baş gösteren eşkiyaya verilen ad. * Sultan Celaleddin Melikşah tarafından hazırlanan ve Hicri 471 tarihinde başlayan bir güneş takvimi.
celallî: çok çabuk kızan kimse.
celaze: Sazların perdeleri.
celb: Kendi tarafına çekmek. çekmek, götürmek.
celb-î kulûb: Kalbleri çekme, kalbleri kazanma.
celb-î suret : Uzakta olan bir şeyin sûretini resmini yanına getirmek.(... Hz. Süleyman (A.S.) taht-ı Belkıs'ı yanına celbetmek için vezirlerinden bir âlim-i ilm-i celb dedi: "Gözünü açıp kapayıncaya kadar sizin yanınızda o tahtı hazır ederim." olan hâdise-i hârikaya delalet eden şu âyet: $îlâahir işaret ediyor ki: Uzak mesafelerden eşyayı aynen veya sûreten ihzar etmek mümkündür. Hem vakidir ki: Risaletiyle beraber saltanatla müşerref olan Hz. Süleyman (A.S.) hem masumiyetine, hem de adaletine medar olmak için pek geniş olan aktar-ı memleketine bizzat zahmetsiz muttali olmak için ve raiyyetinin ahvâlini görmek ve dertlerini işitmek, bir mu'cize suretinde Cenab-ı Hak ihsan etmiştir. Demek, Cenab-ı Hakk'a itimad edip, Süleyman'ın (A.S.) lisan-ı ismetiyle istediği gibi o da lisan-ı istidadıyla Cenab-ı Hak'dan istese ve kavanin-i adetine ve inayetine tevfik-i hareket etse, ona dünya bir şehir hükmüne geçebilir. Demek, taht-ı Belkıs Yemende iken, şamda aynıyla veyahut suretiyle hazır olmuştur, görülmüştür. Elbette taht etrafındaki adamların suretleriyle beraber sesleri de işitilmiştir. îşte, uzak mesafede celb-i surete ve savta haşmetli bir sûrette işaret ediyor ve mânen diyor: Ey ehl-i Saltanat! Adalet-i tâmme yapmak isterseniz Süleymanvâri, ruy-i zemini etrafıyla görmeye ve anlamaya çalışınız. çünki; Bir hakim-i adalet-pişe, bir padişah-ı raiyetperver, aktar-ı memleketine her istediği vakit muttali olmak derecesine çıkmakla mes'uliyet-i mâneviyeden kurtulur veya tam adalet yapabilir. Cenab-ı Hak, şu ayetin lisan-ı remziyle mânen diyor ki: Ey beni-adem! Bir abdime geniş bir mülk ve o geniş mülkünde adalet-i tâmme yapmak için, ahvâl ve vukuat-ı zemine bizzat ıttıla veriyorum. Ve madem herbir insana, fıtraten zemine bir halife olmak kabiliyetini vermişim. Elbette o kabiliyete göre ruy-i zemini görecek ve bakacak, anlayacak istidadını dahi vermesini, hikmetim iktiza ettiğinden vermişim. şahsen o noktaya yetişmezse de, nev'en yetişebilir. Maddeten erişemezse de, ehl-i velâyet misillû manen erişebilir. öyle ise, şu azim nimetten istifade edebilirsiniz. Haydi göreyim sizi, vazife-i ubudiyetinizi unutmamak şartıyla öyle çalışınız ki: Ruy-i zemini, her tarafı, herbirinize görülen ve her köşesindeki sesleri size işittiren bir bahçeye çeviriniz. S.)
celbîz: Kement, ilmik. * Gammâz, koğucu, ara bozucu.
celbname: Mahkemeye çağırma kağıdı, celb kağıdı.
celbû: Nâneye benzer bir ot, sebze.
celbûb: Sarmaşık (bitkisi.)
celca': Boynuzsuz koyun.
celcele: çan sesi. * Gök gürültüsü. * Depretmek. * Gitmek.
celcelutîye: Peygamberimizin Resul-i Ekremin (A.S.M.) derslerine istinâden, aslı cifir ve ebced hesâbı ile alâkalı olarak Hz. Ali (R.A.) tarafından te'lif edilen Süryânice bir kasidedir. Esas mânası; bedi' demektir.
celd: Lügat mânası, deri üzerine vurmaktır. * Fık: Muhsen olmayan mükellef zâni veya zâniyenin muayyen uzuvlarına vech-i mahsus üzere değnek veya kamçı ile vurmaktır. Bu ceza, mücrimin cildi yani derisi üzerine tatbik edildiği cihetle "celde" adını almıştır.
celda: Sür'at. çabukluk. * şecaat.
celde: Fık: Suç işleyen birisine kamçı veya değnekle bir vuruş.
cele: Başın ön tarafının saçı dökülmek.
celeb: Kesilecek hayvanları ve bilhassa koyun sürüsünü celbederek kasaplara satan tacir. * Tar: îstanbul sarayında ilk işe başlamış olan acemi.
celeb: Fahişe. Orospu. * çan.
celece: (C.: Cülec) Kafa, baş.
celed: Sütü ve yavrusu olmayan büyük deve. * Muhkem yer. * Samanla doldurulup anası önüne koyulan buzağı derisi.
celef: Yerden balçık küremek ve gidermek.
celem: Koyun kırkmakta kullanılan büyük makasın herbir yüzü.
celenfea: şişman karınlı büyük deve.
celenza: Arkası üstüne yatıp ayaklarını kaldıran kişi.
celesat: (Celse. C.) Meclisler, celseler.
celevat: (Cilve. C.) Cilveler. Hüsn-ü zuhûrlar.
celevla': Mekân ismi.
celh: Doldurmak, dolu olmak.
celhe: (C.: Cülâhet) Gidermek. Yerinden ayırmak. * Nâhiye.
celî: Parlak, açık, âşikâr, meydanda. * Kur'an harfleri ile yazılan bir çeşit yazı.
celîb: Satmak için bir yerden toplanılan şeyler. * Esir, köle, cariye. Satılık esir.
celîd: Fazla celâdetli, bahadır. * Rutûbetli, kırağı, çiğ. * Buz.
celîl: Celâlet ve celâdet sâhibi. Azim, mertebesi yüksek.
celîl-üş-şân: şan ve şerefi pek büyük.
celîs: Galiz, kaba nesne. Büyük ve sağlam olan şey.
celîs: Ekseri bir yerde oturan. Arkadaş. Birlikte oturan.
celîyyat: (Celi. C.) Aşikâr, açık, aleni, meydandaki şeyler.
cell: (C.: Cülûl) Yerden birşey toplamak. * Gemi yelkeni.* Yaşlı olmak. * Kadr ve mertebesi büyük olmak. * Celil, büyük, ulu.
cellad: îdama mahkûm olanları idam etmeğe vazifeli olan adam. * Mc: Merhametsiz.
cellale: Necaset yiyen sığır.
celle: Deve ve koyun tersi. * Az olarak insan pisliğinden kinâye olur.
celle: "Celil oldu, celil olsun" meâlinde ve Celle Celâluhu diye, Allah îsm-i Celali işitildiği veya anıldığı anda, tâzim makamında söylenir.
celm: Kesmek, kat'etmek. * Ululuk, büyüklük.
celmed: Kaya. Taş.
celse: Bir meclis veya mahkeme hey'etinin toplanmalarından tâtile kadar olan müzakere müddeti. * Bir def'a akd-i meclis etmek. Oturuş, bir def'a oturmak. * Fık: îki secde arasında bir def'a $ diyecek kadar oturmak.
celse-î alenîyye: Açık oturum.
celu: şakacı, lâtifeci kimse. * Kebap şişi.
celvet: Yerini, yurdunu terketme. * Tas: Abdin fenâfillah olup halvetten ayrılması.
celvetîye: Eskiden mevcud bir tarikat ismi.
celz: Seyretmek.
cem: Hükümdar, melik, şah. * Hz.Süleyman'ın (A.S.) nâmı. * îskender'in bir ismi.
cem': (C.: Cümu) Hurmanın iyi olmayanı. Farklı şeyleri bir yere getirmek mânasına mastar. * Az olarak cemaat için isim olur. * Toplama. Bir yere getirme, biriktirme. Yığma. * Gr: Arabçada (ve tesniye olmayan dillerde) ikiden çok olan şeylere delâlet eden kelime. (Kitabın başındaki cemi' hakkındaki izahata bakınız) * Tas: Bütün eşyayı Cenab-ı Hak ile görerek kendi havl ve kuvvetinden teberri etmek.
cem-î ezdad: Birbirine zıd şeylerin bir arada bulunması.
cem-î müennes: Gr: Müfredinin şeklini bozmadan sonundaki müennes alâmeti olan (e "t") kaldırılıp yerine (ât) getirilir. Müslime(t): Müslimât gibi.
cem-î müennes-î sâlîm: Gr: Sonu ( $ ât) eki ile biten cemi'ler. Meselâ: Müminât: (Kadın mü'minler, mümineler) Sâdıkât, Hafiyyât, Sâlihât gibi.
cem-î mükesser: Gr: Cemi yapılacağı zaman müfredinin şekli bozularak yapılan cemi. Kaide dışı yapılan, kaideye uymadan yapılan cemi. Kitab; kütüb, gibi.
cem-î müzekker: Gr: Müfredinin şeklini bozmadan sonuna (in, ûn) getirilerek yapılan cemi: Müslimin, müslimûn gibi.
cem-î sahîh (sâlîm): Gr: Bu cemi yapıldığı zaman müfredinin şekli bozulmaz. îki türlüdür. Cem-i müzekker, Cem-i müennes. * Mat: Toplama.
cem-î ziddeyn: îki zıddın birlikte bulunması. (Bak: îçtima-ı zıddeyn)
cem-ul cevamî': Eski medreselerde okutulan Dört Hak Mezhebin fıkıh usûlünü içine alan, Usûl-i Fıkh'ın en son kitabı. Müellifi şâfii âlimlerinden îbn-üs Sübki'dir.
cem-ül cem: Gr: Bir defa cemi'olan kelimenin tekrar bir defa daha cemi olması. (Evliya; Evliyalar gibi.) * Tas: Vahdet-i vücuda dalmak. Bekabillah, Cenab-ı Hak'ta fâni olmak.
cemaat: Topluluk. Bir yere toplanmış insanlar. Takım, bölük. * Fık: Bir imama uyup namaz kılan müslümanların heyeti. Bir mezhebe tâbi bir heyet teşkil eden ahali. * Aralarındaki münasebetleri din, örf ve âdetlere göre tanzim eden, akrabalık, komşuluk, hemşehrilik gibi rabıtalarla birbirine bağlı insan topluluğu.
cemaat-i mücellîdân-i hâssa: Tar: Saraydaki kitabları ciltlemekle vazifeli sanatkârlar.
cemaat-î çîlîngîrân-i hâssa: Tar: Saraydaki çilingirlik işlerini yapmakla muvazzaf sanatkârlar zümresi.
cemaat-î hademe-î ehl-î hîref: Tar: Saray işlerini yapmakla vazifelendirilmiş sanatkârlar zümresi.
cemad: Cansız ve kurumuş olmak. * Yağmur yağmayan yer. * Sütü olmayan deve. * Donmuş, katı cisim.
cemadat: Katı cisimler, cansızlar.
cemadî: Ruhu olmayan, cansız madde. Câmid cisim.
cemaet: Her nesnenin şahsı ve cüssesi.
cemahîr: (Cumhur. C.) Cumhuriyetler.
cemahîr-î müttefîka: Birbiriyle anlaşmış, ittifak etmiş devletler. Müttefik cumhuriyetler.
cemahîr-î müttehîde: Birleşmiş devletler. Müttehid cumhuriyetler.
cemal: Yüz güzelliği. Fertteki güzellik. * Cenâb-ı Hakk'ın lütuf ve ihsânı ile tecellisi. * Hak ile söylenen doğru söz. * Hüsün. (... Bir cemal sâhibi, dâima hüsn ü cemalini görmek ve göstermek ister. Bu ise, âhiretin vücudunu ister. çünkü dâimi bir cemâl, zâil ve muvakkat bir müştaka razı olmaz. Onun da devamını ister. Bu da âhireti ister. M.N.)
cemal-î bî-mîsal: Misâli, benzeri olmayan güzellik. (Bak: Celâl)
cemalullah ú: Allah'ın cemâli.
cemam: Rahat olmak. Dinlenip yorgunluğu gidermek. îstirahat etmek.
cemamîh (cemûh): Başı sert, yavuz at.
cem'an: Bir yere toplamak suretiyle, toplanmış olarak.
cem'are: Galiz, kaba nesne. Yüksek taşlar. * Kabile ismi. * Küçük kuş.
cemaş: Kadın ile oynaşan kişi.
cemazîyel ahîr: Arabi ayların altıncısıdır. (Arabi aylar: Muharrem, Safer, Rabiyy-ül-evvel, Rabiyy-ül-âhir, Cemaziyel-evvel, Cemaziyel-ahir, Receb, şaban, Ramazan, şevval, Zilkade, Zilhicce'dir)
cemazîyel evvel: Arabi ayların beşincisidir. * Bir kişinin mazisi, geçmişi.
cemceme: Sözü gizli söyleme, harfleri tâne tâne söyleyip açık beyan edememe.
cemd: Donmak.
cemder: Bir cins bıçak veya kama.
cemed: Dondurmak. * Buz, kar.
cemedî: (Cemed. den) Buz gibi, çok soğuk, bârid.
cemel: Erkek deve. îbil.
cemel vak'asi ": Müslümanlar arasında vuku bulan elem verici ilk muharebedir. Peygamber Efendimizin (A.S.M.) Zevcesi Hz. Aişe (R.A.) ile Aşere-i Mübeşşereden Talha ve Zübeyr'in (R.A.) Hz. Ali'ye (R.A.) karşı kıyamlarından doğmuştur. Bu harpte Hz. Aişe ile Talha ve Zübeyr'in maiyetinde otuzbin; ve Hz. Ali'nin refakatinde yirmibin kişi olduğu hâlde karşı karşıya gelinmiş ve muhârebe sonunda her iki taraftan içlerinde sahabeden birçok zatla beraber onbin kişi şehid edilmiştir. Bu muharebede Hz. Talha ve Zübeyr de şehâdete nâil olmuşlardır. Bu muhârebeye Cemel Vak'ası denilmesinin sebebi: Hz. Aişe'nin mahfelini bir deve üzerine koydurarak ve kendisi ve bu mahfelde gayet mestûre bir şekilde oturup harp yerine maiyetindeki sahabelerle beraber gittiği için ve harbin en şiddetlisi bu devenin etrafında meydana geldiği içindir. (Bak: Sahabe)(Hazret-i Ali (R.A.) zamanında başlayan muharebelerin mâhiyeti nedir? Muhariblere ve o harpte ölen ve öldürenlere ne nam verebiliriz?Elcevap: Cemel Vak'ası denilen Hazret-i Ali ile Hazret-i Talha ve Hazret-i Zübeyr ve Aişe-i Sıddıka (Radıyallahü Teâlâ Aleyhim Ecmain) arasında olan muharebe; adâlet-i mahzâ ile, adâlet-i izâfiyenin mücadelesidir. şöyle ki:Hazret-i Ali, adâlet-i mahzâyı esas edip, şeyheyn zamanındaki gibi o esas üzerine gitmek için içtihad etmiş. Muârızları ise: şeyheyn zamanındaki safvet-i îslâmiye adâlet-i mahzâya müsaid idi, fakat mürur-u zamanla îslâmiyetleri zaif muhtelif akvam hayat-ı içtimaiye-i îslâmiye'ye girdikleri için adâlet-i mahzânın tatbikatı çok müşkil olduğundan, "ehvenüşşerri ihtiyar" denilen adâlet-i nisbiye esası üzerine içtihad ettiler. Münâkaşa-i içtihadiye siyasete girdiği için, muharebeyi intaç etmiştir. Mâdem sırf "Lillâh" için ve îslâmiyet'in menâfii için içtihad edilmiş ve içtihaddan muharebe tevellüd etmiş; elbette hem katil, hem maktûl ikisi de ehl-i Cennettir. îkisi de ehl-i sevaptır diyebiliriz. Her ne kadar Hz. Ali'nin içtihadı musib ve mukabilindekilerin hata ise de, yine azâba müstahak değiller. çünki: îçtihad eden hakkı bulsa iki sevab var. Bulmazsa, bir nevi ibadet olan içtihad sevabı olarak bir sevab alır. Hatâsından mâzurdur. Bizde gayet meşhur ve sözü hüccet bir zât-ı muhakkik Kürdçe demiş ki: $Yâni: Sahabelerin muharebesinde kıyl ü kal etme. çünki hem katil ve hem maktûl ikisi de ehl-i Cennettir.Adâlet-i mahzâ ile adâlet-i izafiyenin izâhı şudur ki: $âyetin mâna-yı işârisiyle; bir masumun hakkı, bütün halk için dahi ibtal edilmez. Bir ferd dahi, umumun selâmeti için fedâ edilmez. Cenâb-ı Hakk'ın nazar-ı merhametinde hak haktır, küçüğüne büyüğüne bakılmaz. Küçük, büyük için ibtal edilmez. Bir cemaatin selâmeti için bir ferdin rızâsı bulunmadan hayatı ve hakkı fedâ edilmez. Hamiyet namına rızasıyla olsa, o başka mes'eledir.Adâlet-i izâfiye ise, küllün selâmeti için, cüz'ü feda eder. Cemaat için, ferdin hakkını nazara almaz. Ehven-üş-şer diye bir nevi adâlet-i izafiyeyi yapmağa çalışır. Fakat, adâlet-i mahzâ kabil-i tatbik ise, adâlet-i izâfiyeye gidilmez, gidilse zulümdür.îşte îmam-ı Ali Radiyallahü Anh, adâlet-i mahzâyı şeyheyn zamanındaki gibi kabil-i tatbiktir deyip, hilâfet-i îslâmiyeyi o esas üzerine bina ediyordu. Mukabilleri ve muârızları ise, "Kabil-i tatbik değil, çok müşkilâtı var." diye adâlet-i izâfiye üzerine içtihad etmişler. Tarihin gösterdiği sâir esbab ise, hakiki sebep değiller, bahanelerdir. M.)
cemen: çardak.
cemerat: (Cemre. C.) Cemreler. şubat ayında azar azar artan sıcaklıklar.
cemh: Sür'at yapmak, hız yapmak. * Huruç etmek, çıkmak.
cemh: Gururlanmak, kibirlenmek.
cem'î: (Cem'. den) Cemiyete mahsus, cemiyetle alâkalı.
cemî': Cümle, hep, bütün. * Gr: çokluk bildiren kelime. çoğul.
cemîan: Bütün, hep.
cemîl: Güzel. * Cenab-ı Hakk'ın isimlerinden biri.
cemîl-î ale-l itlak: (Cemil-i alelıtlak) Her cihetle çok güzel ve mükemmel.
cemîl-î zülcelal: Celal sâhibi, cemil olan Cenab-ı Allah (C.C.)
cemîle: Hoşa gitmek için yapılan hareket.
cemîlekâr: îyilik sever, güzel ahlâk ve huy sâhibi olan.
cemîr: Zaman, dehr.
cemîş: Saçı yolunmuş. * Ot bitmeyen yer.
cem'îyet-î muhammedî: (Bak: îttihad-ı Muhammedi Cemiyeti)
cem'îyyat: (Cemiyet. C.) Cemiyetler.
cem'îyyet: (Cemiyet) Topluluk, birlik. Hey'et. * Bir yere cem' olma. * Mânevi birlik teşkil eden cemaat. * Huk: Kazanç paylaşmaktan başka bir maksadla, ikiden ziyade şahsın ilim ve mâlumâtlarını ve faaliyetlerini devamlı bir şekilde birleştirmek suretiyle bir esas nizamnameye müsteniden ve hükmi şahsiyyeti hâiz olarak kurdukları teşekkül. (T.H.L.) * Tas: Zihnin yalnız Cenab-ı Hak ile meşguliyet hali. * Edb: Tenasübü veya tezadı dolayısıyla birbirine uyan kelimeleri veya zıd olan kelimeleri beraber aynı ifade içinde bulundurmak. (Edebiyat Lügatı'ndan bir misal:Bir tâir-i kudsiyi uçurdun yuvasından.Bir lâne-i sevdayı tebah eyledin ey mevt.Bir tûde türaba çevirip cism-i latifin.Bir haclegehi hâk-i siyah eyledin ey mevt."Tair, uçurdun, lâne, tûde, türab, hâk" lâfızları arasında tenasüb vardır."Bir tûde türab" ile "Cism-i latif" "haclegeh" ile "hâk-i siyah" arasında tezad vardır. Buna, sözün cem'iyyetli olması denilir.
cem'îyyet-î akvâm: (Milletler Cemiyeti) Birinci Dünya Savaşından sonra kurulan ilk Birleşmiş Milletler Cemiyetinin bizdeki adıdır.
cem'îyyet-î hatir: Zihin ve fikrin dağınık olmayıp toplu bulunması. Hasr-ı fikir etmek.
cem'îyyet-î kelâm: Kelâmın câmi olması. Müteaddid mânası bulunan kelâm, söz.
cem'îyyetgâh: Toplantı yeri, toplanılacak yer.
ceml: Yağ eritmek.
cemm: çokluk. Mecmu. * Kuyuda biriken su. * Hırs ve tama ile mal biriktirmek.
cemm-î gafîr: Büyük cemâat, insan kalabalığı. Ekseriyet. * Muhâfızlar.
cemma: Boynuzsuz koyun.
cemmal: Deveci, deve süren, deve sürücüsü.
cemmaz: Hızlı giden.
cemmaz-süvar: Hızlı giden bineğe binen kimse.
cemr: însanların bir araya toplanması. * Atın sıçrayarak yürümesi. * Ateş ve küçük taş vermek. * Bir kimseyi def etmek, kovmak.
cemr-ül gada: Ateşi çok devam eden ağacın ateşinin koru.
cemra: Kuvvetli dişi deve.
cemre: (C.: Cimâr) şiddetli karanlık. * Ateşli kömür parçası, kor. * îlkbaharda suya, yere, havaya düştüğü söylenen sıcaklık. * Hacıların Mina Vâdisinde şeytan taşlamaları.
cemre-î sâlîse: üçüncü cemre ki, toprağa düşer.
cemre-î sânîye: îkinci cemre ki, suya düşer.
cemre-î ulâ: Birinci cemre ki, havaya düşer.
cemrevîyye: Divân şairleri tarafından bayramlar, baharlar gibi cemre sebebiyle, muasır olan büyük makamlı ve rütbeli kişiler için yazılan şiirler.
cemş: Saçı yolmak veya traş etmek. * Gizli ses. * Parmaklarının uçları ile çekmek. * Gazel söylemek. * Oynaşmak.
cemşasb: Hz. Süleyman Peygamber. (A.S.)
cemum: Yorga at. * Yürürken eşinen at.
cena: Yemiş toplamak. * Cem'etmek, toplamak.
cena': Arka yumruluğu. Kamburluk.
cenab: (C.: Ecnibe) Evin etrafı, çevresi. * Cânib. * Nâhiye.
cenab: Büyüklük ifade etmek için, hürmet maksadı ile söylenir. Cenab-ı Hak, Cenab-ı Resül-i Kibriya (A.S.M.)... gibi.
cenab-i hakk: Allah.
cenabet: Pis. Gusletmesi lâzım gelen kimse. * Uzaklık.
cenadîf: şişman, kısa boylu kimse.
cenah: Kanat, taraf, kısım. (Vicdanın ziyası ulum-u diniyyedir. Aklın nuru, fünun-u medeniyedir. îkisinin imtizacı ile hakikat tecelli eder. O iki cenah ile talebenin himmeti pervaz eder. îftirak ettikleri vakit, birincisinde taassub, ikincisinde hile, şüphe tevellüd eder. Mün.)
cenah-i tâîr: Kuş kanadı.
cenah-i zübab: Sinek kanadı.
cenaheyn: (Cenah. dan) îki kanat, iki yan, iki cenah. * îki hususiyetli.
cenaîb: (Cenayib) (Cenibe. C.) Yedek hayvanlar, yedek binekler.
cenan: Gönül. Ruh. Kalb. Can.
cenanî: Kalbe âit ve müteallik olan. Kalben duyulan. (Arabça müfred, birinci şahıs sigası ile "kalbim" mânasınadır.)
cenaze: (C.: Cenâiz) însan ölüsü.
cenb: Yan taraf. Koltuk altının aşağısı. * Def'etmek, kovmak. * Müştak olmak. * Bir yere gitmek için bir yere inmek. * Birisinin sevdiğinden dolayı kararsız ve muztarib bulunmak. * Büyük ve çok olan. * Engin taraf. * şetmetmek, söğmek. (L.R.)
cenbî: Yan tarafa âit.
cenbîyye: Arapların kullandıkları bir cins eğri kamadır ki, yan taraflarına takarlar.
cencene: Sözü burun içinden söylemek, genizden konuşmak.
cendel: Nehirlerde bulunan ve büyükçe olan kaya.
cendere: yun. Tazyik. Baskı, basınç. * Dar dere, boğaz. * Kalın oklava. * çamaşır ütülemeye mahsus iki ağaç üstüvaneden ibaret alet. * Mc: Sıkı ve dar yer.
ceneb: Susuzluktan böğrü ciğere yapışmak.
cenedîl: (C.: Cenâdil) Taşlı yer. * Yuvarlak taş.
cenef: Hata ve cehilden dolayı haktan meyletmek. * Zulmetmek.
cenen: Mezar, kabir.
ceng (cenk): Top, tüfek ile harbetmek. Muharebe. Kavga. Harb. Savaş.
ceng-azmüde: Savaş tecrübesi olan kişi.
ceng-cû: Kavgacı, dövüşçü, cenkçi.
cengaver: (C.: Cengâverân ) Cenkçi. Yiğit olan. Kahraman. îyi harbeden.
cengel: Orman. Ağaç topluluğu.
cengelîstan: Sık ağaçlık, orman, sazlık yer.
cengîz: (Temuçin) Moğol Devleti'nin hükümdarlığını yapmıştır. îslâmi medeniyetleri ve kıymetleri tahribeden zâlim ve müstebid bir hükümdar olarak tarihe geçen bir kimsedir. Milâdi 1229'da ölmüştür. Asrının deccalıdır. (Bak: Celaleddin-i Harzemşah)
cengîzîyan: Cengiz soyundan gelenler, bunlara tâbi olan kimseler.
cenh: Kuşun kanadını vurması.
cenî: Devşirilmiş, koparılmış olan. Meyve toplanması ve alınması.
cenîb: Garip. * Hurmanın iyisi.
cenîbe: (C.: Cenâib) Yedek hayvanı.
cenîn: (Cenne. den) Ana karnındaki harekete başlıyan çocuk. * Gizli ve mestur, saklı olan şey.
cenîver: Sırat köprüsü.
cenk: (Bak: Ceng)
cenk-âver: Harpçi, fedakâr.
cenn: (Cünün) Bir şeyi setretmek, gizlemek. * Ana karnındaki cenin, gizli olmak.
cennân: Bahçıvan.
cennât: (Cennet. C.) Cennetler.
cennât-i adn: Adn cennetleri. Hulûd üzere ikamet ve temekkün edilen cennetler. (Kamus Tercümesi.)
cennet: Allah'a (C.C.) inanan ve O'na ibadet ve itaat edenlerin, iman ve îslâmiyyet'e ihlâs ve sadâkatle hizmet edenlerin, Kur'ana bir hizb-ül Kur'ân olarak mücâhidâne bir sûrette hizmetkâr olan mücâhidlerin, cihâd-ı diniyye erlerinin âhirette fazl-i îlâhi ile gidip ebediyyen içinde kalacakları mekân ve mesken. Cennet'in varlığını bütün peygamberler, onların yolundan giden âlimler ve ermiş kişiler, evliyalar ittifakla haber vermişlerdir. Esasen Allah'ın adaleti, Cehennem gibi Cennet'in de varlığını gerektirir. înananlar, ölümün; ebedi bir hiçlik değil, ölümsüzlüğe geçiş, sevdikleriyle buluşacakları âhiret âlemine bir yolculuk olduğuna inanıyorlar ve bunalım içinde değil; mutluluk içindedirler. înananların ve iyilerin bu hâlleri Cennet'in varlığını gösteren hayattaki belirtilerinden biridir.Cennetin tabakaları: Dâr-ül-Celâl, Dâr-üs-Selâm, Cennet-ül Me'va, Cennet-ül Huld, Cennet-ün Naim, Cennet-ül Firdevs, Cennet-ül Adn, Cennet-ül Vesile. (Bak: âhiret)(Mühim bir taraftan ehemmiyetli bir sual: Rivayette gelmiş ki; Cennet'te bir adama beş yüz senelik bir Cennet verilir. Bu hakikat akl-ı dünyeviyenin havsalasında nasıl yerleşir?Elcevap: Nasılki bu dünyada herkesin dünya kadar hususi ve muvakkat bir dünyası var. Ve o dünyanın direği onun hayatıdır. Ve zâhiri ve batıni duygulariyle o dünyasından istifade eder. Güneş bir lâmbam, yıldızlar mumlarımdır der. Başka mahlukat ve ziruhlar bulunmaları o adamın mâlikiyetine mani olmadıkları gibi bilâkis onun hususi dünyasını şenlendiriyorlar, ziynetlendiriyorlar. Aynen öyle de fakat binler derece yüksek herbir mü'min için binler kasır ve hurileri ihtivâ eden has bahçesinden başka, umumi Cennet'ten beşyüz sene genişliğinde birer hususi Cennet'i vardır. Derecesi nisbetinde inkişaf eden hissiyatıyla, duygularıyla Cennet'e ve ebediyete lâyık bir surette istifade eder. Başkaların iştiraki onun mâlikiyetine ve istifadesine noksan vermedikleri gibi, kuvvet verirler. Ve hususi ve geniş Cennetini ziynetlendiriyorlar. Evet bu dünyada bir adam, bir saatlik bir bahçeden ve bir günlük bir seyrangâhtan ve bir aylık bir memleketten ve bir senelik bir mesiregâhta seyahatından; ağzıyla, kulağıyla, gözüyle, zevkiyle, zâikasıyla, sair duygularıyla istifade ettiği gibi; aynen öyle de, fakat bir saatlik bir bahçeden ancak istifade eden bu fâni memleketteki kuvve-i şâmme ve kuvve-i zâika o baki memlekette bir senelik bahçeden aynı istifadeyi eder. Ve burada bir senelik mesiregâhtan ancak istifade edebilen bir kuvve-i basıra ve kuvve-i sâmia orada, beşyüz senelik mesiregâhındaki seyahattan; o haşmetli, baştan başa ziynetli memlekete lâyık bir tarzda istifade eder. Her mü'min derecesine ve dünyada kazandığı sevablar, haseneler nisbetinde inbisat ve inkişaf eden duygularıyla zevk alır, telezzüz eder, müstefid olur. L.)
cennet-âsâ ": Cennet gibi.
cennetmekân: "Yeri cennet olası, makamı cennet olan" meâlinde olup, vefat eden makbul ve sâlih kimselere hürmeten söylenir.
cennur: Arpa ve buğday döğdükleri yer.
centîlmen: ing. Kibar erkek, çelebi, görgülü kişi.
cenub: Güney. şimalin zıddı olan taraf.
cenubî: Cenuba âit, güney tarafında, cenûba dair ve müteallik.
cephane: (Aslı: Cebehane'dir) Barut vesair yanıcı maddelerin konulup, muhafaza edildiği yer. * Yanıcı maddeler levazımı.
cer: Yarık, çatlak.
cer': Suyu yudumlayarak içme.
ce'r (cuâr): Tazarru etmek, yalvarmak. * çağırmak.
cer'a: Kumlu, otsuz yer.
cera': Suyu sora sora içmek.
cerab: Torba, dağarcık.
cerad: çekirge. * Mc: Yağmacılar gürûhu.
cerade: (C.: Cerâd) çekirge.
cerahat: Yaradan akan irin. Yaralı vücudda toplanan kandaki küreyvât-ı beyzâdan (ak yuvarlardan) mürekkeb kan. Yaradan akan beyaz akıcı cisim.
cerahor: Tar: Osmanlılarda ordu hizmetlerinde kullanılan Hıristiyanlara verilen isim.
ceraîd: (Ceride. C.) Cerideler. Gazeteler.
ceraîd-î yevmîyye: Günlük gazeteler.
ceraîm: (Cerime. C.) Cerimler, suçlar, kabahatlar, cinayetler.
ceraîm-î müştereke: Müşterek işlenen suçlar. Ortak kabahatlar.
cera'kuk (cera'kîk): Ekşi yoğurt.
ceram: Hurma çekirdeği. * Kuru hurma.
cerame: Gövdeli olmak. Vücudu iri olmak. * Cesâmet.
ceramîka: Musul yakınında Acem asıllı bir kavmin adı.
ceraye: Vakıf tarafından verilen erzak ve yiyecek.
cerayet: Câriyelik hâli.
cerazet: Oburluk.
cerba: Uyuz kadın.
cerban: Uyuz hastalığına tutulmuş olan, uyuz.
cerbeya: Mağrib ile şimâl arasında esen yel.
cerbeze: Aldatıcı sözlerle kurnazlık etme. Fazla sözlerle aldatıcılık. Haklı ve haksız sözlerle hakikatı gizleme. * Beceriklilik, fetânet ile temyiz ve cesaret-i mutedile ve kuvvet-i idareden ibâret olan sıfat-ı zihniye.(Bu kelime, Arabçada: Hilekârlık, kurnazlık gibi aşağılayıcı bir mânâda kullanıldığı halde; Türkçede: Beceriklilik ve konuşma kabiliyeti gibi medhedilir bir sûrette geçmektedir.)(... Kuvve-i akliyenin tefrit mertebesi, gabâvettir ki, hiç bir şeyden haberi olmaz. îfrat mertebesi, cerbezedir ki; hakkı bâtıl, bâtılı hak suretinde gösterecek kadar aldatıcı bir zekâya malik olur. Vasat mertebesi ise, hikmettir ki hakkı hak bilir, imtisal eder; bâtılı bâtıl bilir, içtinab eder. î.î.)(... Cerbeze nedir?C- Müteferrik büyük işlerde, yalnız kusurları görmek cerbezeliktir; aldanır ve aldatır. Cerbezenin şe'ni, bir seyyieyi sümbüllendirerek hasenata galib etmektir...Meselâ: Bir aşiretin herbir ferdi, bir günde attığı balgamı, cerbeze ile vehmen tayy-ı mekân ederek birden bir şahısta o muhassalı temsil edip, başka efradı ona kıyas ederek, o nazar ile baksa...Veyahut bir sene zarfında birisinden gelen rayiha-i keriheyi, cerbeze ile tayy-i zaman ederek, bir dakika-i vâhidede, o şahs-ı hâzırda sudurunu tasavvur etse acaba, evvelki adam ne derece mustakzer; ikinci adam ne derece müteaffin... Hattâ hayal, gözünü kapasa, vehim dahi burnunu tutsa mağaralarından kaçsalar, akıl onları tevbih etmeğe hakkı olmayacaktır.îşte şu cerbezenin tavr-ı acibi; zaman ve mekânda müteferrik şeyleri toplar, bir yapar. O siyah perde ile herşeyi temaşa der. Hakikaten cerbeze, envaiyle garâibin makinesidir.Görülmüyor mu ki, cerbeze-âlûd bir âşıkın nazarında, umum kâinat, birbirine muhabbet ile müncezib, rakkasane hareket edip gülüşüyor... veyahut, çocuğunun vefatıyla matem tutan bir validenin cerbeze-âlûd me'yusiyeti nazarında umum kâinat, hüzün-engizâne ağlaşıyor. Tuluât)
cerbeze-âlûd : Cerbezeli. Cerbeze ile olan faaliyet.
cerbîyye: Uyuz böcekleri.
cercar: Yaban maydanozu.
cercer: (C.: Cerâcir) Kağnı.
cercere: Deve sesi.
cercîs: (A.S.): (Circis) Taberi tarihine göre: îsâ Aleyhisselâmdan sonra gelmiş ve Filistinde yaşamış ve onun şeriatı ile amel etmiş olan bir peygamberdir. Yedi sene içersinde tebliğde bulunarak çok işkencelere maruz kalmış, müteaddid defalar öldürülmüş ve mu'cize ile dirilerek tekrar tebliğ vazifesine devam etmiştir. Kendisine düşmanlık eden kavim ateşle helâk edilmiştir. En sonunda yine Cercis Aleyhisselâm şehid edilmiştir.
cerd: Elbisesini çıkarma, elbisesinden soyma, çıplak hâle getirme. * Ot ve ağaç yetişmeyen yer.
cerda: Mahrum, çıplak. * Tüysüz, dazlak. * çorak, verimsiz toprak, arazi. * Karıştırılmamış.
cerdahl: Büyük gövdeli deve. * însanların her işine itiraz eden.
cerdak(a): (C.: Cerâdik) Yufka ekmeği.
cerea: (C.: Cere') Ot bitmeyen kumlu yer.
cereb: Uyuz hastalığı, uyuzluk.
cereb-nak: Uyuz hastalığına tutulmuş kimse, uyuz kişi.
cerec: Yüzüğün, parmağa geniş olması. * Taşlı, sert yer. * Muztarib. Iztırab ve acı çeken.
cerece: Büyük, geniş yol. * Ulu yol.
cered: Yaralı, mecrûh.
cered: çıplak olma.
ceref: Bir kimsenin, kederden dolayı tükrüğünü yutkunup durması.
cerem: Ayrılmak. * Günâh. Cinâyet. * Hurma toplarken yere düşenleri yemek.
cerenfeş: Yanları etli ve büyük olan kişi.
cereng: Kılıç veya topuzun çarpmasından çıkan ses. Zil veya çan sesi.
ceres: çan. * Zindan, hapis yeri. * Hayvanın boynuna asılan çıngırak.
ceres-dar: çıngırak taşıyan, çıngıraklı.
cereş: Bir şeyi iri dövme, iri öğütme.
cerevhak: îplik yumağı.
cereyân: Akma, akış, gidiş. Hareket. Akıntı. Gezme. Mürûr. Vuku, vâki olma. * Mc: Aynı fikir ve gaye etrafında toplananların meydana getirdikleri faaliyet ve hareket. Bu hareket; dini, fikri veya siyasi hareketler gibi birbirlerinden farklı sahalarda olabilir.
cereyân-i hevâ: Hava akımı.
cerez: Davarın art sinirinde olan bir hastalık.
cerez (cürüz): Suyu kesik olan. * Otsuz yer.
cerf: Ahzetmek, almak. * Yıkmak, harap etmek. * Yerden bel veya kürekle bir şey atmak.
cergand: Bumbar dolması denen bir yemek çeşiti. * Işık. Işık konacak yer.
cerge: Bir mevki'de bulunan insan topluluğu.
cerh: Yara. * Baş ve yüzden başka uzuvlardan birisini yaralamak. * Bir kimseye söğmek. Taan etmek. Sözle gönül incitmek. * Birisinin fikrini çürütüp kabul etmemek. * şahid, yalancı ve fâsık olduğundan dolayı mahkemede hâkimin şâhidin şehâdetini reddetmesi. * Kesb u kâr eylemek. Kazanmak.
cerh-î amûd: Bir kimseyi her ne ile olursa olsun, haksız olarak kasden yaralamak.
cerha: Yaralı, yaralanmış.
cerhetmek: Yaralamak. Herhangi bir meseleyi hak ve hakikatle çürütmek. Yanlış veya yalanını bulup hurafe ve bâtıl olduğunu isbât edip herhangi bir kimsenin veya cereyanın fikrini kabul etmemek.
cerî': (Cür'et. den) Cesur, yiğit, delikanlı, gözü pek, cesaretli, yılmayan.
cerî'-ül lîsân: Sözünü esirgemiyen, çekinmeden söyliyen.
cerîb: Uyuz hastalığına tutulan. Uyuz marazına tutulmuş olan. Uyuz.
cerîb: împaratorluk zamanında Arabistan ülkelerinde kullanılan takriben 216 litrelik bir hacim ölçüsü. * Dönüm. * Eni ve boyu 60 arşın olan arazi ölçüsü.
cerîd: (C.: Cerâyid) Hurma budağı. * Yaprağı dökülmüş olan hurma ağacı.
cerîd(e): çorak ve verimsiz yer.
cerîde: Yalnız, tenhâ.
cerîde: Gazete. * Resmi dâirenin büyük hesablarının kaydedildiği defter.
cerîde-î havâdîs: 1840'da çörçil ismindeki bir îngiliz tarafından çıkarılan ilk hususi gazete.
cerîh: (Cerh. den) Mecruh. Yaralanmış, yaralı.
cerîha: Yara. çürüklük.
cerîha-dâr: Cerihalı, yaralı.
cerîm: Kabahatli, câni, suç işlemiş. * (C.: Cirâm) Kuru hurma. * Hurma çekirdeği.
cerîme: Suçludan alınan para cezası, cereme. * Günah, zenb, suç.
cerîn: (C.: Ecrân-Ecrine-Cürün) Hurma kurutma yeri.
cerîr: (C.: Cürür) Devenin boynuna taktıkları ip.
cerîr-î taberî: (Bak: Taberi)
cerîre: Kabahat, suç.
cerîş: îri bulgur. * îri dövülmüş tuz.
cerîz: Tasalı kimse. Hüzünlü, kederli olan kişi.
cerm: (C.: Cürüm) Bir cins Arap sandalı. * Kat'. Kesme. * Günahkâr olma, günah işleme. * Koyun kırkma. * Sıcak, sıcaklık.
cermen: Germen, Alman.
cermüze: Sefer ve misafirlik.
cerr: Kendine doğru çekmek. çekmek. Cezb. * Para almak. * Uçurum. * Kale hendeği.
cerr-î magnem: Menfaat celbetmek.
cerrah: Yarayı açıp tedavi eden, ameliyat yapan. Operatör.
cerrahhâne: Osmanlılarda ordu için cerrah yetiştiren müessese. Yüksek dereceli okul.
cerrahhâne-î âmîre: Geçen asırda yeni usullerle cerrahlık yapılan Osmanlı tıp müessesesi, cerrahhânesi.
cerrahî: Tıpta operatörlük. * Ameliyatla ilgili.
cerrar: Cer yapan, para toplayan. * Yavaş yavaş giden asker alayı veya ordusu. Harp âletleri ile cihazlanmış ordu. * Desti satıcısı. * Ağır ağır giden. * Traktör.
cerrare: Sarı renkte küçük ve zehirli akrep.
cerre: (C.: Cürr-Cirar) Topraktan yapılan desti ve bardak. * Ağaçtan yaptıkları su kabı.
cerre çikma: Eski zamanda medrese talebelerinin, mübarek üç aylar olan Receb, şaban ve Ramazanda köylere dağılıp halka, ahaliye dini nasihatlarda bulunmak, namaz kıldırmak veya müezzinlik etmek suretiyle para ve erzak toplamaları.
cers (cîrs): Gizli ses. * Arının ağaçtan ve çiçeklerden emmesi. * Bir miktar zaman.
cerş: Bir şeyin kabuğunu soyma, bir şeyi kazıma.
cerur: çok miktar yemek.
ceruz: Obur, çok yiyen.
cerv: Küçük meyve. * Vahşi hayvan yavrusu. Enik.
cervel: Taş.
cery: Suyun ve diğer sıvıların akması. Cereyan.
cerz: Kat', kesme. * Yok etme, mevcudiyetini kaldırma. * Katletme, öldürme.
cerze: (C.: Cürüz) Yaş ot bağı.
ce's: Korkutmak, tahvif.
cesa: Bir kimsenin elinin, çalışmaktan dolayı iri ve katı olması.
cesale: çokluk, kesret.
cesamet: îrilik. Büyük olma, cesim olma.
cesaret: Cesurluk, yiğitlik, korkusuzluk.
cesaret-î medenîye: Her türlü baskılara karşı çekinmeden hakikatı söylemek. Müsbet harekette korkmamak. Haklı olduğu bir mes'elede korku göstermemek. îçtimai münasebetlerde girişkenlik.
cesaset: Tecessüs, casusluk. Merak.
cescas: Kılı çok olan. * Bir otun adı.
cesed: Ten, gövde, vücut, beden. Ruhsuz vücud.
cesed-î mîsalî: Misali ve lâtif bir cesed. Varlığı maddi olmayan fakat cinsinin cesedine benzeyen beden.
cesîm: îri vücudlu. * Kebir. Ehemmiyetli. Büyük.
cesîs(e): Hurma ağacının yeni çıkan budağı. (Fesil-ün-nahl derler).
cesk: Mihnet, keder, elem, gam, tasa. * Musibet, belâ, âfet, felâket.
cesl: Kıllı kimse. * çok nesne, kesir.
cesle: Kara karınca.
cesm: Devam etmek, mülâzemet.
cesr(e): Büyük deve.
cess: Koparmak. * Bal mumu. * îçinde arının kanadı ve gövdesi karışmış olan şey.
cess: Araştırma, tahkik etme, soruşturma. * El ile yoklama. * Yapışmak.
cessame: Sefer yapmamış kişi. Seyahat etmemiş kimse.
cessas: Gizli şeyleri araştıran, gizli şeylere merak eden. Tecessüs sâhibi.
cessas : Kireç ile bina yapan. Badanacı.
cessase: Kruvazör, harp gemisi.
cest: Sıçrayış, atlayış.
cestan: Atlıyan, sıçrayan.
ceste: Azar azar, bir parça. * Sıçrayış, atlayış. Hatve.
ceste ceste: Azar azar, parça parça, kısım kısım.
cesten: Atlamak, sıçramak. Kaçmak, kurtulmak. Atılmak.
cesurâne: Yiğitçesine, cesaretli olarak, yüreklice, cesaretle.
cesur(e): (Cesâret. den) Cesaretli, yiğit.
ceş: Mavi boncuk.
ceşa': çok hırslı olmak.
ceşer: Davarı otlamaya çıkarmak.
ceşîb: Kaba ve galiz nesne.
ceşîr: Kir.
ceşîr: Büyük çuval. * Ev önünde davar yürüyecek yer.
ceşîş: Bulgur.
ceşîşe: Bulgur yemeği.
ceşm: Meşakkatli iş buyurmak, zor bir iş söylemek.
ceşn: Ziyafet, şölen. * îd, bayram.
ceşş: Dövmek. * Kırmak. * Vurmak, darp. * Bir nesneyi pâk etmek, temizlemek.
cev: Arpa.
cev-be-cev: Azar azar.
cev'a: Bir kere acıkmak.
ceva': Geniş. * Hasta. * Kokmuş su. * Aşktan, gamdan veya tasadan dolayı kalbin yanması.
cevab: Sorulan şeye söz veya yazıyla verilen karşılık. * Kabul etmemek. Reddetmek. * (Câbiye. C.) Havuzlar.
cevab-i kat'î: Kesin ve kat'i söz, kesin cevap.
cevab-i nâ-savab: Doğru olmayan karşılık. Yanlış cevab.
cevab-i red: Red cevâbı verip kabul etmemek. Reddetmek. Kabul etmemek yolunda söylenen söz.
cevabat: (Cevâb. C.) Cevablar. Sorulan sorulara verilen karşılıklar. Mukabil sözler.
cevaben : Karşılık ve cevap olarak.
cevabî: Karşılık, cevap. * (Câbi. C.) Tahsildarlar, câbiler.
cevad: (Cevvad) çok çok ihsan eden. çok cömert.
cevadd: (Câdde. C.) Caddeler, büyük ve işler yollar, tarikler.
cevahîr: (Cevher. C.) Cevherler. çok kıymet verilen ve az bulunan şeyler, çok kıymetli mâden veya taşlar. * Mc: çok kıymetli söz veya faydalı yazılar.
cevahîr-î ferd: (Cevher-i ferd. C.) Cevher-i ferdler. Zerreler, atomlar.
cevahîr-ül-kelîmat: şemsi adındaki bir zat tarafından Arapçadan Türkçeye kaleme alınan 108 sahifelik bir lügat kitabının adı.
cevaîb: Halk arasında gezen haberler.
cevaîz: (Câize. C.) Câizeler, verilen bahşişler, armağanlar.
cevâmî': Toplu olan şeyler. * Câmi'ler. Mescidler.
cevâmî-ül kelîm: Lâfızları az, mânâsı çok kelâmlar, sözler, ibâreler, fıkralar. (Bak: Câmi-ül kelim)
cevamîd: (Câmid. C.) Cansız, donmuş şeyler.
cevamîs: (Câmus. C.) Camuslar, mandalar, kömüşler, su sığırları.
cev'an: (Cu'. dan) Acıkmış, aç, midesi boş.
cevanîb: (Cânib. C.) Cânibler, yanlar, taraflar.
cevanîb-î erbaa: Dört taraf.
cevar-ül künnes: Seyyar yıldızlar. (ütarid, Zühre, Merih, Müşteri, Zuhal.) (Bak: Hunnes)
cevarî: (Câriye. C.) Akıcı ve câri olanlar. * Hizmetçi kızlar. * Câriyeler, kadınlar.
cevarîh: El, ayak gibi vücud azaları.(Cevârih, cârihanın cem'idir ki, esasen cerhden me'huz olup te'sir mânası mülâhazasıyla kâsibe mânasına isim olmuştur. Cevarih, kevasib demektir. Bunun için el, ayak ve ağız gibi yaralayıcı âlet olan azaya cevarih denildiği gibi, av tutan yırtıcı hayvanlara ve kuşlara dahi kevasib ve cevarih denilir ki, burada murad budur. E.T.)
cevasîs: (Casus. C.) Casuslar. Gizli şeyleri araştıranlar. Gizlilikleri öğrenip bilenler.
cevaz: Müsaadeli. Ruhsat, izin. Câiz olma. * Yol, tarik ve meslek.
cevaz-i şer'î : şer'an câiz olma. şeriatça yasak olmayan husus.
cevazînc: Nilüfer çiçeği.
cevb: Kesmek. * Yırtmak. * Mesafe almak.
cevca': Uzun ayaklı adam.
cevcem: Kızıl gül, verd-i ahmer.
cevder: öküz.
cevdet: îyilik. Güzellik. Kusursuzluk. * Bir kimsenin, başkasının işini güzelce ve kusursuz olarak yapması. * Cömertlik. * Susuz olma.
cevdet-î fehm: Fehm ve anlayış üstünlük ve iyiliği.
ce've: (C.: Cââ-Cevâ) çömlek. * örtü.
cevebe: (C.: Cüveb) Bulut aralığı. * Dağ aralığı.
cevef: Bolluk.
cevelân: Dolaşma. Kaynama. Yerinde durmayıp gezme.
cevelân-i dem: Kanın vücudda dolaşması.
cevelângâh: Gezip dolaşılan yer. Cevelân yeri. Tâlim meydanı.
ce'vet: Kıtlık. * Bir şeyin üzerine örtülen. * üzerine tencere konulan örtü. * çömlek.
cevf: Boşluk. Oyuk. çukur. îç boşluğu. * Orta, yarı. * Kof.
cevf-î leyl: Gece yarısı.
cevh: Akmak. * Koparmak.
cevh: Ulaşmak. * Bittih-i şami denilen karpuz.
cevhan: Hurma kuruttukları yer.
cevher: Bir şeyin özü, esası. * Kıymetli taş. * çelik üzerindeki nakış. * Edb: Noktalı harf. * Yalnız noktalı harflerin ebcedisi hesab edilerek yazılan manzum tarih. * Harflerin noktası. * Fls: Varlığı kendinden olan, var olmak için kendi dışında başka birşeye muhtaç olmayan varlık. Allah'a inanan filozoflar iki çeşit cevher kabul etmişlerdir. Yaratıcı cevher, Allah. Yaratılmış cevher, madde, ruh. Allah'ı cevher olarak vasıflandırmak noksan bir anlayıştır. çünkü cevher Allah'ın sıfatlarından "kıyam-ı binefsihi: varlığı kendinden olan" sıfatını belirtebilir. Allah'ı sıfatları ve isimleriyle tanımak icab eder. Maddeci filozoflar cevher olarak yalnız maddeyi kubul ederler. Oysa madde Allah'ın yarattığı âlemlerden sadece biridir. Fizik ilmi maddenin enerjiye ve enerjinin maddeye dönüştüğünü göstermiştir. Madde de enerji de belli kanunlara bağlıdır. Kanun varsa kanun koyucu da vardır. Madde ve enerjiye hakim olan ve kanunları koyan, madde ve enerjiyi yaratan Allah'dır.
cevher-dâr: Elmaslı. * Noktalı harf. Meselâ: Cim, şın harfleri gibi. * Eskiden kullanılmış tüfeklerden birinin ismi. * Siyah ve beyaz dalgalı, benekli kılıç.
cevher-î ferd: Zerre, en küçük cisim. Atom.
cevher-î ulvî: Ateş, nâr. * En yüksek cevher. * Ruh.
cevhere: Bir, tek cevher.
cevî: Aşk galebesinden gelen şiddet ve hiddet, gam ve gussadan, müzahemeden gelen bir hastalık, maraz. * Kokmuş su.
cevî: Akarsu, nehir, dere, çay.
cevîn(e): Arpadan yapılmış şey. Arpa unu.
cevîr: (Cevr) Cefa, eziyet, sıkıntı, üzüntü. Zulüm. * Tas: Tarikat adamının ruhen ilerlemesine mâni olan şey.
cevl: Tavaf etme.
cevlan: şam'da bir dağ.
cevle: Dönmek.
cevn: Ak, ebyaz, beyaz. * Kara, esved. (Ezdattandır)
cevreb: (C.: Cevârib, Cevâribe) çorap.
cevs: Kaba, büyük nesne.
cevs: Bir şeyi arayıp istemek.
cevsak: Kasr, köşk, konak.
cevse: Köşk, kasr, konak.
cevsek: Düğme.
cevş: (C.: Cevâşin) Demir gömlek. * Göğüs. * Orta.
cevşen : Zırh.
cevşen-î kebîr: Büyük zırh. Peygamberimiz Hz. Muhammed'e (A.S.M.) vahiyle gelen en azim ve en mühim bir münâcâtın ismidir. Bu harika münâcât, mârifetullahda terakki eden bütün âriflerin münâcâtının fevkindedir. Bin hâsiyeti olan ve bin Esmâ-i Hüsnâ'yı içine alan emsalsiz bir münâcât-ı Peygamberiyedir.
cevşen-pûş: Zırhlı, zırh giyen.
cevşîr(e): Arpa çorbası. * çulha.
cevv: Yer ile gök arası. Gök boşluğu. Fezâ. * Ev veya odanın içi.
cevv-î hevâ: Hava boşluğu.
cevv-î semâ: Gökyüzü. Gök boşluğu. Fezâ. (Cevv-i âsuman da denir.)
cevvad: (Bak: Cevâd)
cevval: Dâim hareket hâlinde olan.
cevvaz: Malı toplayıp hayır ve tasadduk etmeyen kimse.
cevvî: Gök boşluğuna âit. Cevve dâir.
cevz: (C.: Ecvâz-Cevzât) Ceviz. * Her nesnenin ortası.
cevz (cevzân): Malı toplayıp kimseye hayır ve sadaka etmemek. * Sallana sallana yürümek.
cevz-î bevvâ: Hindistan cevizi.
cevza: Astr: îkizler burcu. Gökyüzünün kuzey yarım küresinde yer alan iki tane parlak yıldızlı bir burcdur. Güneş, mayıs ayında bu burca girer.
cevzak: Kederlenme, elemlenme.
cevzeka: (C.: Cevzek-Cevâzik) Pamuk kozağı.
cevzekî: Koza satıcısı.
cevzel: (C.: Cevâzil) Güvercin yavrusu. * îğne deliği.
cevzenîc: Cevizli helva.
cevzîne: Cevizli helva.
ce'y: Isırmak.
ceya': Yağmur.
ceyar: Gadaptan ve açlıktan dolayı göğüste olan hararet.
ceyb: (C.: Cüyûb) Cep. Gömleğin (yarığı) açıklığı. * Yaka. * Kalb.* Geo: Sinüs.
ceyd: (C.: Ecyed) Uzun boylu olmak.
ceyder: Kısa boylu.
cey'e: Gelmek.
ceyeşan: Kaynamak. * Hışm etmek.
ceyl: (C.: Ecyâl) însan topluluğu, zümre, kavim. * Nesil, batın, kuşak. * Yengeç.
ceylan: Geyik çeşidinden küçük, ince bacaklı, pek hafif ve çok koşucu bir kara hayvanı, gazâl.
ceyş: Asker, ordu. En az dörtyüz nefer süvari ve piyadeden müteşekkil bir askeri kıt'a. * Dolup taşmak. * Ses, sadâ.
ceyş-ül azîm: Büyük ordu. Binikiyüz kişilik askeri kuvvet.
ceyvad: îttika', günahtan sakınma.
ceyyîd: îyi, güzel, hoş. Saf.
ceyz: Döndürmek. * Dar etmek.
cez: Cezire, ada. Her tarafı su ile çevrilmiş olan kara parçası.
cez': Dereyi enine kesmek.
cez': Ağaç kökü, ağaçların alt kısımları.
cez'(a): Damarlı akik. Göz boncuğu adı verilen, kara alaca ve kıymetli bir süs taşıdır.
cez'a: Az nesne.
ceza: Karşılık, mukabil, ivaz. Cürüm veya günâh işleyenlere verilen azab. * Gr: şart cümlelerinde ikinci kısım. (Bak: şart)
ceza': Hüzünle ağlayıp sızlanmak. Sabırsızlık yüzünden telâş ve teessür göstermek.
ceza': (C.: Cezeân-Cizâ') Altı veya dokuz aylık koyun. (Kurban olması caizdir). * îki yaşına girmiş koyun. * Arslan, esed. * Hayvana yulaf vermeyip hapsetmek.
ceza-üş şart : şartın cevabı. Meselâ: Zeyd ayağa kalkarsa, ben de kalkarım cümlesindeki, "ben de kalkarım" ifadesi, birinci cümlenin cevabıdır.
ceza-yi amel: Yapılan işin karşılığı.
cezaen : Cezâ olarak.
cezaîr: (Cezâyir) (Cezire. C.) Cezireler, adalar. * Kuzey Afrikada Fas ile Tunus arasında olan ülke ve bu ülkenin merkezi olan şehir.
cezâîr-î îsnâ aşer: Ege Denizindeki oniki adalar.
cezalet: Rekâketsiz ifade. * Güzellik. * Müdebbirlik, akıllılık. * Azim, büyük. * Edb: Kelimeler, ince veya sert söylenişlerine göre; elfâz-ı cezle veya elfâz-ı rakika diye ikiye ayrılır. Elfâz-ı cezle: Söylenişte tatlılığı bulunan veya heybet, ululuk, çarpışma, korkutma, yıldırma ifâde etmeğe uygun kelimeler olarak ayrılır. Celâdet, sadme, kazanfer, çekâçek, dırahşân gibi.. Bu çeşit kelimelerle, söylenen ve yazılan ifâdelerde cezâlet var, denir. (Edb. S.)
cezalet-î beyanîye: Beyan ilmine ait ve beyan sahasındaki cezâlet.
cezalet-î nazmîye: Kur'an-ı Kerim'deki kelime ve harflerin harika bir ahenk ve münâsebet ile nazm ve tertibindeki cezâlet.
cezaze: Ekin biçmek. * Hurma kesmek. * Kıl ve yün kırkmak.
cezb: Kendine doğru çekme. * îçme.
cezbe: Tas: Meczubiyet, istiğrak. Allah'ı hatırlayıp Allah sevgisi ile kendinden geçer bir hale gelme.
cezbe-eda: Cezbeli olmak. çekici olmak
cezbedar: Cezbeli, çekici.
cezbetmek: çekmek, ikna etmek, sevdirmek.
cezea: (C.: Cezaât-Cizâ) Beş yaşına girmiş deve. * îki yaşına girmiş koyun. * üç yaşına girmiş sığır ve at.
cezeb: Adamın ağzında tükrüğü kesilmek. * Hayvanın sütü az olmak.
cezebat: (Cezbe. C.) Cezbeler. (Bak: Cezbe)
cezel: Yoğun ve kuru odun ağacı. * Kesmek, kat'.
cezel: (C.: Cezlan) şâd olmak.
cezer: Havuç. * Aslanın yediği et.
cezf: Kesmek. * Sürmek. * Evmek.
cezf (cüzâf): Bir şeyi ölçmeden tartmadan almak.
cezh: Hediye, atâ, bahşiş vermek.
cezîa: (C.: Cezâyi) Koyun sürüsü.
cezîl: Bol. çok. * Edb: Peltek ve bozuk olmayan kelime.
cezîm: (Bak: Cezm)
cezîr: (Bak: Cezr)
cezîre: Ada. Dört tarafı su ile çevrilmiş toprak parçası.(üç tarafı su ile çevrili kara parçasına yarımada denir.)
cezîret-ül arab: Arabistan yarımadası.
cezl: Kalın odun. Tomruk. * Sağlam. Metin. * Güzel ve muhkem fikir. * Rekik olmayıp doğru ve dürüst olan söz veya kelime. * Kâmil, dirayet sahibi, akıllı ve olgun adam.
cezlan: Saadetli, mutlu, sevinçli.
cezm: (Cezim) Kat'i karar. Yemin. Kararlaştırmak. * Kesmek. * Niyet. Tahmin. Takdir. * îlzam. * îcâbe. * Gr: Arabçada kelime sonundaki harfi sâkin okumak. Kur'ân-ı Kerim okurken harfleri yerlerine vaz'edip mahrecinden çıkarırken tâne tâne, fesahat, beyan ve teenni ve sükûnet üzere okumak.
cezm (cîzm): Her nesnenin aslı. * Ağacın kökü. * Kesmek, kat'.
cezma: Kulağı kesik koyun. * Kulağı delik koyun.
cezme: Bir kere yemek.
cezme: Kamçı. * Ağaç parçası. * îp parçası.
cezmen: Kestirip atmak sûretiyle.
cezmî: Kat'i niyet ve karara ait. Cezm.
cezr: Kök, asıl, temel. Bünyâd. * Kesmek. * Mat: Kendi misline darbolunmakla (çarpılmakla) bir sayı meydana getiren rakam (Kare kök). üç, dokuzun cezri'dir. Dokuz, üçün meczuru'dur. (Bak: Meczur) * Derya, deniz. * Arı kovanından bal almak. * Ay ve güneşin câzibesi te'siri ile deniz ve ırmak sularının çekilip kabarması. Buna "med ve cezir" hâdisesi denir.
cezr-î vetedî: Kazık kök. Kazık gibi yere derinliğine giden kök. (Havuç gibi.)
cezre: Kasaplık koyun, keçi gibi davar. * Semiz koyun.
cezrî: Köklü. Kat'i. Köke âit ve müteallik.
cezu' : çok sızlanan, kıvranan, feryad eden. Allah'tan gayrısından imdad bekleyen.
cezur: (C.: Cüzür) Boğazlanacak deve. Hem erkeğe hem dişiye denir. (Boğazlanacak yere meczer derler. Boğazlayan kimseye cezzar derler.)
cezz: Kesmek, biçmek.
cezzab: Fazla çekici olan. Cezub. çok cezbeden.
cezzaf: Ağ ile balık tutan balıkçı.
cezzar: Zâlim. Gaddar. Kanlı. * Deve kasabı.
cihre: (C.: Cihar-Echâr) Bir kimseye sığınmak.
ciranta: yun. Poliçeyi, senedi devir ve havale eden şahıs.
civata: Arkası iri başlı ve ucu somun geçmek üzere yivli vida. Başlıca potrelleri, demir ve tahtaları birbirine bağlamaya yarar.
cîal: (C.: Cüul) Ocaktan çömlek ve tencere gibi sıcak şeyleri tutup indirmekte kullanılan bez.
cîale (ca'yîle): Rüşvet.
cîar: Ucunu bir kazığa bağlayıp bir ucunu da beline bağlayıp kuyuya inilen ip.
cîba: Odun.
cîba: Toplanmış, birikmiş su.
cîbab: Car dedikleri kaftan. * Ağaç aşılamak. (Ekseri hurma ağacında kullanılır.)
cîbah: (Cebhe. C.) Cebheler, alınlar.
cîbal: (Cebel. C.) Dağlar.
cîbal-î mübâha: Huk: Hiç bir kimsenin mülkiyeti altında bulunmayan dağlar.
cîbal-î şâhîka: Yüksek dağlar.
cîbave: Toplamak. Cem'etmek.
cîbayat: (Cibâyet. C.) Vergi, câbilikler, gelir toplamalar.
cîbayet: Vergilerin, devlet gelirlerinin tahsili. * Büyük vakıfların ayrı vazifeliler tarafından idare edilen kısımları.
cîbîll: (C.: Cibillât) Yaratılmak. * însanlardan bir grup.
cîbîllen kesîra: çok insanlar.
cîbîllet: Huy, fıtrat, yaradılış, tabiat, cibilliyet.
cîbîllî: Cibilliyet. Yaratılıştan olan. Asıl maya, huy, tabiat, tıynet.
cîblet: Yaratılmak.
cîbr: Az-çok, zorla olgunlaşmak, kemal bulmak.
cîbrîl: Cebrâil, Ruhül Kudüs. Cenâb-ı Hakdan (C.C.) Peygamberimize (A.S.M.) vahiy getiren melek.
cîbs: Kansız, hissiz. Hayırsız, alçak kimse. * Alçı taşı, kireç.
cîbt: Put, sanem, salib.
cîbve: Toplamak. Cem'etmek.
cîd: Gerdan. Süslemeye lâyık boyun. Güzel boyun.
cîdad: Hurma kesecek vakit.
cîdal: Sözle mücadele. Ateşli konuşma. Niza. * Muharebe. Cenk. Kavga.
cîdalcu: Harpçi. Kavgacı.
cîdale: (Bak: Cedalet)
cîdar: Duvar. * îki yeri birbirinden ayıran zar, perde.
cîdd: çalışmak. Ciddiyetle yapmak.
cîdden: şaka olmayarak. Gerçekten. Ciddi olarak.
cîddî: Gerçek. Hakikat. * Ağırbaşlı, hâlleri sakin olan kişi. * Mühim.
cîddîyat: Hakiki sözler. Ciddiyetler.
cîddîyet: Ciddilik. * Ağırbaşlılık, sakin hâllilik. * Ehemmiyet.(Ahlâk-ı âliyeyi ve yüksek huyları hakikata yapıştıran ve o ahlâkı daima yaşattıran, ciddiyet ile sıdktır. Eğer sıdk kalkıp araya kizb girerse, rüzgârlara oyuncak olan yapraklar gibi, o adam da insanlara oyuncak olur. î.î.)
cîde: Batı Karadeniz bölgesinde Kastamonu vilâyetine bağlı bir ilçe.
cîf: ing. Bir malın fiyatına, nakliye ve sigorta ücretinin de katılmış olduğunu gösteren bir kısaltma.
cîfan: (Cefne. C.) çanaklar.
cîfar: (Cefr. C.) Geniş kuyular.
cîfe: Kokmuş et, ölü hayvan, leş.
cîfe-gâh: Leş ile, lâşe ile dolu olan yer.* Mc: Dünya.
cîfne: (C.: Cifnân) On kişi doyabilecek kadar büyük çanak ve büyük tas. * Bağ çubuğu.
cîfr: (Cefr) Harflere verilen sayı kıymeti ile, geleceğe veya geçen hâdiselere, ibarelerden tarih veya isme dâir işaretler çıkarmak ilmidir. (Bak: Ebced, îlm-i Cifir)
cîğer: Ciğer. Bağır. * Keder, sıkıntı, elem. * Avaz.
cîğer-dâr: Yürekli, ciğerli, cesâretli.
cîğer-der: Ciğer söken, ciğer parçalıyan.
cîğer-dûz: Ciğeri delip geçen.
cîğer-fürûş: Ciğerci, ciğer satan.
cîğer-gûşe: Evlât, yavru. * Sevgili. Mâşuk.
cîğer-hûn: Ciğeri kanlı. çok acıklı.
cîğer-pâre: Sevgili yavru, evlâd.
cîğer-sûz: çok acı. Ciğer yakar derecesindeki teessür.
cîğer-şükâf: Ciğer parçalayan. çok acı veren.
cîhad: (Cehd. den) Düşman ile muharebe. îlim ve imanla, sözle, fiile, mal ve canla bütün kuvvetini sarf etmek. Allah (C.C.) yolunda muharebe. Din için çalışmak. Erkân-ı imâniye ve esasât-ı diniyeyi muhafaza ve imânı takviye için cehd ve gayret etmek. şeriat-ı Garrâ'nın ahkâmını muhafaza, Kelimetullah'ı i'lâ, küfr-ü mutlakın ve küffarın (süfyan ve deccalın) fitnelerini def ile hâkimiyet-i Hakkı te'min eylemek. (Bu mücahede, zamanımızda kılıçla değildir. Kılıçla olan cihad, din hükümlerinin câri olduğu dar-ı îslâmın hâricinde yapılabilir. Bununla berâber bu mezkur maddi ve mânevi cihad, değişen şartlara bağlıdır.)Kur'an-ı Kerim'de 9. sûrenin 24. âyetinin çok kısa bir meâli şöyledir:"De ki: Eğer babalarınız, çocuklarınız, kardeşleriniz, zevceleriniz, akraba ve kabileniz, elinize geçirdiğiniz mallar, kesada uğramasından korktuğunuz bir ticaret ve hoşunuza giden meskenleriniz, evleriniz size Allah ve Resulünden ve Allah yolunda cihaddan daha sevgili ise, artık Allahın emri (lâyık olduğunuz cezası ve felâketi) gelinceye kadar bekleyin. Allah öyle fâsıklar güruhunu hidâyete erdirmez."Cihada dair pekçok âyet-i kerimeler ve hadis-i şerifler vardır.(Cihâd-ı diniye farzdır; bu zamanda muzaaf farz-ı ayndır. M.)(Cihad, mertebe-i şehadetin merdivenidir. Lemeât.)(Bütün ümmet için ve bilhassa, îslâm ve Kur'an hizmetinde fedakâr ve sebatkâr çalışan mücâhidler için dâima tazeliğini koruyan Tebük Seferindeki bir hâdiseyi, bazı kısımlarını aynen alıyoruz.Bu hâdisede, çok çeşitli ders ve ibretler vardır. Ezcümle: Maddi ve manevi cihadda, bir tekâsül ve ihmâlin bilhassa kendi şahsi hayatına temâyül gösterip özürsüz olarak cihaddan geri kalmakla, mücâhid cemaatin cihad ruhuna ve fedakârâne sebatına fütur getirmek ve kuvve-i mâneviyeyi kırmağa sebep olmak gibi büyük mes'uliyetler bulunduğundan, cihad ruhuna zararlı düşen bu gibi fiil ve hareketler, cemaatça ve bilhassa ileri gelen kimseler tarafından takbih edilerek, bu tarz hissiyatların inkişafına meydan vermemek.Hem ihlâs ile ve sadece Allah rızası için çalışmanın şiddetli imtihanlarından geçmekle azami sadakat dersini vermek gibi ehemmiyetli çok hikmetleri ihtivâ eder:(...Resulullah ile müslümanlar, gaza hazırlığıyla meşgul oldular. Ben de onlarla beraber yola hazırlanmak için sabahleyin evden çıkıp dolaşırdım. Hiçbir iş görmeden akşam üzeri döner gelirdim. Ve kendi kendime: "Hazırlanmağa kudretim, vaktim müsaittir." derdim. Bu ihmâlcilik bende durmayıp devam etmişti.Resulüllah gazaya gittikten sonra çarşıya, pazara çıktığım ve halk arasında dolaştığım sıra beni en fazla mahzun ve mükedder eden bir şey vardı. O da halk arasında (imanı yerinde, vücudu zinde kimse) görmemekliğim; ancak ya nasiyesine nifak damgası vurulmuş kimselerden bir kişi yahut da mâlül olup da Allah Teâlâ'nın mazur gördüğü bir mü'min görürdüm.Sonra Resulüllah bir sabah Medine'ye teşrif buyurdu. Resulüllah bir seferden geldiğinde ilk iş olarak mescide girmek ve orada iki rekât namaz kılmak, sonra halkın: Hoş geldiniz temennilerini kabul etmek için oturmak itiyadında idi. Bu defa da bu âdetini yerine getirip mescidde oturunca Tebük Seferi'ne gitmeyip arda kalanlar Resulüllah'a gelerek özür dilemeye ve yemin ile özürlerini te'yid etmeğe başladılar. Bunlar seksen kadar er kişiydiler. Resulüllah bunların hallerine göre özürlerini ve biatlerini kabul ve onlar için istiğfar buyurdu. Ve bunların iç yüzünü ve hakikatını Allah Tealâ'ya havale eyledi. Bu arada ben de huzura geldim. Ve Resulüllah'a selâm verince gazablı bir tebessümle gülümsedi. Sonra bana: Gel dedi. Ben de yürüyüp vardım, tâ önünde oturdum. Bana: "Seni nasıl bir mâni geri bıraktı? Sen Akabe'de arkana biat almış değil mi idin?" buyurdu. Ben de şöyle cevap verdim: "Evet, vallahi, Ya Resulüllah! Size nusret etmeğe söz verdim. Vallahi benim seferden tahallüfüm hakkında arzedecek hiç özrüm yoktur. Vallahi ben sizden geri kaldığım zamanki kadar hiçbir vakit daha kuvvetli ve daha suhûletli değildim." Bu maruzatım üzerine Resulüllah (A.S.M.) "Hakikaten bu, doğru söyledi. Ey Ka'b! Haydi kalk; Allah hakkında hükmedinceye kadar bekle!" buyurdu.Resulüllah, kendisinden seferde geri kalanlardan bizim işte şu üçümüzle konuşmaktan müslümanları nehyetti. Halk da bizden çekindiler ve bize yüzlerini ekşittiler. Hatta bana yeryüzü yabancılaştı, bu hakidan benim bildiğim toprak değildi. Bu hâl üzere elli gün kaldık. îki arkadaşım halktan çekildiler ve evlerinde oturup ağlamakla vakit geçirdiler. Fakat, ben onların daha genci ve daha salâbetlisi idim. Bu cihetle ben evimden çıkardım. Ve mescide gidip müslümanlarla beraber namazda hazır bulunurdum. Ve sokaklarda, çarşıda dolaşırdım. Halbuki hiçbir kimse bana söz söylemezdi. Namazdan sonra Resulüllah'ın meclisine varır ve kendine selâm verirdim. Ve içimden: Acaba Resulüllah selâmıma mukabele ederek dudaklarını oynattı mı, yoksa oynatmadı mı? derdim. Sonra namazı Resulüllah'ın yakınında kılardım da gizlice onu gözetlerdim. Namazıma yöneldiğim sıra o bana doğru dönerdi. Fakat ben onun tarafına bakınca da yüzünü çevirirdi. Nihayet halkın cefasından ıztırab çektiğim bu hâl uzayınca bir gün gittim. Tâ Ebu Katâde'nin bahçe duvarından aştım. Ebu Katâde, amcam oğlu ve halk arasında beni en çok seven bir zat idi. Vardım, ona selâm verdim. Vallahi selâmımı almadı. Ben: "Ey Ebu Katâde! Allah adına and vererek sana sorarım: Benim Allah'ı ve Resulüllah'ı sevdiğimi bilir misin?" dedim. Sustu, cevap vermedi. Tekrar and verdim. Allah aşkına sordum. Yine sükut etti. üçüncü bir daha Allah adına and verdim. Bu defa: "Allah ve Resulü daha iyi bilir!" dedi. Bunun üzerine gözlerimden yaş boşandı. Artık döndüm, duvardan aştım.Kâ'b bin Mâlik rivayetine devam ederek der ki: Birgün Medine çarşısında gidiyordum. Medine'ye zahire satmağa gelen şam ahalisinden nebeti bir fellâh, bir ekinci: "Ka'b bin Malik'i bulmağa bana kim delâlet eder?" diye soruyordu. Bunun üzerine halk ona beni göstermeğe başladılar. Nihayet nebeti kişi bana geldi. Ve Gassan Meliki'nden bir mektup verdi. Bakınca: (Emma ba'dü) den sonra bu mektupta şöyle yazıldığını gördüm: Haber aldığıma göre sahibin (Peygamber), sana cefa ve eza ediyormuş. Allah seni hakaret görecek ve hakkın zayi olacak bir mevkide tahkir ve tezlil için yaratmamıştır. Orada durma, bize gel! Sana şânına lâyık bir surette hürmet ve ihsanda bulunuruz. Bu mektubu okuyunca, bu da öbürüsü gibi bir belâdır, dedim. Hemen bu sayfayı ocağa attım, ocakta yaktım.Nihayet bu elemli elli günden kırk günü geçtiğinde bir gün baktım ki Resulüllah'ın gönderdiği bir zat, (Huzeyme bin Sâbit) bana geliyor. Huzeyme gelip, bana: "Resülullah sana kadınından ayrılmanı emrediyor!" dedi. Ben de: "Kadınımı boşayacak mıyım, yoksa ne yapacağım?" dedim. O da: "Hayır, boşama, yalnız ondan ayrı bulun, kadınına yaklaşma." dedi.Resulüllah, Huzeyme ile iki arkadaşım Murar ile Hilâl'e de bunun gibi emir göndermişti. Bu emir üzerine kadınıma, haydi ehline (baban ailesi yanına) git, Allah bu iş hakkında hükmedinceye kadar, onların yanında bulun! dedim.Bundan sonra on gün daha durdum. Tâ ki Resulüllah'ın bizimle halkı görüşmekten menettiği tarihten itibaren elli günümüz dolmuştu. Vakta ki ellinci günün sabahında sabah namazını kıldım. Ve evlerimizden birinin damı üzerinde bulunuyordum. öyle bir hâlde bulunuyordum ki, Allah Telâlanın (Tevbe sûresinde) zikrettiği vechile hayatım bana güçleşmişti. Ve yeryüzü bütün genişliği ile başıma dar gelmişti. îşte bu sırada Sili dağı üzerinde en yüksek sesiyle: "Ey Ka'b bin Mâlik, müjde!." diye olanca kuvvetiyle bağıran birisinin sesini işittim. Hemen secdeye kapandım. Ve anladım ki darlık gitmiş, genişlik gelmiştir. Ve Resulüllah sabah namazını kıldığı zaman Allah'ın bizim üzerimize tevbesini (nedametlerimizin kabulünü) ilân etmiştir de, halk bize müjdelemeğe koşmuştur. Arkadaşlarım tarafına da bir takım müjdeciler gitmişlerdi. Bana da bir kişi (Zübeyr bin Avvam) müjdelemek üzere atını sürmüştü. Ve Eslem kabilesinden bir müjdeci (Hamza bin Amr) da koşup Sili dağının üstüne çıkmıştı. Bunun sesi attan sür'atli idi. Sevimli sesini işittiğim bu müjdeci bana gelince üzerimdeki iki kat elbisemi hemen çıkarıp müjdelik olarak ona giydirdim. Vallahi o gün bundan başka elbisem yoktu. (Ebu Katade'den) iğreti iki kat elbise alıp giydim. Hemen Resulüllah'a (A.S.M.) koştum. Ashab, beni takım takım karşıladılar. Tevbemin kabulünü (günahtan beraatimi) tebrik ediyorlar ve: Allahın, tevbeni kabul buyurması sana kutlu olsun! diyorlardı.Ka'b rivayetine devam ederek der ki: Nihayet mescide girdim. Resulüllah oturmuştu. Etrafında ashab çevrelenmişti. Hem Talha bin Ubeydullah kalktı, koşarak geldi, musafaha etti, elimi sıktı ve beni tebrik etti. Vallahi muhacirlerden Talhadan başka kimse bana ayağa kalkmadı. Talha'nın bu lütfunu unutmam.Ka'b der ki: Vaktaki Resulüllah'a (A.S.M.) selâm verdim. Mübârek yüzü meserretten şimşek çakar gibi şakır bir hâlde bana: "Bir günün hayır ve saâdeti ile müjde sana ey Ka'b ki, annen doğurduğu günden beri yaşadığın günlerin en hayırlısı!" buyurdu. Ben: "Yâ Resulallah! Bu tebşir, tarafınızdan mı, yoksa Allah tarafından mı?" dedim. Resulullah: Hayır, benim tarafımdan değil, doğrudan Allah tarafından! buyurdu. Esasen Resul-ü Ekrem, taraf-ı îlâhiden tesrir buyurulduğu zaman mübarek yüzü parlardı, hatta o, bir ay parçasına benzerdi. Biz de meserretli bir vahiy geldiğini onun bu sevimli simasından anlardık.Vaktaki Resulüllah'ın huzurunda oturdum. - Ya Resulallah, Allah ve Resulullah'ın rızası için halis sadaka olmak üzere malımdan sıyrılıp çıkmak ve malımın hepsini fukaraya dağıtmak istiyorum. Bu istek, tevbemin kabulü icabındandır dedim. Resulullah (A.S.M.): "Hayır, malının bir kısmını kendine alıkoy. Bu senin için daha hayırlıdır!" buyurdu. Ben de "şu Hayber'deki hissemi alıkorum" dedim.) (S.B.M.)
cîhad-i asgar: Küçük savaş. îslâm müdâfaası için silahla savaşma.
cîhad-i ekber: Nefis ile mücadele.
cîhad-i manevî: îlim, fikir, istiğfar gibi manevi unsurlarla din düşmanlarına karşı koymak.
cîhadî: (Cihadiyye) Cihada mensub, savaş işleriyle alâkalı. * II. Sultan Mahmud devrinde harp masraflarına mukabil olmak üzere kesilmiş olan sikke.
cîhan: Dünya, kâinat, âlem.
cîhan-ârâ: Cihanı süsliyen, dünyayı bezeyen.
cîhan-bân: Cihanın bekçisi, dünyanın koruyucusu olan. Allah. Hükümdar.
cîhan-bîn: Dünyayı, cihanı gören. Allah. * Göz.
cîhan-cu(y): Dünyaya hâkim olmaya çalışan sultan, hükümdar.
cîhan-değer: Cihan kıymetinde. çok kıymetli.
cîhan-dîde: Cihanı görmüş. Tecrübeli. * Meşhur, nâmdar.
cîhan-efruz: Cihanı, dünyayı aydınlatan.
cîhan-füruz: Cihanı aydınlatan.
cîhan-gerd: Dünyayı dolaşan, cihanı gezen.
cîhan-gîr: Meşhur, cihanı zabteden, fâtih.
cîhan-nevred: Cihanı gezen, dünyayı dolaşan.
cîhan-nüma: Dünyayı gösteren harita veya coğrafya. * çatının üzerinde her tarafa nezareti olan açık taraça. * Meşhur Türk âlimi Kâtib çelebi'nin 1654 (Hicri: 1065) tarihinde çizdiği Asya Kıt'asının haritası.
cîhan-penah: Cihanın koruyucusu olan.
cîhan-pesend: Cihana meydan okuyan.
cîhan-sâlâr: Cihanın başkanı, büyüğü ve kumandanı olan, padişah.
cîhan-sîtan: Cihanı zapteden. Padişah, hükümdar.
cîhan-sûz: Cihanı yakan, güneş. * Mc: çok zulmeden.
cîhan-şümûl: Cihan vüs'atinde, dünya çapında, cihanı alâkadar eden. Dünyayı kaplayan.
cîhanîyan: Dünya ahalisi olan insanlar.
cîhar: (Bak: çâr)
cîhar: (Cehr. den) Sesle, sadâ ile ve alenen söyleme ve okuma.
cîhar-i yar-i güzîn: Dört halife: Hz. Ebu Bekir, Hz. ömer, Hz. Osman ve Hz. Ali (R.Anhüm)
cîharen: (Cehr. den) Alenen, açık olarak.
cîhas: Kalabalık, müzâhame.
cîhât: (Cihet. C.) Cihetler, taraflar, yönler.
cîhât-i erbaa: Dört cihet.
cîhât-i selase: üç uzunluk: En, boy, yükseklik.
cîhât-i sîtte: Altı cihet. Altı taraf. (îleri, geri, sağ, sol, yukarı, aşağı taraflar.)
cîhaz: âlet ve edevat.* Gelinin lüzumlu şeyleri. çeyiz. * Cenazenin kaldırılması için lâzım olan eşya.
cîhazat: (Cehâzât) (Cihâz. C.) Cihazlar, maddi manevi âletler, lüzumlu edevat.
cîhet: (C: Cihât) Yan, yön, taraf. * Sebeb, mucib. * Vesile, bahane. * Evkafça olan vazife, maaş. * Yer, mahâl, semt.
cîhet-î rüchanîyet: üstünlük ciheti.
cîhet-ül vahdet: Birlik ciheti.
cîhet-ül vahdet-î îttîhad: Birleşmenin birlik ciheti. Yani birleştiren temel unsur. Birleştiren ve birleşilen esas.
cîhnam: Derin kuyu.
cîl: Cemaat, insan güruhu. Millet. Boy, aşiret, kuşak.
cîlâ: Parlaklık, parlatma, perdaht, lostura.
cîlâ-bahş: Parlaklık veren, parlatan.
cîlahîk: Eskiden kemankere ile ve şimdi de tüfek ile atılan yuvarlak nesne.
cîlanger: çilingir.
cîlas: Beraber oturma.
cîlaz: Kamçının ucuna bağlanan kayış.
cîlaz: Toz, gubâr.
cîlbab: Kadın feracesi. çarşaf. (Bak: Celâbib, Tesettür)
cîlbend: Büyük cüzdan. Evrak koymaya mahsus birçok gözlere ayrılmış cüzdan şeklinde çanta ki, koltuk altına alınır.
cîld: Deri. * Meşin. * Kitab kabı. * (Masdar olarak) Kitabın dikilip kap geçirilmesi. * Bir büyük kitabın bölündüğü kısımların her biri.
cîld-ger: Ciltçi, mücellit.
cîldîyye: Cilt hastalıkları bölümü.
cîlen ba'de cîlîn: Devirden devire, asırdan asıra.
cîlf: Boş küp.* Kırılmış, ufanmış köpek esfeli. Arı kovanı. * Kuru ekmek parçası. Kuru ekmek kenarı. * Yüzülüp karnı çıkmış ve başı ile ayağı kesilmiş koyun. * Her nesnenin parçası. * Hoyrat, kaba. Ayak takımından.
cîlfe: Kalem yongası.
cîlhabe: Büyük olan şey, kebir.
cîll: Ekin biçildikten sonra yerde kalan sap ki, "anız" derler.
cîlle: Büyük, ulu nesne. Kebir ve azim.
cîllevez: înce kabuklu, uzunca fındık. * Köknar.
cîlm(e): üzüm çubuğundan kestikleri değnek.
cîlnar: (Cüllenâr) Gülnar. Nar çiçeği.
cîlse: Bir çeşit vurmak.
cîlt: (Bak: Cild)
cîlvah: Geniş ve dolu olan deve.
cîlvaz: (C.: Celâvize) Kethudâ. Reis.
cîlve: Esmâ-i îlâhinin tecellisi. * Tecelli. * Güzellere yakışır duruş ve davranış. Dilberâne hareket. Naz ve edâ. Hoşa giden görünüş.
cîlve-î îrâde: îrâde ve kasdı gösteren tezahür ve tecelli. Cenab-ı Hakkın kendi bizzat isteği ve iradesiyle yaptığını gösteren oluş ve intizam, mükemmeliyet. (însanın nasıl ruhu bütün cesedine özel bir münasebeti var ki: Bütün âzâsını ve eczasını birbirine yardım ettirir. Yani: îrade-i îlâhiye cilvesi olan evâmir-i tekviniyeye ve o emirden vücud-u harici giydirilmiş bir kanun-u emri ve lâtife-i Rabbaniye olan ruh onların idaresinde onların manevi seslerini hissetmesinde ve hâcatlarını görmesinde birbirine mâni olmaz, ruhu şaşırtmaz. S.)
cîlvegâh: (Cilve-geh) Cilve edilecek yer, cilve yeri.
cîlveger: Cilve ve naz eden. Cilveli. * Tecelli eden.
cîlvekâr: Cilveli. Nâzenin.
cîlvekünân: Cilve yaparak.
cîlvenümâ: Cilve yapan, cilve gösteren, cilve eden.
cîlvesaz: Cilveli. Nazlı. Gönül alan.
cîlvezet: Mâni olmak. Men'etmek.
cîlz: Süngü demiri. * Kamçının ucundan tuttukları yer.
cîlze: (C.: Cilzâ) Sert ve sağlam yer.
cîm: ( harfinin arapça adı olup ebced hesabında üç sayısının karşılığıdır.
cîm: Gulamperest olan kimse.
cîma': Cinsi münâsebet. çiftleşmek. * Zamm etmek.
cîmah: Binicisi zabtedemediğinden, atın serkeş olup binicisini istememesi.
cîmal: (Cemel. C.) Erkek develer.
cîmam: Kuyu içinde suyun toplanması ve çoğalması.
cîmar: Toplu kabile. * Süvari alayı.
cîmnastîk: yun. Vücud organlarını alıştırıp kuvvetlendirmek için yapılan idman. Beden terbiyesi.
cîmrî: Hasis, varyemez, pinti. Elindeki mal veya parayı harcayamıyan ve türlü sıkıntılara katlanarak daha çok biriktirmeye çalışan kimse. Cimrilik, müsriflik (savurganlık) gibi îslâmda kötü huy olarak bilinir. Cömertlik ve tutumluluk ise övünülen ahlâki vasıflardandır. Cömertlikte de ölçülü olmak tavsiye edilir. Başkasına muhtaç duruma düşürecek cömertlik de doğru değildir. (Bak: îktisad)
cîmse: Rengi gökrek kızıllığa yakın kıymetli bir taş.
cîn: (Bak: Cinn)
cînab: Hayvanlara vurulan damga ve nişan.
cînaî: (Cinâiyye) Cinayetle alâkalı.
cînan: (Cennet. C.) Cennetler.
cînan-i ulûm: îlm-i Kur'ân ve imân cennetleri. Maarif-i îlâhiye ve tahkiki ve yakini imân derslerinin okunduğu ulemâ-i îslâm ve talebe-i ulûm meclisleri.
cînare: Esterâbâd ile Cürcân arasına derler.
cînas: Benzeyiş, münâsebet. * Edb: Birçok mânâya gelebilen söz, imalı, telmihli söz. telâffuzu bir, mânası ayrı olan kelimelerin bir sözde bulunması. Bunu yapmaya "tecnis" denir, o kelimelere de "cinas" denir.
cînas-i muharref: Edb: Yalnız harflerde beraberlik, harekelerde ayrılık bulunan cinâs. (merd, mürd gibi.)
cînas-i nâkis: Edb: Cinaslı kelimelerin birinde veya birkaç harfin ziyade olması suretiyle yapılan cinas. (dem, âdem gibi.)
cînas-i tamm: Edb: Lâfızda, harekelerde ve harflerde eksiklik ve ziyâdelik bulunmayan cinâs. Kır (kırmaktan emir), kır (çöl); yaz (yazmaktan emir), yaz (mevsim).
cînayat: (Cinayet. C.) Büyük cezâları gerektiren suçlar. Cinayetler.
cînayet: Adam öldürmek, katl. (Bak: Câni)
cînayet-kâr: Cinayet işleyen.
cînaze: Tabut. îçine cenaze konulan sandık.
cîncîn(e): (C: Cenâcin) Göğüs kemiği.
cînh: Gece karanlığı.
cînn: Bir cins ateşten yaratılmış olup, dünyanın insandan sonra en mühim sekenesidir. Akıl ve şuur sâhibi olup pekçok şer ve isyan yapabildikleri gibi "Peygamberlerin ve semâvi kitabların irşadlarıyla" insana yetişememekle beraber terakki edip yüksek kemâlatlara çıkabilen mahluktur. însanlar gibi dinin bir kısım emirlerini yapmakla ve bazı yasaklarından kaçınmakla yükümlüdürler. Kıyamet ve haşirden sonra cinlerden de dünya imtihanını kazananlar Cennet'e, kaybedenler Cehennem'e girecektir. Kâinat ve içindeki bütün varlıklar hakkında, en birinci söz söyleme hakkı; onların yaratıcısı ve mâliki olanındır. çünki "Yapan bilir, öyleyse bilen konuşur" bir kaidedir. Cinlerin varlığını da, evvelâ; Kur'an-ı Kerimden öğreniyoruz. Ayrıca Peygamberimiz Resul-ü Ekrem'den (A.S.M.) gelen sahih rivayetler ve ashabının cinleri görmesi ve görüşmesi hâdiseleri de pek çoktur. Cinlerin pekçok cinsleri vardır. Bunlar lâtif yaratıklar oldukları için gaybi haberler getirmekte kullanılabilirler. Fakat Hazret-i Peygamber'den (A.S.M.) sonra cinlerin gaybi âlemden haber hırsızlamaları Cenab-ı Hak tarafından menedilmiştir.Cinlerin, kötülüğe sevkedenlerine şeytan-ı cinni de denilir. * Lügatta: Bir şeyi hisseden, setretmek, gizlemek mânasına gelir.
cînn sûresî ": Kur'ân-ı Kerim'in 72. sûresi olup Mekke-i Mükerreme'de nâzil olmuştur.
cînnet: Delilik.
cînnî: Cinn taifesinden olan.
cîns: Nevi'. Boy, soy, kavim, kabile. Aynı çeşitten olmak.
cîns-î latîf: Lâtif ve hoş cins, nev. însanlar nev'inde kadın.
cînsî: Zırh yapıcı.
cînsî: Cinsle ilgili, cinsle alâkalı.
cînsîyet: Bir kavim ve kabileye mensub olma. * Bir cins ile alâkalı olma.
cînun (cînan): Gece karanlık olmak.
cînzab: Yaban havucu.
cîr: Aşağı, alt. * Eldiven, kayış vs. gibi şeyler yapılabilen tabaklanmış deri.
cîrab: (C.: Ecribe-Cireb Cerbân) Dağarcık.
cîraha: (C.: Cirâh-Cirâhât) Yara.
cîran: Komşular. * Müşteriler.
cîran: (C.: Cürün) Devenin boynunun önünde boğazlanacak yerinden boğazı çukuruna kadar olan yer.
cîranta: yun. Bir senedi ciro eden kimse.
cîrar: (Cerre. C.) Toprak testiler.
cîraye: Suyun ve diğer sıvıların durmadan akıp gitmeleri.
cîrban: Yaka.
cîrbet: Ekinlik, mezra.
cîrcîr: Maydanoz.
cîrcîs: (Bak: Cercis)
cîrcîs: Mühür yapılan mum. * Toprak. * Küçük üvez.
cîre: çırak, uşak ve hizmetçilere verilen yevmiye, yemek ve para.
cîr'et: (Cer'et- Cür'et) Bahadırlık, kahramanlık, şecaat. * îkdâm etmek.
cîret: Komşuluk.
cîrf: Büyük nesne.
cîrî: Yılan balığı. (Fâriside mermahi derler.)
cîrîs: Sazan balığı.
cîrîş: Ceset.
cîrît: Düşmana atılmak üzere yapılmış ucu demirli, sert tahtadan kısa mızrak. Sulh zamanlarında talim mahiyetinde yapılan karşılaşmalara cirit oyunu denirdi. Türklerin makbul bir sporu idi.
cîrîyya: Tabiat, mizac, fıtrat, yaradılış. * Huy, haslet.Adet, alışkanlık.
cîrm: Vücud, ten, cüsse, hacim, büyüklük. * Cansız cisim. * Yıldız.
cîrman: Organlarla birlikte vücut.
cîro: ing. Bir senet veya havalenin alacaklı tarafından diğeri namına çevrilmesiyle üzerine buna dair şerh verilmesi.
cîrre: Devenin karnından çıkarıp çiğnediği geviş. * Yapağı denilen yün.
cîrrîyye: Kursak.
cîrs: Temel, kök, menşe, kaynak, menba.
cîrsam: Divanelik, delilik. * öldürücü zehir. * Zatülcenb.
cîrşab: Hasta olduktan sonra zayıflayıp gövdede çıban çıkmak.
cîryal: Altının kırmızılığı. * Bir cins kırmızı boya. * Temiz renk. * şarap.
cîrye: Suyun akması ve şırıldaması. * Cereyan.
cîsad: Kan. Safran.
cîsîm: (Cism) Varlığı bilinen, hayyiz olan, mekânı, ciheti, uzunluğu, genişliği ve derinliği olan şey.
cîsm-î nâtik: Söz söyleyen cisim. Konuşan cisim. însan.
cîsm-î nîzâr: Zayıf vücud.
cîsmanî: (Cismaniye) Bedene mensub, vücutla alâkalı. * Mânevi ve ruhani karşılığı. Maddi ve cisimli olmak.
cîsmanîyet: Cismânilik. Maddi beden sahibi olmak hâli.(Sual: Kusurlu, noksaniyetli, mütegayyir, kararsız, elemli cismaniyetin, ebediyetle ve cennetle ne alâkası var? Madem, ruhun âli lezâizi vardır; ona kâfidir. Lezaiz-i cismaniye için bir haşr-i cismâni neden icab ediyor?Elcevab: çünki, nasıl toprak suya, havaya, ziyaya nisbeten kesafetli, karanlıklıdır. Fakat, masnuat-ı îlâhiyenin bütün envaına menşe ve medar olduğundan bütün anâsır-ı sâirenin mânen fevkine çıktığı gibi; hem kesafetli olan nefs-i insaniye, sırr-ı camiiyet itibariyle, tezekki etmek şartıyla bütün letâif-i insaniyenin fevkine çıktığı gibi.. öyle de cismaniyet, en câmi, en muhit, en zengin bir ayine-i tecelliyât-ı esmâ-i îlâhiyedir. Bütün hazain-i rahmetin müddeharatını tartacak ve mizana çekecek âletler, cismaniyettedir. Meselâ: Dildeki kuvve-i zaika, rızk zevkinde, enva-ı mat'umat adedince mizanlara menşe olmasaydı, herbirini ayrı ayrı hissedip tanımazdı; tadıp tartamazdı. Hem ekser esmâ-i îlâhiyenin tecelliyatını hissedip bilmek, zevk edip tanımak cihazatı, yine cismaniyettedir. Hem gayet mütenevvi ve nihayet derecede ayrı ayrı lezzetleri hissedecek istidatlar, yine cismaniyyettedir. S.)( $ âyetinin sarahat-ı kat'iyesiyle: însan, en ziyade ünsiyet ettiği ve dünyada numunesini tatmış olduğu cismani lezzetleri cennete lâyık bir tarzda görecek, tadacak. Ve lisan, göz ve kulak gibi âzaların ettikleri hâlis şükürler ve hususi ibadetlerin mükâfatları, o uzuvlara mahsus cismani lezzetler ile verilecektir. Kur'ân-ı Mu'ciz-ül Beyan o derece cismani lezzetleri sarih bir surette beyan eder ki, başka te'viller ile mâna-yı zâhiriyi kabul etmemek imkân hâricindedir. ş.)
cîsmen: Cisim itibariyle, cisim olarak. Vücutça, bedence.
cîsr: (C.: Cüsûr-Ecsür) Köprü. Ağaçtan olan köprü.
cîsr-î muallâk: Asma köprü.
cîvan: Cevan. Taze. Genç.
cîvanan: (Civân. C.) Gençler.
cîvanî: Gençlik.
cîvanmerd: Sözünde sağlam. îyilik sever. Kahraman.
cîvar: çevre, yöre, etraf. * Yakın yer, yakın komşu.
cîvarîyyet: Komşuluk, yakınlık, aynı civarda oluş.
cîve: Civa. (Hg)
cîvelek: Tar: Yeniçeri Ocağı'nda bulunan ve aşçıbaşı maiyetinde yaver gibi kullanılan gençler. * Canlı, hareketli ve neş'eli deve yavrusu veya genç.
cîya': (Câyi'. C.) Karınları acıkmış olanlar, açlar.
cîyadet: Tazelik, yenilik. * îyilik, güzellik.
cîyef: (Cife. C.) Lâşeler, leşler. Cifeler.
cîyet: Bozulmuş, değişmiş olan su. Bir yere toplanıp birikmiş olan su.
cîz': Ağaç kütüğü. Ağaç kökü. Kuru direk. Hurma ağacının kökü. Hurma ağacı. * çatı örtüsünde kullanılan ağaçlar. (Bak: Hanin-i ciz')
cîz': Derenin dar ve kısık yeri.
cîz'-un nahl: Hurma ağacının kökü, kütüğü.
cîzal: Hurma toplama.
cî'zare: Kısa boylu tıknaz kimse.
cîzaret: Deve kasaplığı.
cîze: Dere kenarı.
cîzfe: Küçük sürü.
cîzîrman: Hurma yaprağının aslı; yâni dibi ki, yaprağı dökülünce ağaçta kalır.
cîzl: (C.: Cüzul-Eczâl) Büyük odun ağacının kökü, tomruk.
cîzle: Bir büyük yığın hurma.
cîzme: Deve sürüsü. * Koyun sürüsü.
cîzmîr: Ağaç kütüğü.
cîzn: Kök. * Ağaç kütüğü.
cîzye: Vergi. Haraç. Müslümanların fethettikleri yerlerde, müslüman olmayanlardan alınan ve devlet teminatı altında bulunmanın karşılığı olan vergi. (Bak: Haraç)
cîzyedâr: Cizye adı verilen vergiyi toplıyan memur, cizyeci.
coğrafya: Yeryüzünün şimdiki hâlini çeşitli cihetlerden inceleyen ilim. Bölümlerinden olan Fiziki Coğrafyada: Karalarla denizlerin durumları ve iklimleri;îktisadi Coğrafyada: Toprak mahsulleri, sanayi ve ticaret işleri;Siyasi Coğrafyada: Irk, dil, millet hususiyetleri ve devlet sınırları anlatılır.Bunlardan başka; hayvanat, nebâtât, ziraat, tarih, matematik gibi çeşitli mevzularla alâkalı coğrafya kolları da vardır.
conta: Birbirinin üzerine kapanan iki madeni parça arasında, açıklık kalmamasını te'min etmek için konulan karton, kösele, lâstik vs. şey.
cop: Polis ve polis görevlisi askerlerin taşıdığı, kauçuktan yapılma sopa.
cömert: Eli açık, ikramcı, kerem sahibi.
cu: Custen fiilinin emir kökü. Gelecek misâlde olduğu gibi birleşik kelimeler yapılır.
cu: Akarsu, ırmak, nehir, çay.
cu': Açlık.
cu'an: (Cu'. dan) Aç olarak, acıkmış olarak.
cu'bub: (C: Ceâbib) Fitil ucu. * çirkin ve kısa boylu adam.
cu'bus: Ebleh, ahmak.
cuce: Civciv.
cud: Cömertlik. Sahilik. Eli açık olmak. Muhtaçların vaziyetlerini, durumlarını bildirmeğe meydan vermeksizin lütuf ve ihsanda bulunma hâleti. Mücahede-i diniye ve neşr-i hakaik-ı Kur'aniye ve imaniye hizmetinde mutemed zâtlara lüzumunda maddeten de iştirak etmek fedakârlığı.
cud u kerem: Cömertlik, eli açıklık.
cud u sehavet: Cömertlik ve eli açıklık, sahilik.
cudî: Hz. Nuh'un (A.S.) tufandan sonra gemisi ile sahile çıktığı dağın ismi. * şırnak îlinin 6 kilometre güneydoğusunda bulunan bir dağın adı.
cudî-î îslâmîyet: Her türlü helâket ve felâketlerden îslâmiyetle necat bulunacağını ifâde eden bir teşbihdir.Nasıl ki Nuh tufanında Nuhun (A.S.) gemisi Cudi Dağında karaya oturup kurtuldukları gibi.
cug: öküz boyunduruğu.
cugd: Baykuş.
cuhaf: Zarar ve ziyân edici, zarar verici nesne, muzır. * çok yemekten şişip ishal olmak. * ölmek, mevt.
cuhale: îğne deliği.
cuham: însanı zayıflatan ve gözleri irinleten bir hastalık.
cuhdub: (C.: Cehâdib) Ayakları uzun, yeşil çekirge.
cuhfe: Medine yakınında bir yerin adıdır ve şam ehli orada ihram giyerler.
cuhr: Yer deliği.
cuhuz: çıkmak, huruç.
cu'l: ücret, mukabil, karşılık. * Ayak kirası. * Padişahın etbâından aldığı mal.
cul: çaylak.
cul: (C.: Ecvâl) Akıl. * Rey. * Kuyu duvarı. Aşağısından yukarısına kadar kuyunun taraflarından her bir tarafı.
culah: örümcek, ankebut. * çulha, yâni dokuyucu, nessâc.
cum'a: Toplanma. * Perşembeden sonraki gün. Müslümanların kudsi tâtil günü olup, o güne mahsus namazla mükelleftirler. Memur ve işçilerin cuma namazı vakti serbest bırakılmamaları din hürriyetine aykırıdır. Yahudiler ve hristiyanlar haftalık dini törenleri için cumartesi ve pazar günü serbest oldukları halde, müslümanlara aynı hakkın tanınmaması hakiki medeniyete zıttır.
cum'a sûresî ": Kur'an-ı Kerim'in 62. ve Medine-i Münevvere'de nâzil olan sûresi.
cum'a-î atîk: (Eski Cum'a) Osmanlılar zamanında, Bulgaristan'da şumnu ile Razgrat arasında yer alan meşhur bir bölge.
cum'a-î bâlâ: (Yukarı Cum'a) Osmanlılar devrinde, Selânik Vilâyetinin Serez sancağındaki bir kaza merkezi.
cum'at: (Cum'a. C.) Perşembeden sonra gelen günler. Cum'alar.
cumeat: (Cum'a. C.) Perşembeden sonra gelen günler. Cum'alar.
cumhur: Halk topluluğu. Hey'et, takım. Aynı kararı veya hükmü kabul edenler. * âlimlerin çoğu, ekseriyeti. * Seçimle idare edilen devlet. * Bir yere toplanmış kum, toprak.
cumhur reîsî: Cumhuriyetle idâre olunan memleketlerde Devlet Reisi.
cumhur-u avam: Halk tabakası.
cumhur-u muhaddîsîn: Hadis alimleri sınıfı.
cumhur-u mü'mînîn: îmanlılar sınıfı.
cumhur-u nâs: însanların ekserisi, halk kalabalığı.
cumhur-u ulemâ: âlimler cemaatı. âlimler sınıfı. (Bir fikre dâvet cumhur-u ulemânın kabulüne vâbestedir, yoksa dâvet bid'attır, reddedilir. Mek.)
cumhurîyet: Devlet reisi, millet veya Millet Meclisleri tarafından seçilen hükümet şekli. Demokraside temsili hükûmet şekli. Halkın hür olarak seçtiği temsilciler (Millet vekilleri ve senatörler) aracılığı ile egemenliğini, (hâkimiyetini) kullanmasına dayanan hükûmet şekli. Cumhuriyetin birbirinden farklı üç tatbik şekli vardır.1- Parlementer hükûmet: Hükûmeti meclisler karşısında bağımsız sayan şekil.2- Meclis hükûmeti: Hükûmeti meclise bağlı sayan şekil.3- Başkanlık hükûmeti: Devlet ve hükûmet başkanı aynı kişidir ve halk tarafından seçilir. Hükûmeti başkan kurar, başkan değiştirir. Başkan meclislere karşı bağımsızdır. (Amerika'daki gibi.) (Orada benden sordular ki: Cumhuriyet hakkında fikrin nedir?Ben de dedim: Yaşlı mahkeme reisinden başka daha siz dünyaya gelmeden ben dindar bir Cumhuriyetçi olduğumu elinizdeki tarihçe-i hayatım isbat eder. Hülâsası şudur ki: O zaman şimdiki gibi, hâli bir türbe kubbesinde inzivada idim, bana çorba geliyordu. Ben de tanelerini karıncalara veriyordum, ekmeğimi onun suyu ile yerdim. Benden sordular, ben dedim: Bu karıncı ve arı milletleri Cumhuriyetçidirler. Cumhuriyetperverliklerine hürmeten tanelerini karıncalara veriyorum. Sonra dediler: Sen selef-i sâlihine muhalefet ediyorsun? Cevâben diyordum: Hülefâ-i Râşidin hem halife hem Reis-i cumhur idiler. Sıddık-ı Ekber (R.A.) Aşere-i Mübeşşereye ve Sahâbe-i kirama elbette Reis-i Cumhur hükmünde idi. Fakat, mânâsız isim ve resim değil, belki, hakikat-ı adaleti ve hürriyet-i şer'iyeyi taşıyan mânâ-yı dindar Cumhuriyetin reisleri idiler. ş.)(Cumhuriyet ki: Adalet ve meşveret ve kanunda inhisar-ı kuvvetten ibarettir. H.)
cumhurîyet-perver: Cumhuriyetçi, cumhurcu.
cumu': Toplanmalar. Cemi'ler.
cumuat: (Cum'a. C.) Perşembe gününden sonra gelen günler. Cum'alar.
cu'mus: Pis, necis.
cun (cunî): Karnı ve kanadı kara olan bağırtlak kuşu cinsinden bir kuş.
cûne: (C.: Cuven) Attarların kutusu ve tablası.
cur: Belde ismi.
cur'a: Tek yudum. Bir içimlik. Bir yudumluk.
cur'aten : Bir yudumluk.
curh: (Curha) Yara. Yaralama.
curnal: (Bak: Jurnal)
cuş : Coşmak, kaynamak. Taşmak. Deprenmek.
cuş u huruş : Kaynayıp taşma. Neş'e ve âhenk. Coşup taşma.
cûş-aver: Coşturucu, coşmaya sebep olucu.
cuşacuş: çok coşkun, taşkın. Pek coşkun ve taşkın bir sûrette.
cûşak: Kaynama.
cuşan : Coşup kaynayan.
cuşîde: Coşmuş, kaynamış.
cuşîr(e): Dokumacı.
cuşîş: Kaynama, coşma.
cu'şum: Galiz, kısa boylu adam.
cu'şuş: (C.: Ceâşiş) Kötü huylu, kısa boylu.
cuudet: Kıvırcıklık.
cuur: Hurmanın gayet yaramazı, iyi olmayanı.
cuy: Nehir, akarsu, ırmak, dere, çay.
cuy-çe: Küçük ırmak.
cuya(n): Arayan, arayıcı.
cuybar: Akarsu, nehir, dere, çay, ırmak. * Irmak kenarı.
cuyem: (Cüsten, aramak mastarından "arıyorum, ararım" mânasınadır.) (Bak: Cû)
cuyende: Arayıcı, araştırıcı, isteyen.
cüba': Korkak.
cübab: Devenin sütünün üstüne gelen köpüğü.
cübar: Ziyan olmak. Heder olmak. * üçüncü gün.
cübb: Kuyu. * Küp. Kulpsuz desti. * Vaktiyle zindan gibi kullanılan çukur, susuz kuyu.
cübbe: (C: Cübeb) şeâir-i îslamiyeden olup, giyilmesi sünnet olan dış kıyafetini teşkil eden, bilhassa namazda giyilen uzun ve bolca bir libas.
cübcübe: (C.: Cebâcib) Korkutmak. * Yağ koymağa mahsus deri zenbil ve büyük desti. * çok su. * Erimiş yağ.
cübcübîyye: îşkembe yemeği. (Onu pişirip satana işkembeci mânâsına "cübcübi" derler.)
cüble: Hörgüç.
cübn: (Cübün) ürkeklik. Korkaklık. Korkak olmak. * Peynir.
cübne: Korkaklık.
cübnî: Peynirci. * Peynir hâlinde olan şey.
cübu': Tehir etmek, sonraya bırakmak. * Yönelmek, rücu etmek.
cübüll: (C: Cübüllât) Yaratılmak, hilkat. * Kesir, çok.
cübün: Peynir. * (Cebin. C.) Alınlar.
cü'cü': Gemi göğsü. Kuş göğsü.
cüda: Ayrılık. Ayrılmış.
cüda': ölüm. Mevt. * Hayvana muzır olan otlak, çayır.
cüdad: çulha yumağı. * Eski kaftan. * Küçük ağaç.
cüdat: (Câdi. C.) Dilenciler, sâiller.
cüdayî: îftirak, ayrılık.
cüdcüd: (C.: Cedâcid) Orak kuşu derler bir büyük böcek ki yaz aylarında öter.
cüdd: Cem'etmek, toplamak. * Yol üstünde olan kuyu.
cüddet: (C.: Cüded) Dağ arasındaki yol. * şekil, tarz, işaret. * çizgi.
cüded: Dağ yolları. Yol gibi olan izler. * Bir rengi diğer renkten ayıran çizgi.
cüdera': (Cedir. C.) Yakışanlar. Lâyık olanlar, liyâkat sahibi olanlar.
cüdere: (C: Cüder) Ur dedikleri yumru. (însan bedeninde çıkar)
cüderî: Kabarcık denilen hastalık. * çiçek hastalığı.
cüdran: (Cedr. C.) Duvarlar.
cüdube: Kıtlık.
cüdür: (Cidâr. C.) înce deriler, zarlar. * Duvarlar, setler.
cüfaen: Beyhude, boşuboşuna, faydasız yere.
cüfaf: Kurumuş.
cüfafe: Dağılmış kuru ot.
cüfal: Selin kenara attığı çör çöp. * Davarın yünü ve kılı çok olmak. * Kıllı kimse. * Bol.
cüfale: Su kenarında olan çörçöp.
cüff: îçi boş olan şey. Kof. * Dimağa işlemiş olan baş yarığı. * Hurma çiçeğinin kabuğu. * Cemaat, topluluk. * Yarısı kesilip kova olmuş olan çürük ve eski kırba.
cüfre: Bir şeyin ortası. Mezar. * Boşluk. çukur. * Göğsün içerisi. Sadır.
cüft: Tek olmayan. Eşi olan. çift.
cüfte: Benzer, eş, denk, müsavi. * însan veya hayvan sağrıs. * Hayvan çiftesi.
cüfur: Zayıf olmak.
cühal: Zehir.
cühd: Kuvvet, tâkat.
cühela: (Câhil. C.) Cehele, cühhâl. Cahiller. Bilgisizler.
cühera: (Câhir. C.) Yüksek sesle açık olarak söylenenler.
cühhal: (Câhil. C.) Bilgisizler, câhiller.
cühud: Bilerek inkâr etmek. Bildiği hâlde yanlış söylemek. * Peygamberimiz Resul-i Ekremi (A.S.M.) bildikleri ve mukaddes kitablarında O'nun evsâfını okudukları hâlde inkâr eden Yahudiler. (Türkçedeki "cıfıt" kelimesi bundan gelir.) * Bir kimseyi bahil bulmak.
cülab: Gülsuyu, cüllâb. * îshal veren şerbet, müshil.
cülahek: örümcek, ankebut. * Küçük dokumacı.
cülal: (Celil) Ulu, büyük nesne, azim.
cülale: Büyük dişi deve.
cülazî: Kocaman ve kuvvetli. îriyarı. * Hâdim, hademe, hizmetkâr. * Kilise veya manastır uşağı. * Papaz veya keşiş.
cülb (cîlb): Su olmayan bulut.
cülban: Burçak dedikleri hububat cinsi.
cülbe: Yara iyi olduğunda üstünde olan ince deri.
cülcül: (C.: Celâcil) Ufak çıngırak, küçük çan.
cülcülân: Susam.
cülcülân-i habeşe: Beyaz haşhaş.
cülesa: (Celis. C.) Beraber oturanlar.
cülhab: Dere, vâdi.
cülhub: Dizleri büyük olan kadın.
cüll: (C.: Cilâl-Ecille) çul. * Gül. * Her nesnenin büyüğü ve muazzamı.
cülla: (C.: Cilel) Büyük emir.
cüllab: Cülâb, gülsuyu.
cüllah: çok sel.
cüllas: (Câlis. C.) Cülus edenler, oturanlar.
cülle: Hurma koydukları kap. * Hurma yükü.
cülmud: Kaya.
cülmüd: Sesi çok çıkan ve kuvvetli olan kimse.
cülube: Başka yerden satmaya getirilen şey.
cülud: (Cild. C.) Ciltler, hayvan derileri.
cülul: Kişinin, yerinden başka yere çıkması.
cülus: Oturuş. Oturma. * Padişahın taht'a oturması.
cülus-u hümâyun: Padişahın taht'a oturma merâsimi.
cülusîyye: Taht'a çıkan hükümdarlar veya padişâhlar için yazılmış yazı veya söylenmiş şiir. * Hükümdarın tahta çıktığı ilk gün verdiği bahşiş.
cülüban: Sahtiyandan yapılan dağarcığa benzer bir kap.
cülünbak: Diş gıcırtısı. * Kapı gıcırtısı.
cülza: Sağlam deve.
cüma': Toplamak. Cem'etmek.
cümâd-el-âhîre: Arabi ayların altıncısının adı.
cümâd-el-ûlâ: Arabi ayların beşincisi. Cemazi-yel-evvel.
cümâde: Arabi ayların beşinci ve altıncısının adı.
cümah: Kibirlenmek.
cümale: (C.: Cümâlât) Gemi urganı.
cümame: (C.: Cümâm) Yuvarlak inci. Kıymetli taş. Gümüşlü boncuk. Büyük inci tanesi. Gümüşten yapılıp dizilen inci gibi toplar.
cüman: îri inci.
cümane: Tek inci.
cümase: Soğuk, berd.
cümaz: Gümüşlü boncuk.
cümbüş: (Bak: Cünbiş)
cümcüme: (C.: Cemâcim) Baş kemiği, kafatası. * Ağaç çanak. * Arabdan bir kabile.
cümd: Taş.
cümd: (C.: Cümâd-Ecmâd) Yüce, sağlam mekân.
cümel: (Cümle. C.) Cümleler. Birden fazla anlama gelen sözler. Mecmular. (Bak: Cümmel)
cümhure: îçi boş kemik.
cümle: Hep, bütün, tam. * Gr: Tam mânâyı ifade eden, kaideye uygun söz.
cümle kapisi: Sarayın büyük kapısı. * Dış kapı.
cümle şîrân-i cîhân: Cihânın bütün arslanları.
cümle-î asabîye: Tıb: Sinir sistemi.
cümle-î cezâîye: şart cümlesinin ikinci kısmı. Misâl: "Eğer lügatı rehber edinirsen, kelimelerin mânasını anlarsın" cümlesindeki "kelimelerin mânasını anlarsın" cümlesi, cümle-i cezâiyedir.
cümle-î fîîlîye: Fiil ile başlayan arabça cümle. Fiil cümlesi.
cümle-î îhbârîye: (Cümle-i haberiye de denir) Bir hâdiseyi, bir nesneyi bildiren cümle. Bunun zıddı: cümle-i inşâiyedir; emir ve nehiyleri bildirmek gibi.
cümle-î îsmîye: îsimle başlayan arabça cümle. îsim cümlesi.
cümle-î mu'terîze: Cümlenin mânasını açıklamak için parantez içine yazılan cümle.
cümle-î müste'nefe: Kendinden önceki cümleden bağımsız, müstakil cümle.
cümle-î şartîye: (Bak: şart)
cümle-î tefsîrîye: (Cümle-i müfessire) "Yâni, meselâ" gibi sözlerle başlayıp önceki cümleyi açıklayan cümle.
cümle-î ûlâ: Birinci cümle. Evvelki cümle.
cümleten : Bütün, hep, kâffeten, cemian, hep birden.
cümma': Bir araya gelerek toplanmış şey, küme.
cümmah: Temrensiz, ucu yuvarlak ok. (Oğlancıklar onunla ok atmayı öğrenirlerdi)
cümmar: Hurma yağı denilen beyaz bir maddedir ve hurma ağacının başından çıkar ve araplar onu yerler.
cümmel: (Cümel) Harflerin, sayı kıymetine göre hesaplanması. Ebced. (Bak: Ebced) * Bir kaç urganın birleştirilmesinden meydana gelmiş olan çok kalın gemi halatı.
cümmet: Suyun biriktiği yer. * Başta toplanan saç. * Omuzlara inen saç.
cümmeyz: încire benzer bir yemişin adı.
cümre: Süvari alayı, bin atlı cemaat.
cümse: Hurma koruğu.
cümud: Donuk. Katı. Sert. * Mc: Gayretsiz. * Soğukluk.
cümud-u ayn: Göz donukluğu.
cümudîye: Büyük buz dağ. Glâsiye. Buzul. Aysberg.
cümum: Suyu çok olan kuyu. * Su kuyuda çok olmak (mânâsına mastardır).
cümûs: Donmak.
cümza: Seri davar.
cümzan: Hurma nevilerinden bir hurma.
cümze: Toplanmış hurma.
cünabe: îkiz çocuk.
cünaf: Kuruluk.
cünah: Bir şeyi basıp meylettiren sıklet demek olup, harec, sıkıntı ve alel-ıtlak ism-i vebal mânasına da gelir ki, "günah" kelimesinin aslı budur. (E.T.) (Bak: Günah)
cünbân: "kımıldanan, kımıldatan, sallanan, oynayan, oynatan, hareket eden" mânâlarına gelir ve sıfatlar yapar. Dünbâle-cünbân $: Kuyruk sallayan.
cünbîde: Sallanmış, kımıldanmış, hareket etmiş.
cünbîş: Kımıldanma, hareket. * Zevk, eğlence, cünbüş.
cünbîş-geh: Cünbüş yeri, eğlence yeri.
cünbîş-î zemîn: Deprem, zelzele, yer sarsıntısı.
cünbuh: Kalın, uzun ve yüksek nesne. * Büyük bit.
cünbüde: Kümbet, kubbe.
cünbüş: Zevk, eğlence. * Hareket, kımıldanma. * Uta benzer bir çalgı. (Doğrusu: Cünbiş'tir).
cünbüz: Kemer, kubbe, kümbet.
cünd: Er, asker. Ordu. * Bir kimsenin yardımcıları. * şehir.
cündeb: (Cündüb) Bir nevi çekirge. * Mc: Yağmacı.
cündî: Süvâri, sipâhi, ata iyi binen, binici.
cünduh: Büyük çekirge.
cündüb ôö: (C.: Cenâdib) Bir nevi çekirge.
cü'ne: Hokka.
cüneyd: Küçük asker. Askercik.
cüneyd-î bağdadî: (Hicri: 207-298) şafii Hz.lerinin talebesinden ders almıştır. Zamanın kutbu sayılmıştır. 30 defa yaya olarak hacca gitmiştir. Büyük velilerdendir. (K.S.)
cünh: Koruma, esirgeme, himâye ve muhafaza etme.
cünha: Suç, kabahat. Te'dib cezâsına müstahak olanın suçu.
cünnab: Bitişik olan iki yemiş.
cünnar: çınar.
cünnet: örtü, kadın başörtüsü. * Yağan. * Kalkan.
cünu': Yüzü üstüne düşürmek.
cünud: (Cünd. C.) Askerler. Ordu.
cünudullah ú: Allah'ın ordu ve askerleri. (Zerrattan seyyarata kadar bütün mahlukat, Allah'ın emrine tabi birer ordu ve asker gibidir. Mukaddes Kur'an ve iman hizmetinde cansiperane ve ihlâs ve feragatla cehd ü gayret eden müslümanlar da Cünudullah ünvanına mazhardırlar.)
cünuh: Yöneliş, meyil.
cünun: Delilik, cinnet. Delirmek. * çok olmak. * Otun uzaması.
cünüb: Cenabetlik. şer'an yıkanıp temizlenmeye mecburiyet hâli. * Irak, uzak, baid.
cür'a: Bir yudumluk su. îçim, yudum.
cür'a-rîz: Damla damla döken.* Bir çeşit ibrik.
cürade: Soyulmuş nesne.
cüraf: Sel yolu. Selin aktığı mecrası.
cürah: Yara.
cürahüm: îri gövdeli davar.
cüraşe: Tuz döğülürken etrafına düşen iri parçalar.
cüraz: Keskin.
cüraz: Polat. Demir.
cürbüz: însanlar arasında fesâdçılık yapan gaddâr kişi.
cürcanî: (Abdülkahir) Hicri beşinci asrın ikinci yarısında yaşamış büyük âlimlerden ve Arapçanın dâhi mütehassıslarındandır. Dindarlığı ve takvası da çok ileri olduğu nakledilir... Asıl adı: Abdülkahir-el Cürcani olan bu Zâtın ilk tahsilini memleketi Cürcan'da yaptığı biliniyor. Adı ve künyesi şu şekilde oluyor: Eş-şeyh Ebu Bekir Abdulkahir bin Abdurrahman. Bütün cihetleri ile beğenilen bir zat olmuştur. Hakkında deniyor ki: Namazda iken evine bir hırsız girse, bulduğu bir takım şeyleri alır. Cürcani hırsızı gördüğü halde namazına devam eder ve bozmaz... Vefat tarihi Hi.471 senesidir. (K.S.)
cürcanî: (Seyyid şerif Ali Bin Muhammed): (Hi: 760-830) Astarabad (Cürcan) civarında Tacu'da doğmuştur. Mısır'a giderek orada çeşitli âlimlerden ders okumuştur. şiraz'da müderrislik yapmıştır. Sa'duddin-i Taftazani ile kapanan Mütekaddimin devrinden sonra açılan Müteahhirin-i Ulemâ devrinin birincisi bu Seyyid şerif Cürcani'dir. (K.S.)
cürce: (C.: Cürâc) Heybeye benzer bir kap.
cürcur: Deve başı.
cürd: Tüysüz, kılsız. * Cilt hastası (deve). * Tüyleri kısa olan (at). * Bitki örtüsü olmayan (arazi). * Piyâdesiz (süvâri).
cürdan: At ve eşek zekeri.
cürde: çorak bölge. * çıplak vücut. * Atlı asker.
cürde askerî: Eskiden hacca giden kafilelerin muhafızlığını yapan asker.
cür'et: Yiğitlik, cesaret. Korkmayarak ileri atılmak.
cür'et-yâb: Cesur, cesaretli, yiğit, delikanlı, atılgan, gözüpek, cür'etkâr.
cür'etkâr: Cesur, cesaretli, yiğit, delikanlı, atılgan, gözüpek.
cürez: (C: Cirzân) Tarla faresi.
cürf: Dere kenarında selin, dibini yalayıp oymuş olduğu bıçık üzerinde kalan toprak veya çamur çıkıntısıdır ki, her an için yıkılıp çökmeğe hazır bir vaziyette bulunur. (E.T.) * Estiyan adı verilen bir ot.
cürfüş: Yanları etli olan şişman kimse.
cürh: (C.: Cüruh) Yara.
cürha: Birtek yara. * şehadette yani şahidlikte bir tek hükümsüzlük sebebi.
cürhüm: Yemende bir kabile.
cürm: (Cürüm) Kabahat, kusur. Hatâ. îsyan. Günah. Kanun hilâfına hareket.
cürm-nak: Suçlu, kabahatli.
cürm-ü meşhud: Suç üzerinde suçluyu yakalamak. Görülen suç. (Suç üstü)
cürmane: Ceza, mücâzat.
cürmuk: (C.: Cerâmik) çizme.
cürmuz: Küçük havuz.
cürn (cerîn): (C: Cüren) Hurma kurutulan ve harman yapılan yer.
cürre: Cesur, cesaretli, cür'etkâr, cür'et-yâb, yiğit, delikanlı, gözüpek, atılgan. * Uçan her çeşit kuşun erkeği. * Bir zira' miktarı ağaç. (Ağacın başında bir küfe, ortasında bir ipi olup onunla geyik avlarlar.)
cürre-baz: Atmaca kuşu. * Erkek şahin veya akdoğan. * Hızla uçan ok.
cürsum: (C: Cerâsim) Her nesnenin aslı.
cürsume: (Cürsâm) Kök, asıl, temel. Bir tohumun özü. îlk hücrelik. * Gırtlak kapağı. * Karınca yuvası.
cürsume-î diraht: Ağacın kökü.
cürsun: üzerine binâ yapmak için duvardan dışarı uzattıkları ağaç.
cürş: Yemen diyarında bir yerin adı. * Başı tırnakla taramak.
cürşu': Büyük karınlı deve.
cürub: Beddualar, bed ve kötü dualar, fenâ sözler.
cüruh: (Cürh. C.) Yaralar.
cürum: Sıcak, çukur yer.
cürûn: Bezin eskimesi. * Yumuşak olmak. * Bir nesne aşınmak. * Alışkanlık, itiyat.
cürüf: Uçurum, yar.
cürüz: Verimsiz çorak yer.
cürvaz: Karnı büyük olan kişi.
cüryaz: (C: Cerâyız) Karnı büyük olan.
cürz: (C: Cirzan) Köstebek.
cürzum: (C: Cürâzim) çok yiyen kişi.
cüsacîs: Büyük deve. * Kılların veya otların sık ve çok olup birbirine karışması.
cüsad: Karın ağrısı.
cüsal: Tarla kuşu.
cüsale: Sonbaharda dökülen yapraklar.
cüsam: Büyük, geniş. Eni fazla olan.
cüsam: Uykuda gelen ağırlık, kâbus.
cüses: (Cüsse. C.) Cüsseler, gövdeler, bedenler, cisimler, kalıplar, cesetler.
cüseym: Cisimcik. Küçük cisim.
cüseymat: (Cüseym. C.) Küçük cisimler, cisimcikler.
cüsman: Organlarla birlikte vücudun tamamı. * Her nesnenin cismi ve cesedi.
cüsse: Gövde, kalıp, beden.
cüsse-dâr: îri yapılı, cüsseli kimse, irikıyım kişi.
cüst: Araştırma, arama.
cüst ü cu: Arayıp sorma, araştırma, arama.
cüsu: Diz üstünde çökmek.
cüsu': Tamahkârlık, pintilik, harislik, cimrilik.
cüsum: (Cisim. C.) Cisimler. Ecsam.
cüsum: Kuşun, uyuması vaktinde göğsünü yere koyup çömelmesi. çömelip oturmak. * Uykuda gelen ağırlık. Kâbus. * Oturmak.
cüsur: (Cisr. C.) Köprüler.
cüsüvv: Kurumak, yebs. * Donmak, cümud.
cüsve: Bir yere biriktirilmiş taş.
cüsy: Diz üstüne çökmek.
cüşa': çok yemekten dolayı genirmek.
cüşem: Deve göğsü.
cüşre: öksürük. * Göğüs sertliği.
cüşu': Durmak, kıyam. * Huruç etmek, çıkmak. * Hafif yay.
cüşur: Sabah yerinin ağarması.
cü'şuş : Göğüs. Sadır.
cüşüm: Kısa boylu, tıknaz kimse.
cüvad: Susamak.
cüval: çuval.
cüvalîk: (C.: Cevâlik) çuval.
cüvan: (Bak: Civân)
cüvar: (Civâr) Yakınlık. Komşuluk. * Himâyet, korumak. * Riâyet. * Süt emen deve yavrusu. * Karga sesi. * öküz avazı.
cüveyre: Küçük câriye, câriyecik.
cüvvet: Kırba yaması. * Bir parça yer. * Siyaha yakın boz renk. * Demir pası.
cüyud: (Cid. C.) Gerdanlar, boyunlar.
cüyuş: (Ceyş. C.) Ceyşler, askerler, neferler, erler. Ordular.
cüz: Kısım, parça. Bir şeyin bir parçası. * Kitab forması. * Küllün mukabili. * Kur'ân-ı Kerim'in otuzda bir parçası. * Kanaat. îktifâ eylemek. * Düğümü sağlam yapmak. Bir şeyi pekiştirip muhkem kılmak. * Kız evlâdı.
cüz-î asgar : En küçük cüz. En ufak parça.
cüz-î îhtîyar: Dilediği gibi hareket edebilme. Yani: Herhangi bir şeyi yapmak veya yapmamak hususunda bir tarafı tercih etmek iktidar ve serbestliği. Bu serbestlik ile, Cenab-ı Hak insanları, iyiliği veya kötülüğü istemek cihetinde imtihan eder.(Halbuki; o cüz-i ihtiyari denilen silâh-ı insani hem âciz hem kısadır. Hem ayarı noksandır. îcad edemez. Kesbden başka hiçbir şey elinden gelmez. îman o cüz-i ihtiyariyi, Allah namına istimal ettirip herşeye karşı kâfi getirir. Bir askerin cüz'i kuvvetini devlet hesabına istimal ettiği vakit, binler kuvvetinden fazla işler görmesi gibi. S.)
cüz-î îrade: îradeden bir cüz. Allah tarafından insana verilen irade. (Bak: îrâde)
cüz-î lâyetecezzâ : Bir daha bölünmeyen en küçük parça. En küçük cisim parçası. Tecezzisi kabil olmayan. Atom. Yani parçalansa, maddilikten çıkıp kanun-u îlâhi ile bir nevi kuvvete inkılâb eder.
cüz-ü ferd: Bir varlıktan veya bir vücuddan bir parça. * Atom. (Bak: Cüz-i lâyetecezzâ).
cüz-ü tamm: Bütün. Bir şeyin, temel vasıflarının tamamını toplayan parçası. Parçalandığı vakit ana vasfını ve asliyetini kaybeden şey.
cüzae: Bıçak sapı.
cüzaf: Götürü pazar.
cüzam: (Cüzzam) Hansel basilinin (mikrobunun) sebep olduğu bulaşıcı bir deri hastalığı.
cüzame: Hasaddan sonra ekinden bâki kalan ekin.
cüzare: Devenin etrafı (ayakları ve başı gibi.)
cüzaz: Kesilmiş ve parçalanmış olan şey.
cüzaze: (C.: Cüzâzât) Pâre pâre etmek, ayırmak, kesmek. Ağaçtan yemiş düşürmek.
cüzaze: Bez kırpıntısı.
cüzbend: Bir çeşit cüzzam hastalığı. * Ciltçi.
cü'zer: (C.: Câzer) Geyik buzağısı. * Yaban sığırının buzağısı.
cüzeyr: Kök dalı, ince kök.
cüzeyre: Küçük ada, adacık. Etrafı su ile çevrili küçük kara parçası.
cüzhan : Kur'ân-ı Kerim cüzlerini okuyan kimse.
cüz'î: Azdan olan. Parçaya âit olan. Biraz. Pek az. Kıymetsiz. Mühim olmayan. Esasa ait olmayan. Cüz'e âit olan. Külli olmayan.
cüz'îyyat: Cüz'i olan şeyler. Ufak tefek şeyler. Mânası düşünüldüğünde zihinde ortaklık kabul etmeyen şeyler. Mânası başka şeylere şâmil olmayanlar.
cüz'îyyet: Azlık, cüz'i oluş.
cüzur: (Cezr. C.) Kökler.
cüzve: (Cezve-Cizve) (C: Cezey-Cizey) Kalın ağaç parçası. * Ateş közü.
cüzzam: (Bak: Cüzam)
cüzzet: Kaftan.
