j: Osmanlı alfabesinin ondördüncü harfi olup, ebced hesabında "" harfi gibi, 7 sayısına tekabül eder.
jaje ©©: Bâtıl, edebsizce olan söz. 
jajha: Saçma sapan söyliyen. Mânâsız ve boş konuşan.
jajhayan: Saçma sapan söz söyleyenler. Mânâsız ve boş konuşanlar.
jajhayî: Mânâsız söyleyicilik.
jajhor: Mânâsız ve mâlâyani şeyler konuşan.
jajî ©©: Tereyağı ile karışık peynirin tuluma konan şekli.
jaketatay: Fr. Arkası yırtmaçlı, etekleri uzun ve ön köşeleri yuvarlakça kesilmiş olan resmi ceket.
jale ©: çiğ. Kırağı. (Bak: şebnem)
jale-î eşk: Gözyaşı jâlesi. Kırağı tânesine benziyen gözyaşı.
jaledar: üzerine çiğ düşmüş, kırağılanmış.
jalerîz: çiğ saçan, kırağı saçan.
jandarma ©: Fr. Yurt içinde asayişi sağlamak gayesiyle meydana getirilen ve orduya mensup silâhlı kuvvet. Ve bu kuvvette yer alan asker.
jar: Zaif, takatsiz, bitkin.
jardînîyer: Fr. Salonlara süs için konulan ve içine çiçek ekilmek üzere bir sandığı bulunan bir mobilya.
jartîyer ©: Fr. çorap bağı.
jean: Dev. Gayet büyük. Dev cüsseli.
jegale: çığlık, nâra. * Darı ekmeği.
jegand: Sağlamlık, metanet. * Vahşi ve yırtıcı hayvanların korkunç sesi.
jegar: Küf, kir, pas. * Yüksek ses, nâra.
jeh: Siğil, sivilce.
jelatîn ©: Fr. Tıbda ve fotoğrafçılıkta kullanılan şeffaf, renksiz ve kokusuz bir cisim. Hayvanların kemik ve kıkırdak gibi kısımlarından elde edilir. * Bir cins kâğıt.
jende ©: Yamalı, eski. * Eski-püskü. Pejmürde.
jendepuş: Yamalı hırka giyen kimse. Fakir.
jeng ©: Pas, küf, kir.
jeng-âlud ©: Paslı.
jeng-bar: Pas saçan.
jeng-beste: Paslı, kirli, küflü, pas tutmuş.
jeng-dar: Küflü, paslı, kirli.
jeng-pezîr ©: Paslı, küflü, kirli.
jeng-yab: Paslı, küflü, kirli.
jengar: Kir, küf, pas. * Bakır pası.
jengarî: Bakır yeşili. Bakır pası renginde olan boya.
jengdan: çan. çıngırak. 
jengele: çatal tırnaklı hayvan. * Hayvanda bulunan çatal tırnak.
jenk: Yüzde hâsıl olan buruşukluk.
jeoloğ ©: yun. Yer (Arz) ilmi ile uğraşan.
jeolojî ©©: yun. Yerin (Arzın) yapı kütlelerini inceleyen ilim kolu.
jerd: çok yiyen, obur.
jerf (jerfa) ©©: Derin. Suyun derin yeri.
jerfbîn: Dikkat sâhibi, dikkatli.
jerfî: Derinlik.
jerfîn: Kapı sürmesi. Kapının ardına konulan dayak.
jest ©: Fr. çalım. Mânâlı ve gösterişli hareket.
jeton: Fr. Para yerine kullanılan marka. * Telefonlarda veya garsonların kasa ile hasaplaşmasında kullanılır.
jey ©: Göl. * Irmak.
jiyan: Kükremiş, kızgın. (Ey yâreli şir-i jiyan, bu hâb-ı gafletten uyan.)
jîk ©: Yağmur damlası. * Kirpi.
jîkase: Kirpi.
jîle: Yelek.
jîmnastîk: (Bak: Cimnastik)
jîmnaz: Bazı memleketlerde orta tahsil müesseselerine verilen isim. îdadi mektebi.
jîr: Göl. Havuz.
jîrnet: Fırıldak. Rüzgârın istikametini gösteren âlet.
jîve: Civa.
jîyan ©: Kızgın, kükremiş, hışımlı. (Bu tabir, ekseriyetle arslanlar hakkında kullanılır.)
jön türk ©: Fr. Genç Türk. 1868'den sonra, Avrupa'daki gibi, güya yenilik ve terakki isteyen Genç Osmanlılara Avrupalılarca takılan isim.
jun: Sanem, put.
jurnal ©: Fr. îlk önce gazete ve rapor mânasına kullanılırken sonradan "hükümete ihbar" gibi olan hâdiselere denilmeğe başlandı. îhbar, şikâyet, polis raporu. însanı kötüleyerek verilen haber veya rapor.
jügal: Kömür. Maden kömürü.
jülîde ©: Dağınık, perişan, karma karışık.
jürî ©: ing. Herhangi bir mes'ele için hüküm vermek üzere toplanan hey'et, cemaat.: k: Osmanlı alfabesinin yirmidördüncü harfi olan kaf ile, yirmibeşinci harfi olan kef harfini karşılar.
