p: Osmanlı alfabesinin üçüncü harfi olup, ebced hesâbında "b" harfi gibi iki sayısına tekabül eder. 
pâ (pây): Ayak. * Takat, mukavemet. * îz.
pâ-be-rîkâb: Hareket etmek üzere olan.
pâ-bend: Ayak bağı. Köstek. Ayağa vurulan zincir. * Engel, mâni.
pâ-bend-î terakkî: îlerlemeğe mâni olan zincir, köstek.
pâ-bercâ: Ayağı yerde demek olan bu tâbir, mecaz yoliyle kaim, sabit, berkarar, daim, bâki mânâlarında da kullanılır.
pâ-bercâ-yî hareket: Hareket etmek üzere bulunan, âmâde.
pâ-beste: Ayağı bağlı. Hareketsiz.
pâ-bus: Ayak öpen.
pâ-bürehne: Yalın ayak.
pâ-câme: şalvar, don, çakşır. Pijama.
pa-çe: Küçük ayak. Pantolon, şalvar gibi şeylerin dizden aşağı olan kısmı. Paça. * Koyun, keçi ve sığır ayağı. * Koyun, keçi ve sığır ayağından yapılan yemek.
pa-çîle: Karda yürüyüp yol açmak gayesiyle ayağa giyilen bir çeşit ayakkabı.
pa-dam: (Ayaktan yakalayan) Kuş tuzağı.
pa-deş: Mükâfat.
pa-hast: Ayak altında kalmış, çiğnenmiş olan.
pa-kub: çengi.
pa-mal: Ayak altında kalmış, çiğnenmiş.,
pa-mal-î adüv: Düşmanların ayakları altında çiğnenmiş.
pa-nîhade: Ayak koymuş, ayak basmış. Gelmiş, ulaşmış, vâsıl olmuş. * Doğmuş, tevellüd etmiş.
pa-puş: Ayak örten. Ayakkabı, pabuç.
pa-renc: Ayak teri. ücret.
pa-sar: Tekme. Tepme.
pa-sebük: îşine sarılmış, ayağına çabuk.
pa-sîtade: Ayakta duran. Kaim.
pa-süvar: Yaya olan, yaya, piyade.
pa-yab: Kuvvet, kudret, tâkat. * Su birikintisi. * Havuzun dibi. * Kuyu basamağı. * Son, nihayet.
pa-zede: (Bak: Pâyzede)
paçan: Saçan, saçıcı.
paçavre: Paçavra, kirli bez.
paçek: Tezek, mayıs.
paçeng: Küçük pencere. * Baca, menfez delik.
pad: Saklayan, hıfzeden. * Büyük, ulu. * Bekleyen, muhafaza eden, koruyan.
padaş: (C.: Padaşân) Mükâfat, ecr. * Yoldaş. Yol arkadaşı.
padaşân: (Padaş. C.) Arkadaşlar, ayakdaşlar. * Mükâfatlar.
padav: Kocakarı.
pade: Eşek ve sığır sürüsü. * çoban sopası. * Yayla.
padergîl: (Pâ-der-gil) Ayağı çamurda. * Mc: Davranamaz. * Sıkıntıda.
paderhava: (Pâ-der-hava) Ayağı havada. * Mc: Temelsiz, çürük.
paderîkal: (Pâ-der-ikal) Ayağı köstekli, ayağı bağlı, hareketsiz.
paderpa: (Pâ-der-pâ): Ayak ayağa. Yanyana.
padgâne: Yüksek dam. * Kapı içinde olan pencere.
padîşah : (Pâdşâh) Büyük hükümdar, sultan. Cihan sahibi. Zararı def' eden, ıslah eden, muslih.
padîşah-i sânî: îkinci padişah. 
padîşahî : Padişahla ilgili, padişaha ait.
padzehr: Panzehir.
pafersud: (Pâ-fersud) Ayağı incinmiş, aşınmış olan.
pagande: Atılmış pamuk. * Atılmış pamuktan yapma yumak.
paguş: Suya dalma.
pajeh: înleme, inilti.
pajîr: Panzehir. 
pak: Temiz, saf, katıksız. Hep, tamam, mübarek, kudsi.
pak-baz: (C.: Pâk-bâzân) Temiz oynayan. * Mc: Sadakatli âşık.
pak-damenî: "Eteği temiz oluş" * Mc: Namusluluk.
pak-meşreb : Gidişi, yaratılışı temiz. îyi huylu olan.
pak-zad: Temiz asıllı. Aslı temiz olan.
pakan: (Pâk. C.) Temizler, pâklar. * Mc: Veliler, evliya.
pakâr: Tahsildar.
pakârî: Tahsildarlık.
pakdamen: Eteği temiz. * Mc: Namuslu.
pakend: Yakut. * şarap, bâde.
pakî: Temizlik, paklık. * Ustura.
pakîze: Temiz, pak. Lekesiz. Hâlis, saf, katıksız.
pakt: Fr. Akid, sözleşme, andlaşma. Siyasi anlaşma.
pala: Ağzı enli, ortasına doğru daha genişliyerek ucuna doğru daralmaya başlayan kalın, kısa ve ağır kılıç.
pala: Yedek at. * Asılmış, asılı. * Süzgeç.
palad: (Pâlâde) Yedek at.
palade: Kötü söyleyen, ayıp arayan.
palaheng: Yular, dizgin. * Av veya suçlu bağlanacak kement. * Kemer. * Tazı boynuna geçirilen ağaç halka.
palamar: Büyük gemileri karaya bağlamak yahut demir gomneye bedel lengere rabtetmek için kullanılan halat. * Büyük halat. (O.T.D.S.) * Vaktiyle muharebelerde silâh olarak kullanılan ve yük kaldırmak için kullanılan sırıklar. (Sanat Ansiklopedisi)
palan: Palan, semer, eğer.
palan-duz: Semerci, palancı. Semer diken.
palanî: Semerci.
palar: çatı direği.
palas pandiras: Hemen, birden bire, hazırlıksız, habersiz.
palavan: (Pâlâven) Süzgeç, helvacı süzgeci.
palavra: (îspanyolca) Mübalâğalı söz, yalan söylenen söz.
palay: (Bak: Pala)
paldüm: Hayvanın semerinin ileri geri kaymaması için arka ayaklarının kaba etleri üzerinden geçirilen kayış.
paleng: Postal. çarık.
paleng-î fersude: Eski çarık.
palîde: Süzülmüş, durulmuş. * Ziyade olmuş, büyümüş.
palîkane: Büyük han kapılarının ortasındaki küçük kapı.
palîkarya: Mc: Kabadayı, yiğit, cesur. * Rum gençleri.
palude: Süzülmüş, saf hâle getirilmiş.
paluş: Karışık.
palvane: Dağ kırlangıcı.
palvaye: Dağ kırlangıcı.
pan: Yun. "Bütün, karşı" mânasına kelimenin başına getirilerek kullanılır. Meselâ: Panzehir $: Zehire karşı ilâç.
pan-îslamîzm : Bütün müslümanların birleşmesi siyaseti. îttihad-ı îslâm. îslâm birliği siyaseti.
panayir: Yun. Yılda bir - iki defa muayyen bir yerde kurulan ve bir müddet devam eden büyük pazar.
pandomîma: Yun. Vahşi ve gürültülü karışıklık, anarşi. * Sessiz tiyatro oyunu.
pandomîma kopmak: Karışıklık çıkmak. * Seyircileri eğlendiren kavga çıkmak.
pano: Fr. üzerine ilân, tablo, vs. asmaya yarayan levha.
panzde(h): Onbeş.
panzehîr : Zehire karşı ilâç.
papa: îtl. (Baba kelimesinden) Roma Katolik kilisesinin ruhâni reisi.
papağan: îtl. însan konuşmasını taklid edebilen bir kuş.
papez: înişi ve yokuşu olan yer.
papure: îki çift öküz koşulan ağır bir cins saban.
par: Geçen yıl, bıldır. * Para.
parafe: Fr. Kısa imza, işâret.
paragraf: Yun. Düz yazıda bölümlerden herbiri.
paralel: Yun. Müvazi. * Geo: Bütün noktaları birbirinden aynı uzaklıkta olan çizgi veya hat, düzlük, satıh.
parantez : Yun. Cümle içinde geçen bir sözü, metin dışı tutmak için o sözün başına ve sonuna konulan işaret.
parav: Kocakarı, acûze.
paravan(a): îtl. Eskiden haremle selâmlığı ayıran ve şimdi de ilk bakışta görülmesi caiz olmıyan yerleri örten perdeler. * Daha ziyade kapıların dışına veya içine konan, katlanır, taşınır tenteneli perde. * Gizleme vasıtası.
parazît : Yun. Radyo gibi ses veya elektrik âletlerinin zırıltı ve gürültü çıkarması. * Başka bir hayvan veya nebatın üzerinde onun zararına yaşayan canlı. Asalak. Tufeyli.
parçe: Ufak şey, küçük nesne, parça.
parduz: Eskici, yamacı.
pare: Cüz, parça. Kesinti. * Para. Kuruşun kırkta biri. * Kur'an-ı Kerim'in otuz kısmından bir kısmı, bir cüz'ü. * Sayı, bölük. * "Parça" mânâsına gelir ve birleşik kelimeler yapılır. Meselâ: Meh-pâre $: Ay parçası. * Güzel. Yek-pâre $: Tek parça, bir parça.
pare-duz: Eskici, yamacı.
pare-pare: Parça parça.
pargî: Mutfak ve banyo sularının toplandığı çukur. * Orospuluk.
parîn: (Pârine) Geçen yılki, geçen sene olan, bıldırki.
parîr: Dayak, destek, direk.
parlamento: îng. Millet meclisi. Milletvekillerinden meydana gelen meclis ve senatonun tamamı.
pars: Dine bağlı kimse. * Nâmuslu, iffetli, temiz ve doğru insan. * Fars milleti, îran kavmi.
parsal: Geçen yıl, bıldır.
parse: Dilencilik.
parsel: Fr. Bir maksatla ayrılarak sınırlandırılmış arazi parçası.
parseng: Teraziyi denkleştirmek için kefesine konulan şey.
partîzan: Fr. Kendi partisine aşırı düşkün olup başkasına hak tanımak istemeyen kimse.
paru: (Pârub) Kocakarı, acûze.
parule: şakacı, lâtifeci. * Yonga. * Hayırsız ve işe yaramaz kişi. 
paryab: Irmak ve çay suyu ile sulanan ekin.
pas: Gecenin sekizde biri. * Gözetleme, bekleme. * Keder, hüzün, gam. * îç sıkıntısı.
pas-par: Tekme.
pasban (pâsuban): Nöbetçi, gece bekçisi, bekçi.
pasbanî: Bekçilik.
pasdar: Gece bekçisi.
pasdarî: Bekçilik, gözcülük.
pasek: Esneme, esneyiş.
paskal (pascal): Fr. Hristiyanlıkta dindarlığı ile beraber fizik, edebiyat, hesap, hendese ve felsefede (Milâdi 17. asırda) büyük bir âlim olarak tanınmıştır.
pastoral: Yun. Kır hayatına, köy âlemine dair yazılan manzume.
pasuh: Karşılık, cevap.
pasuhgüzar: Cevap veren, karşılık veren.
pasuhşînev: Cevabı dinleyen.
pasvan: Gece bekçisi.
paş : "Serpen, saçan, dağıtan" mânâsında birleşik kelimeler yapılır.
paş paş: Parça parça, ufak ufak. * Dağınık.
paşa: Sivillerle askerlerin ileri gelenlerinin bir kısmına verilen resmi ünvandı. Osmanlıların ilk devirlerinde bu ünvan, hânedân mensublarıyla yalnız bir kısım idare adamlarına verilirken sonradan askeriden "mir-i liva" ve daha yüksek rütbede olanlarla; mülkiyeden vezir, beylerbeyi, mir-i miran ve mir-ül ümera rütbelerine tahsis edilmiştir. Damat Paşa, Ağa Paşa, Vali Paşa o cümledendir.Paşa kelimesinin aslı hakkında pek çok ihtilâf vardır. Lügat erbabının bazıları, Farsça "Pây-i şah" lâfzından değiştirilmiş olduğunu; bâzıları da Türkçede büyük birâder mânasına gelen "Beşe" kelimesinin telâffuzunun zamanla "paşa"ya değiştiğini; bir kısmı da evin, ailenin büyüğü, reisi anlamına gelen "Baş ağa" dan tahrif edildiğini yazarlar. Ayrıca Türklerde büyük evlâda da paşa derler. Paşa tâbiri, hürmet ifadesi olarak, ulema ve meşâyihten bazılarına da verilmiştir. Bugün dilimizde generâl anlamına kullanılır. (O.T.D.S.)
paşali: Paşa ünvanını alan vezir ve beylerbeyi gibi büyük devlet adamlarının hizmetinde bulunan gedikli ağalar.
paşan: Saçan, saçıcı.
paşazâde: Paşa oğlu.
paşende: Saçan, dağıtan, saçıcı.
paşîb: Basamak, merdiven.
paşîde: Saçılmış, serpilmiş, dağılmış.
paşna: Topuk, ökçe.
paşnîn: Ağaç ve tahta parçaları.
patîle: Tencere.
patînî: Harman yabası.
patrîk: Yun. Rum ve Ermeni kiliselerinin ruhâni reislerine verilen isim.
patrîkhane: Patrik adı verilen Rum başpapazının oturduğu yer.
patrîklîk: Osmanlı saltanatı zamanında muhtelif gayr-i müslimlerin dini ve medeni bazı işlerini idare eden makamlar.
pay-der-gîl: Ayağı çamurda. * Sıkıntıda, dertte. * Mc: Davranamaz.
pay-der-hava: Ayağı havada. * Mc: Temelsiz, çürük.
pay-efzar: Ayakkabı.
pay-endaz: Ayak atan, ayak atmış. * Büyük kişilerin geçecek olduğu yerlere serilen halı gibi şeyler. * Duvar ve möbleleri kaplamada kullanılan bir cins kumaş.
pay-fersud: Ayağı incinmiş, aşınmış.
payan: Kenar, son nihayet, uç. * Tas: Ehl-i tarikatın ulaşacağı birlik âlemi. * Akıbet.
paybaf: çulha.
paybend: Ayakbağı. * Mani, engel. * Köstek.
paybeste: Hareketsiz. Ayağı bağlı.
paydar: (Pâyidar) îyice yerleşmiş. Devamlı, kadim. * Sağlam. Muhkem. * Sermedi. * Bedi. '* Sâbit.
paydarî: Devamlılık, süreklilik.
paydos: Tatil, teneffüs, serbestlik.
paye: Rütbe, derece. * Merdiven ayağı. * îlim sahibi olanların bir derecesi.
payedâr: Rütbeli, pâyeli, itibarlı.
payedârî: îtibarlılık, rütbelilik, pâyedarlık.
payende: (C.: Payendegân) Payanda, destek, dayak. * Duran, sürekli.
payendegî: Devamlılık, süreklilik.
paygâh: Derece, mertebe, rütbe.
payîn: Aşağı. Aşağı taraf. * Merdivenin ilk basamağı.
payîtaht: (Bak: Pâytaht)
payîz: Güz, sonbahar. * Yaşlılık, ihtiyarlık. * Eski, köhne, yıpranmış.
paykub: Ayak vuran. * Mc: Rakseden, köçek.
paymal: (Pâyimal) Ayak altında kalmış, mahvolmuş, telef olmuş, sürünmüş.
paymüzd: Bahşiş, ayak teri.
paytaht: (Pâyitaht) Merkez-i hükümet, başşehir, başkent.
payûe: (Bak: Pâ)
payzar: Ayakkabı, pabuç.
payzede: çiğnenmiş, ayak altında kalmış.
payzen: .f Ayağına pranga vurulmuş. Forsa, deniz esiri. * Suçlu. * Esir. * Hizmetçi, uşak.
pazac: Ebe kadın. * Dadı, sütnine.
pazen: Pezevenk.
pazîn: Gecenin bir kısmı.
pazîr: Destek, payanda, dayak.
pazubend : (Bak: Bâzubend)
peçe: (C.: Peçegân) însan veya hayvan yavrusu. * Oğlan, çocuk. * Sarmaşık bitkisi.
peçe: Kadınların tesettür için yüzlerine örttükleri tüle benzer örtü. (Bak: Tesettür)
peçegân: (Peçe. C.) însan veya hayvan yavruları.
peçel: üstü başı pislik içinde ve iğrenç olan adam.
pedagog: Yun. çocuk terbiyecisi, mürebbi.
pede: çakmak, kav. * Kavak ağacı.
pedender: üvey baba. Babalık.
peder: Baba.
pederâne: Babaya yakışır tarzda, pedercesine.
pederî: Babalık, pederlik.
pederze: çıkın, bohça.
pedîd: Aşikâr, görünür, açık, belli.
pedme: Nasib, kısmet. Pay, hisse.
pedrud: Vedâlaşma.
pehîn: çok enli.
pehle: Mezar sandukalarının yan taşlarına verilen ad.
pehlev: şehir, belde. * Yiğit, kahraman.
pehlevan: Pehlivan. Yiğit. Kahraman. Güreşçi.
pehlevanî: Pehlivanlık, güreşçilik, yiğitlik, kahramanlık.
pehlu: Vücudun iki yanından biri, yan.
pehn: Enli, geniş, yassı. * Genişlik, enlilik.
pehna: Genişlik, enlilik. * Enli, geniş, yaygın.
pehnane: Beyaz pide. * Bir cins maymun.
pehnaver: Pek geniş. Pek açık. * Soluk, solmuş.
pehnaverî: Enlilik, genişlik. Vüs'at.
pejgale: Pay, hisse. * Yırtık, yama.
pejm: Sis, duman.
pejman: Pişman, nâdim. * Kederli, hüzünlü.
pejmürde: Dağınık. * Eski, yırtık. * Perişan. * Buruşuk, buruşmuş.
pejmürde-hal: Kılığı kıyafeti pejmürde olan, üstü başı pis bir halde bulunan.
pejuh: Araştırma, soruşturma.
pejuhende: Gizli şeyleri araştıran. Mütecessis.
pejuhîde: çok akıllı, olgun, bilgili.
pejulîde: Solmuş, bozulmuş, dağılmış, karışmış.
pejvîn: Kirli, pis. çirkin.
pelade: Fesatçı. Müfsid.
pelas: çul, aba. * Eski kilim, keçe vs.
pele: Terazi kefesi.
pelîd: Pis, murdar. * Rezil ve alçak kimse.
pelîte: Lâmba veya kandil fitili. Fitil. * Yaralarda kullanılan fitil.
pelle: Derece. * Merdiven.
pelme: Yazı tahtası.
pelus: Hilekâr. Hile yapan.
pelvas: Yaltaklanma.
penagâh: Sığınacak yer. Sığınak. Melce'.
penah: Sığınma. Sığınacak yer. Dayandığı nokta.
penah-âverde: Sığınmış, iltica etmiş. Mülteci.
penahende: Sığınan, iltica eden.
penahgâh: Sığınacak yer, melce.
penahî: Sığınma.
penahîde: Sığınmış, iltica etmiş.
penam: Gizli, saklı. örtülü. 
penbe: Pamuk. * Açık kırmızı renk.
penbezâr: Pamuk tarlası.
penbezen: Hallaç. Pamuk atıcı.
penc: Beş.
pencah: Elli. (50)
pencahsâle: Elli yaşında.
pencgane: Beşli, beşten ibâret, beş tâneli.
pencîş: încinme.
penckuşe: Beş köşeli. Muhammes.
pencpay: Beş ayaklı. Yengeç.
pencruze: Beş günlük. * Süreksiz, pek az.
pencsale: Beş yaşında.
pencşenbîh: Beşinci gün. Perşembe.
pencüm: Beşinci.
pencümîn: Beşinci.
pençe: El ayası ile beş parmağın tamamı. * Hayvanların ön ayaklarının parmaklarıyla tırnakları. * Eskiden şark hükümdarlarının imza yerine ellerini kırmızı boyaya sürüp, kâğıdın üstüne basmalarıyla olan şekil, tuğra. * Mc: Kuvvet. Savlet, satvet.
pençe-î kahr: Kahir pençesi. Mahveden el.
pençezen : Pençe vuran, düşman.
pend: Nasihat, vaaz, öğüt.
pendîmî guş ettî: Nasihatımı dinledi.
pendkâr: (C.: Pendkârân) Nasihat eden, nâsih. öğüt veren.
pendnâme: öğüt kitabı.
penduz: çuvaldız.
penîr: Peynir.
per: Kanat.
per-aver: Kanat açan, kanat açıcı. Keskin uçan.
per-güşa: Kanat açıcı, uçucu. * Keskin uçucu.
perakende: Dağınık. Dağıtma. * Azar azar yayılan veya satılan.
perakendegû: Saçma sapan konuşan. Saçmalayan.
perandah: Sepilenmiş deri sahtiyan.
perçem: Kâkül. * Tepede bırakılan saç. * Mızrak ve bayrak gibi şeylerin başlarına konulan püskülümsü şeyler.
perd: Kıvrım, büklüm, kat. 
perda: Yarın.
perdaht: Cilâ. Parlaklık, parlama. * Düzleme, temizleme.
perdahte: Cilâlanmış, parlatılmış. * Temizlenmiş, düzenlenmiş, tertib edilmiş.
perdar: (Bak: Berdâr)
perdaz : Tertib eden, düzenleyen, düzeltici.
perde: Kapı, pencere gibi yerlere asılan veya iki yeri birbirinden ayıran, görünmeğe mâni olan şey. * Mc: Irz, namus, iffet.* Bir müzik parçasını meydana getiren seslerden herbirinin kalınlık veya incelik derecesi. * Bir sahne eserinin büyük bölümlerinden her biri. * Ekran, sinema perdesi. * Tıb: Aksu. * Mc: Gaflet. Basiretsizlik. (Bak: Esbabperest.)
perde yirtilmak: Hayasızlık etmek, utanmazlık.
perde-î cümud: Donmuş, katı perde. * Mc: Alem, tabiat. * Akıl ve hissiyatı kendisi ile meşgul edip, dini ve ulvi hakikatlardan ayıran, gaflet veren perde.
perde-î nîlgün: Gökyüzü, sema.
perde-î türabîye: Toprak perdesi, yer yüzü.
perdeber-endaz: Perdeyi kaldırıp atan. * Utanmayı bırakan, sıkılmayan, utanmayan, hayâsız.
perdeberdar: Perde kaldırıcı. Perde açıcı.
perdebîrun: Utanmaz, açıksaçık konuşan.
perdebîrunâne: Sıkılmadan, utanmazcasına. Perdeyi kaldırırcasına. Edebsizce.
perdedâr: Perdeci, kapıcı, odacı. Bir şeyin görünmesine ve bilinmesine mâni ve perde olan.
perdedâr-i felek: Ay, kamer.
perdeder: Perde yırtan. Utanmaz, hayâsız.
perdegî: (C.: Perdegiyân) îyi örtünmüş ve namuslu kadın.
perdekâr: Perdeli. Perde ile örtülü yer.
perdekeş: Perde çekici, örtücü. Engel, mâni.
perdenîşîn: Perde arkasında oturan. * Mc: Namuslu, temiz.
perdepuş: örten, örtücü.
perdeserâ: şarkı söyleyen, şarkıcı. * Saz çalan, çalgıcı. * Küçük çadır.
perdeserây: Küçük çadır. * şarkı söyleyen, şarkıcı, hânende. çalgıcı, saz çalan.
perdeşînâs: şarkı söyleyen, şarkıcı.
pere: Uç, kenar.
pere-î bînî: Burun ucu.
pere-î kûh: Dağ eteği.
perend-aver: çok keskin kılınç, pala veya hançer.
perende: Uçan, uçucu. * Av kuşu. * çark gibi dönerek atılan takla.
perendebâz: Takla atan kimse. Cambaz.
perendek: Küçük tepe.
perendîn: îpek elbise, ipek kumaş veya ipek mendil.
perendun: Evvelki gece.
perenduş: Dün gece.
perenduşîne: Dün geceki şey.
perendvar: Evvelki gece.
pereng: Suyu iyi verilmiş kılınç.
perest: (C.: Perestân) Tapan, tapınan, taparcasına seven.
perestan: (Perest. C.) Tapanlar, tapınanlar, taparcasına sevenler.
perestan: Ocak, fırın.
perestar: (C.: Perestarân) Hizmetçi. * Kul. * Tapan, tapıcı. * Dalkavuk.
perestar-i hayâl: şâir, ozan.
perestarân: (Perestar. C.) Kullar, köleler. * Hizmetçiler. * Dalkavuklar, yaltakçılık yapanlar. * Tapanlar, tapıcılar.
perestarî: Hizmetçilik. * Kulluk. * Tapıcılık. * Dalkavukluk.
perestîde: Sevgili, mahbub, sevilen.
perestîş : Pek çok sevmek. Bendelik etmek. îbâdet etmek.
perestîşkâr : îbâdet edercesine seven, çok ileri sevgi ve hürmet besleyen.
pergâl: Pergel.
pergâle: Kaba iplikten yapılan bir cins dokuma. * Parça.
pergâm: Döl yatağı. Rahim.
pergâr: Pergel. Dâire çizmeğe mahsus âlet.
pergârvâr: Pergel gibi.
pergaze: Kuş kanadının vücuda yapışık olan kısmı.
pergem: îşsiz güçsüz, boşta dolaşan adam.
pergul: Bulgur. * Bulgur pilavı. * Un helvası.
pergune: Yakışıksız, çirkin.
perh: Hisse, pay. * Değersiz mal.
perhaş: Savaş, harb, muharebe, cidâl, ceng. Kavga.
perhaşcu(y): Muharib, savaşçı. Kavgacı.
perhîde: îşaret olunmuş.
perhîz : Sakınmak, çekinmek. * Vücuda zararlı ve tıbben muzır; ve dinen, zevk veren şeylerden sakınmak. * Hastalıkta bazı yiyecek ve içeceklerden sakınmak.
perhîzkâr : Perhiz eden, nefsini tutan. Zararlı şeylerden, günahlardan sakınan.
perhun: Pergelle çizilmiş çember, dâire, halka.
perhüde: Saçmasapan söz, hezeyan. * Ateşten dolayı sararmış eşyâ.
perî: Cisimleri çok lâtif ve görünmez olan hoş mahluk. * însana muhabbet eden, muvahhid ve müslim lâtif mahluk. *Mc: Güzel insan. Güzel kimse.
perî peyker: Peri yüzlü güzel.
perî-çîhre: Peri yüzlü, güzel yüzlü.
perî-î melâhat: Güzellik perisi.
perî-ru: Peri gibi güzel yüzlü.
perîde: Uçmuş. *Solmuş, soluk.
perîdereng: Rengi uçmuş, solmuş.
perîr: Evvelki gün.
perîşan : Dağınık, karışık. * Bozuk, tertibsiz, düzensiz. * Kederli, hüzünlü, kaygılı.
perîşanhâtir: Dalgın, düşünceli.
perîşanî: Perişanlık, dağınıklık. * Düzensizlik, bozgunluk. * Yoksulluk, fakirlik.
perîz: Haykırma, bağırma. Feryâd. * Su kenarlarında yetişen yeşil saz, ot.
perîze: Ateşte pişirilen ekmek. * Kırmızı altun.
permer: ümid etme, umma, bekleme. întizar.
permun: Süs, bezek.
pernîh: înce düz taş.
pernîyan: Nakışlı atlas. îpekten dokunmuş, bir cins işlemeli kumaş.
pernun: înce ve zarif dokunmuş ipek kumaş.
perran: Uçan, uçucu.
personel: Fr. şahsa dâir. şahsi. * Bir işte çalışanların hepsi.
pertab: Atılma, sıçrama. * Hız almak için geriden koşarak atılma. * Uzağa düşen ok veya başka bir şey.
pertev: (Pertav) Ziya, ışık. * Atılma, sıçrama, hız.
pertev-endâz: Işıklandıran, ziyâ veren, nurlandıran.
pertev-feşan: Işık saçan, ziya saçan.
pertev-î mîhr: Güneş ışığı. Güneşin parlaklığı. 
pertev-suz: Yakan ışık. Güneşe karşı tutulduğu zaman, ışıkları bir noktaya toplayan ve bu suretle ışığın değdiği yeri yakan mercek.
peruş: Küçük çıban, sivilce. 
perva: Korku, çekinmek. * Alâka, ilgi, bağ. * Takat. * Durup dinlenmek. * Bilmek. * Vesvese. * Kayd. * Iztırab. * Terk, feragat. * Hayran, şaşmış. * Meyl, teveccüh, iltifat, kayırmak. * Gussalanmak. (L.R.)
pervane: Fırıldak çark. * Geceleri ışığın etrafında dönen küçük kelebek. * Haberci, kılavuz.
pervanegân: (Pervane. C.) Gece kelebekleri.
pervanek: Karakulak adı verilen bir hayvan. * Ask: öncü, pişdâr.
pervar: Besili, beslenmiş.
pervas: El ile dokunup temas etme, eli ile yoklama.
pervaz : Kanat açmak, uçmak. Uçan, uçucu. * Nur. * Karargâh. * Saçmak. * Hücre. * Saçak. * Ayna. Dolap. * înce, uzun tahta. * Uçan, uçucu gibi mânâlara gelerek birleşik kelimeler yapılır.
pervaz-i berdâr : Yükselip uçan. Uçarak dolaşan.
pervaze: Kır gezisi için hazırlanan yemek. * Altun ve gümüş yaprakların kırıntısı.
pervazgâh: Uçulacak yer. Tayyâre meydanı. Hava alanı.
perver: (Pervar) "Besleyen, yetiştiren, velinimet, koruyan" mânâsında birleşik kelimeler yapılır.
perverân: (Perver. C.) Yetiştirenler, besleyenler, koruyup terbiye eden kimseler. 
perverde: Terbiye görmüş, yetiştirilmiş, beslenmiş.
perverende: Besleyen, büyüten. Besleyici, büyütücü. * Terbiye edici, yetiştirici.
perverî: Büyütücülük, besleyicilik. Terbiye.
perverîş: Besleme, besleyiş. Beslenme. * Terbiye etme, yetiştirme, eğitme. Terbiye edilip yetiştirilme, eğitilme. * îlerleme, terakki.
perverîşyâb: Beslenen. * Terbiye edilen, terbiye gören, eğitilen, yetiştirilen.
perverîşyâfte: Terbiye edilmiş, büyütülmüş, yetiştirilmiş, eğitilmiş.
pervîn: ülker denilen yedi yıldızın tamamı.
pervîz: üstün, galib, muzaffer. * Elek. Süzgeç. * Güzellik. * Balık. * Cilve. * Tar: îran Hükümdarı Husrev'in lâkabı.
pervîz-î felek: Güneş, şems.  
pervîzen: Elek, kalbur.
pes: Arka, art, geri. * öyle ise, imdi...
pes ü pîş: Arka ve ön.
pes-î dîvâr: Duvarın arkası.
pes-î perde: Perde arkası.
pesadet: Veresiye alışveriş.
pesavend: Kafiye.
pesend: Beğenmek, kabul eylemek. Beğenici. Muvâfık.
pesendâne: Beğenecek yolda, beğenmek suretiyle.
pesendîde: Beğenilmiş, seçilmiş, müntehab.
pesîn: Sonraki, gerideki, en son.
pesmande: Geri kalmış, geride bulunan, bâkiye. * Artmış, artık.
pesmande-hor: Artık yiyen.
pesperde: Perde arkası, gizli iş.
pesrev: Arkadan gelen. * Uşak, hizmetçi.
pest: Alçak, aşağı. Hafif, yavaş ses. * Sesi galiz, kalın ve korkunç olan.
pestbaht: Talihsiz. Bahtı fenâ olan.
pestî: Alçaklık, âdilik, zillet.
pestpaye: (C.: Pestpayegân) Payesi, derecesi aşağı olan, âdi. Alçak. Bayağı. Pespaye.
pestperde: Alçak ve hafif sesle.
pestsada: Hafif ses.
peşe: (Bak: Peşşe)
peşîman: Pişman. Nâdim.
peşîmanî: Pişmanlık, nedamet.
peşîn: Nakdi para. * önceden, önce.
peşînât: Peşin verilen paralar.
peşîz: (Peşize) Akçe, mangır. Pul. * Balık pulu.
peşkeş : (Pişkeş) Başkasının malını birine bağışlamak. Verilmemesi lâzım olan şeyi başkasına vermek. Karşılıksız vermek.(Bir şeyde mehâsin ve şeref hâsıl oldukça, havassa peşkeş ederler; seyyiât olsa, avâma taksim ederler! M.)
peşleng: Geri kalan, geri kalmış.
peşm: Yapağı, yün. * Keten helvası.
peşmîn: (Peşmine) Yünden yapılmış. Yapağıdan yapılma. * Sâde ve süssüz elbise.
peşrev: (Aslı: Pişrev) önde giden. * Türk müziğinde bir saz eseri. * Güreşten önce pehlivanların ellerini birbirine veya dizlerine çarparak ve biraz sıçrayarak yaptıkları oyun. * Bir çeşit ok.
peşşe: Sivrisinek.
peşşegîr: Sinek avlıyan. * Mc: îşsiz güçsüz, boş gezen kimse.
peter: Düz maden levha.
petgîr: Kıl elek.
pey: îz, işaret, nişan. * Ard, arka, akab.
pey-a-pey: Birbiri ardınca, birbirinin arkasından. * Azar azar, tedricen, peyderpey.
pey-der-pey: Birbiri ardınca. Yavaş yavaş, azar azar.
pey-ender-pey: Ardısıra, arka arkaya, durmadan. Azar azar.
peyam: (Peygam) Haber.
peyam-âver: (C.: Peyamâverân) Haber getiren.
peyam-ber: Haber getiren. Peygamber.
peyam-i hasret: Hasret, özleyiş haberi.
peyda: Mevcud, var olan, açık, âşikâr, meydanda olan.
peyemres: Haber getiren, haber ulaştıran, haberci.
peygam: (Bak: Peyam)
peygamaver: (Peygam-âver) Haber getiren, haberci.
peygamber: (Peyamber) Allah'tan haber getiren. Allah'ı, âhireti, zararlı ve faydalı şeyleri tanıtan. Nebi. (Bak: Mefhar-ı kâinat, Muhammed (A.S.M.), Nübüvvet, Resül)
peygamberân: (Peygamber. C.) Peygamberler.
peygamberî: Peygamberlik. * Peygamberle alâkalı.
peygar: Savaş, harb, muharebe, cidal. Kavga.
peygare: îftira.
peygule: Köşe, bucak.
peygule-î nîsyan: Unutulma köşesi.
peygulegüzîn: Bir köşede oturan. Köşeye çekilmiş olan.
peygun: And, şart, ahd, peyman.
peyk: Bir şeyin etrafında, ona tabi olarak dönen. Seyyare. * Haber ve mektup getirip götüren.
peyk-î felek: Ay. Dünyanın etrafında dönen ay. Dünyanın peyki. 
peykan: Okun ucundaki sivri demir.
peyke: Tahta sedir.
peyker: Yüz, çehre, surat.
peym: Haber. 
peyma: ölçen, ölçücü.
peyman: And, yemin, muahede, ahitleşmek.(Cihet-ül vahdet-i ittihadımız, tevhiddir. Peyman ve yeminimiz, imandır. Madem ki muvahhidiz, müttehidiz. Her bir mü'min ilâ-yı Kelimetullah ile mükelleftir. Bu zamanda bunun mühim bir sebebi maddeten terakki etmektir. H.ş.)
peyman-şîken: (Peyman-şikân) Yemin bozan, ahdini yerine getirmeyen.
peymane: Büyük kadeh. * ölçek, kile. * şarap bardağı.
peymane-şîkest: Kadehi kırık.
peymanekeş: îçki içen.
peymay: Tartıcı, ölçücü.
peymude: ölçülmüş.
peyrev: Ardı sıra giden, tâbi olan, izinden giden, uyan.
peysîper: çiğnenmiş, ayak altında kalmış.
peyug: (C.: Peyugân) Gelin.
peyugan: (Peyug. C.) Gelinler.
peyvend: Ulaşma, varma, vasıl olma. * Bağ, alâka.
peyvest: Ulaşma, vasıl olma, kavuşma.
peyveste: Her zaman, dâima. * Ulaşmış, ermiş. * Bitişik, muttasıl.
peyvestegî: Bitişme, ulaşma, bitişiklik.
pezîr : Kabul eden, olan, olabilen. * "Söz dinleyici, emir tutan" mânasında birleşik kelimeler yapılır.
pezîra: Kabul eden.
pezîray-hîtam: Sona eren, biten, hitam bulan.
pezîre: Karşılama, karşılayış.
pezîrîş: Kabul edilmiş. Kabul ediş. 
pilaçka: (Arnavutça) Tar: Muharebede ve yağmada alınan eşya, çapul.
pirlanta: îtl. çok tıraş edilmiş, foyasız parlak elmas. Taşı pırlanta olan.
pîç: Büklüm, kıvrım, dolaşık. * Nesebi gayr-ı sahih olan, gayr-ı meşru münâsebetten doğan çocuk. * Aslına benzemiyen. * Ağacın kökünden biten sürgün. Aşılanmamış ağaç. * Sarmaşık. * Vida.
pîç ü tab: Iztırab ve sıkıntı. 
pîç-a-pîç: Karma karış, pek dolaşık, kıvrım kıvrım.
pîç-pa: Yengeç.
pîçan: Büklüm büklüm, kıvrım kıvrım olan.
pîçîde: Karışmış, bükülmüş, kıvrılmış. 
pîçîdemuy: Saçı kıvrılmış.
pîçîş: Büklüm, kıvrım.
pîçtab: Sıkıntı, telâş. * şaşkınlık.
pîh: îçyağı. şahm.
pîh: Göz çapağı.
pîh-suz: "Yağ yakıcı": Toprak kandil. 
pîjuh: (Bak: Pejuh)
pîl: Topuk, ökçe. * çelik çomak oyunu. * çadır eteği tutturmada kullanılan küçük ağaç değnekler.
pîl: Fil.
pîl-bân: Fil besleyen, filci.
pîl-ten: Fil gibi iri, fil vücutlu.
pîl-zur: Fil gibi kuvvetli, fil kuvvetinde.
pîle: îpek kozası. îpek.
pîleste: Fildişi.
pîlvaye: Kırlangıç.
pîndar: Sanma, zannetme. * Böbürlenme.
pîne: Yama.
pîneduz : Yamacı. * Ayakkabı tamircisi, eskici.
pîneduzî: Eskicilik, yamacılık.
pîneduzluk: Yamacılık. Eskicilik.
pîngan: Fincan, tas.
pîngançe: Küçük fincan.
pînhan: Gizli, saklı, hafi, mahfi, mestur, müstetir.
pîr: Yaşlı, ihtiyar. * Reis. * Bir tarikatın kurucusu. * Herhangi bir meslek ve san'atın başlatıcısı, te'sis edicisi.(Kur'an-ı Hakim; enbiyaları, insanın cemaatlerine terakkiyat-ı mâneviye cihetinde birer pişdar ve imam gönderdiği gibi; yine insanların terakkiyat-ı maddiye suretinde dahi o enbiyanın herbirisinin eline bâzı hârikalar verip yine o insanlara birer ustabaşı ve üstad etmiştir. Onlara mutlak olarak ittibaa emrediyor. îşte enbiyaların mânevi kemâlatını bahsetmekle insanları onlardan istifadeye teşvik ettiği gibi, mu'cizatlarından bahis dahi; onların nazirelerine yetişmeye ve taklitlerini yapmaya bir teşviki işmam ediyor. Hattâ denilebilir ki: Mânevi kemalât gibi maddi kemâlâtı ve hârikaları dahi en evvel mu'cize eli nev'-i beşere hediye etmiştir. îşte Hazret-i Nuh'un (Aleyhisselâm) bir mu'cizesi olan sefine ve Hazret-i Yusuf'un (Aleyhisselâm) bir mucizesi olan saatı; en evvel beşere hediye eden, dest-i mu'cizedir. Bu hakikata lâtif bir işârettir ki: San'atkârların ekseri, herbir san'atta birer peygamberi pir ittihaz ediyor. Meselâ gemiciler Hazret-i Nuh'u (Aleyhisselâm), saatçılar Hazret-i Yusuf'u (Aleyhisselâm), terziler Hazret-i îdris'i (Aleyhisselâm) ... S.) 
pîr ü berna: îhtiyar ve genç.
pîr-î fanî: Pek yaşlı, zayıf adam. Dünyayı terketmiş ihtiyar.
pîr-î moğan: (Pir-i muğan) Meyhaneci. * Mc: Mürşid.
pîra: Süsleyici, düzenleyici, donatıcı.
pîrahen: (Pirehen) Gömlek. Kamis.
pîrahen-î îsmet: Namus perdesi.
pîramen: çevre, etraf, yan.
pîramun: Yan, etraf, çevre.
pîran: (Pir. C.) îhtiyarlar, yaşlılar.
pîraste: Tertibedilmiş, düzenlenmiş donatılmış, süslü.Pirastegi $ . Düzen, intizam. 
pîraye: Zinet. Süs.
pîrayebahş: Süsleyici, süs veren.
pîrayende: Süsleyici, donatıcı.
pîrayîş: Düzen, nizâm, intizam, tertib. * Süs, zinet.
pîrehen: Gömlek.
pîrezen: Kocakarı, acuze.
pîrî: îhtiyarlık. Kocamışlık.
pîrîstu: (Piristuk) Kırlangıç kuşu.
pîrîstubeçe: Kırlangıç kuşu yavrusu.
pîrsal: Kocamış, ihtiyar, yaşlı.
pîruz: Uğurlu, hayırlı.
pîruzî: Uğurluluk, hayırlılık.
pîrzen: Kocakarı, acuze. Yaşlı kadın.
pîse: Saksağan. * Alaca renk.
pîstan: Meme.
pîste: Fıstık.
pîster: Yatak, döşek.
pîş : Huzur, ön, ileri taraf.
pîş-geh: ön, huzur.
pîş-gîr: Havlu, peşkir.
pîş-î nazar: Göz önü.
pîş-î nazara getîrmek: Göz önünde bulundurmak.
pîş-müzd: Pey, pey akçesi. Satılık bir şeye talip olan kimsenin, sonradan caymayacağını temin makamında olmak üzere satıcıya peşin verdiği bir miktar para.
pîşadest: Peşin para ile alış veriş. * îşçiye, çalıştıktan sonra verilen para.
pîşaheng: (Piş-âheng) önde giden, öne düşen.
pîşan: En ön, en ileri.
pîşanî: Alın, cebin.
pîşanîdâr: Yüzsüzlük yaparak işini beceren.
pîşbîn: îlerisini gören. Basiretli, ihtiyatlı.
pîşdar : öncü. Harpte ileriden düşmana gönderilen askerler. * önde giden. önayak olan. * San'at, meslek. * Kumandan. * Mc: Yüzsüz. Yüzsüzlükle iş beceren.
pîşe : îş, kâr. Meşguliyet. * Alışkanlık, huy, âdet. * Meslek, san'at. * "Huy edinmiş, alışmış" anlamlarına gelir ve birleşik kelimeler yapılır. Meselâ: Hasenât-pişe $: îyi şeyleri âdet edinmiş olan.
pîşegâh: îş yeri. Fabrika.
pîşegân: (Pişe. C.) Meslekler, san'atlar. îşler. * Huylar, âdetler, tabiatlar.
pîşeger: San'atkâr işçi.
pîşekâr: Sanatkâr, oyuncu.
pîşever: Sanat ehli, işçi.
pîşhane: Balkon. * Bir yere gidileceği zaman önceden gönderilen çadır ve yol eşyası.
pîşhayme: Pâdişah veya vezirlerin divan çadırı.
pîşî : îlerleme, üstünlük, tefevvuk. * önünü gören, ileri görüşlü.
pîşîgâh : Huzur.
pîşîn: Peşin, önce, önden. * Evvelki, eski. * önden verilen.
pîşînî: (C.: Pişiniyan) Evvel zaman adamı.
pîşkeş: Hediye, armağan, hibe.
pîşnemaz: îmam.
pîşnîhad: Usûl, kanun. * Temel, esas.
pîşrev: önden giden.
pîştahta: çekmece. Küçük sandık. * Mal serilen yer, vitrin.
pîşva: (Pişuva) Reis, baş. Hâkim. * Mukteda, imâm.
pîşvayan: (Pişvay. C.) Reisler, başkanlar. Hâkimler.
pîyade: Narin yapılı bir çeşit kayık adıdır. Eskiden ekseriyetle îstanbul ve civarında kullanılan bu kayıklar, pek makbul gezinti vasıtası idi. * Ask: Orduda tüfekle teçhiz edilmiş olan ve muharip sınıfların asli unsuru bulunan efrada da bu ad verilir. Yaya askeri. * Yaya.
pîyale: Kadeh. şarap bardağı.
pîyaz: Soğan. * Zeytinyağlı ve sirkeli fasulye haşlaması.
plan: Fr. Yapı, makine, bina...gibi yapılacak şeylerin ayrı ayrı parçalarını kâğıt üzerinde gösteren çizgilerin hepsi.
polat: (Pulat da denir) çelik. * Mc: Sağlam, sert.
polîtîka: îtl. Memleket işlerini idare için tutulan ölçülü yol. Siyaset.
post: Tüylü hayvan derisi. * Mc: Makam, mevki.
posta: îtl. Bir yere gelen veya bir yerden gönderilen mektup ve emânetlerin hepsi. * Bu emânetleri toplayan ve dağıtan idare ve onun yeri. * Belli zamanlarda sefer yapan ve çok zaman posta taşıyan vasıta. * Takım, kol. * Hizmet nöbetinde bulunan er. * Sefer.
postîn: Kürk.
postînduz: Kürk diken.
postînpuş: Kürk giyen.
postnîşîn: Posta oturan. Daha evvelkinin yerine geçen.
pot: t. Irmakları geçmek için kullanılan sal. * Dikişin bir tarafında görülen kumaş kabarığı.
pot kirmak: Farkında olmıyarak karşısındakine dokunacak söz söylemek.
pota: Toprak veya mâdenden yapılmış, kimyacı, eczâcı, mâdenci veya kuyumcu âletlerindendir. Altın, gümüş ve benzeri mâdenlerin eritilimesine mahsustur.
poz : Fr. Fotoğraf alınırken kendine düzen vermek, tavır takınmak. Kımıldamadan durduğu halde kalmak.
pozîsyon : Fr. Vaziyet, durum, duruş.
pozîtîf : Fr. Tecrübe neticesine dayanan, müsbet, isbatlı. Negatifin zıddı.
pozîtîvîst : Fr. Fls: Pozitivizm taraftarı.
pozîtîvîzm : Fr. Fls: Hakikatın yalnız tecrübe ve müşahede ile vakıalara istinaden tam olarak bilineceği iddiasında olan felsefe sistemi. (Bak: îsbatiyecilik)
pranga: îng. Eskiden ağır cezalı mahkûmların ayaklarına takılan kalın zincir. * Halkalarıyla beraber iki okka yüz dirhem ağırlığındaki demire verilen addır. * Umumi hapishanelerde, hapishanenin iç nizamını bozan ve taşkınlık gösteren mahkûmların ayaklarına da pranga vurulurdu.
prens bîsmark: (1815 - 1898) Meşhur Alman siyasilerinden ve Alman birliği için çalışanlardan birisidir. îslamiyeti ve Hz. Peygamber'i (A.S.M.) medh ü sena ederek hayranlığını bildiren bir mütefekkirdir.
prensîp: Fr. Umde. îlk unsur. Temel kanaat, temel düşünce. Temel bilgi * Man: Her çeşit münakaşanın dışında olan.
program: Fr. Yapılacak işler için önceden hazırlanmış tasarı. Plân.
proje ©: Fr. Tasarlanan ilk şekil. Tasarı. Mütehayyel.
projeksîyon ©: Fr. Kuvvetli ışık âleti.
propaganda: Fr. Bir fikri veya malı herkese bildirmek veya kabulü için yapılan ilân. çok kıymetli olduğu veya olmadığı hâlde bir şeyin kıymetini arttırmak maksadiyle yapılan konuşma veya ilânat.
proteîn: Lât. Tıb: Albüminli besleyici madde.
protestanlik: (Prutluk) Papayı Hristiyanların başı olarak tanımayıp ruhaniyetini kabul etmeyen bir Hristiyanlık mezhebi. (Bak: Nasraniye)
proton: yun. Atom çekirdeğinde pozitif yüklü zerrecik. (Bak: Delil-i inayet) 
prutluk: (Bak: Protestanlık)
psîkolog: Fr. Ruhiyatçı, ruh ilmiyle uğraşan.
psîkolojî ©: Fr. Ruhiyat, ruhi hâdiseleri tetkik eden ilim kolu.
psîkoz : Fr. Tıb: Akıl hastalıklarının umumi adı.
pu: (Puy) Araştırma, arama. * Koşma.
puç: Kaba, çirkin. * Boş ve faydasız şey. * îçi boş.
puç-magz: Boş kafalı.
puhte: (C.: Puhtegân) Pişmiş, pişkin. Olgun, kâmil insan.
puhtegân: (Puhte. C.) Olgun kimseler, pişkin kişiler.
puhtegî: Olgunluk, kemalât, pişkinlik.
pujîne: Kantar.
pul: Para.
pulad: çelik.
puladbâzu: çelik pazulu. Kuvvetli, yiğit.
puladsenc: Güzel silâh kullanan, iyi dövüşen.
pur: (C.: Purân) Oğul. Evlâd. 
pur-î duht: Hemşirezâde, yeğen.
purân: (Pur. C.) Oğullar, veledler.
purmend: Evlâd sahibi.
pusîde: çürümüş, paslanıp çürümüş, çürük.
puş : "örten, giyen, giyinmiş" mânasına birleşik kelimeler yapılır. * örtü, elbise, zırh.
puşe: (Bak: Puşide)
puşende: örten. örtücü.
puşende-î hatâ: Ayıp örten.
puşîde : (Puşe) örtülmüş. * örtü. * örtülü, gizli.
puşîde-çeşm: örtünecek, giyilecek şey. * örtü.
puşîde-raz: Sırrı gizli.
puşîdenî: örtünecek, giyilecek şey. örtü.
puşîş: örtecek şey. örtü.
put: Allah'tan başka tapılan herşey. * Heykel. Sanem. Kendisinden medet beklenen veya lâyık olmadığı hürmet kendine yapılan maddi mânevi resim, heykel ve her çeşit cisim.
put-perest: Allah'tan başka şeyleri ilâh kabul eden, puta inanıp ona ibâdet eden. Puta tapan. (Bak:Büt-Perest)
pute: Silâh veya ok atışlarında dikilen nişan tahtası. * îçinde mâden eritilen tava. 
puya(n): Koşan. Seğirten.
puyan olmak: Koşmak. Batmak. Dalmak.
puye: Koşma, seğirtme.
puyeger: Koşucu.
puyende: Koşan. Seğirtici. Koşucu.
puzen: Nadas edilmiş, sürülmüş tarla.
puzîne: Maymun.
puzîş: özür, mâzeret.
pül: Köprü.
pülpül: Karabiber.
pünçüşk: Serçe.
pür: çok, dolu, çok fazla, memlu, tekrar (mânâlarına gelir, birleşik kelimeler yapılır) *Sâhib, mâlik.
pür-âmâl: îstek ve emellerle dolu.
pür-âteş ü hevl: Ateş ve korku dolu.
pür-bâd: Kibirli. * çok rüzgârlı.
pür-bîm: Korkmuş.
pür-çîn: çok buruşuk, çok bükülmüş ve karışık.
pür-dîl: (C: Pür-dilân) Yürekli, cesur.
pür-dîlân: (Pür-dil. C.) Cesurlar, yürekli kimseler.
pür-dud: çok tüten, çok dumanlı.
pür-emvât: ölüler dolu.
pür-envâr: (Pür-nur) çok parlak, çok nurlu.
pür-fer: çok parlak. çok aydınlık.
pür-gazab: çok kızgın ve hırslı.
pür-gû: çok söyliyen, çok konuşan.
pür-gubâr: çok tozlu. Toz içinde.
pür-hânde: Neş'e dolu, çok gülme ve sevinç dolu. Sevinçli, neşeli.
pür-hayâl: Hayal ile dolu. 
pür-hazân: Sonbahara uğramış, solup sararmış.
pür-heves: çok hevesli. Heves dolu.
pür-heyecân: Heyecan dolu. çok heyecanlı.
pür-hun: Kan içinde. Kan dolu.
pür-kîne: Düşmanlık ve gazab dolu.
pür-nâr: çok ateşli. çok kızgın. Ateş dolu.
pür-nâz : çok nazlı.
pür-nevâl: çok lütuf ve ihsan. çok çok ihsan etmek, vermek.
pür-nur: (Bak: Pür-envar)
pür-paye: Kırkayak.
pür-sâle: Yaşlı. Yaşı dolgun.
pür-suz: çok yakıcı. çok yanık.
pür-şa'şaa : çok gösterişli, şa'şaa dolu.
pür-temkîn: çok ağır başlı. çok temkinli.
pürsan: (Pürsâ) Soran, sorucu.
pürsîş: Soruş, sorma, sual ediş.
pürsîş-î hâtir: Hatır sorma.
püryan: (Bak: Biryan)
püsender: üvey oğul. üvey evlâd.
püser: (C.: Püserân) Erkek çocuk, oğul.
püşt : Sırt, arka.
püşt-pa: Ayak tabanı.
püşte: Tepe, yığın.
püşte-î bağ: çimenlik, çayırlık.
püşter: Arka, sırt.
püştîban: Payanda, destek, dayanak. * Yardımcı, muin.
püştîvan: Destek, dayanak, payanda. * Yardımcı.
püştmal: Peştemal.
püştvare: Bir hamal yükü. Bir arkalık yük.
