ra: Kur'an alfabesinde onikinci harftir. Ebced hesabında 200 sayısına işaret eder. Bu harfe "Rı" denildiği gibi, "Ra-i mühmele" de denilir. Bazı tarih kayıtlarında" Rebi-ül Evvel" ayına işaret olarak geçer.
ra: îsim veya zamirin sonuna ilâve edilirse, Türkçedeki i, im, in, a, e eklerinin yerine kullanılır. Meselâ:Hâne: Ev. Hâne-râ: Evi, evin, eve.Tû: Sen. Tû-râ: Seni, senin, sana.
ra': Küçük kene.
ra': şiddetle sürmek.
ra-î mühmele: Noktalı ze'den ayırmak için "rı" harfine verilen bir ad.
raa': Boğazına hizmet eden adi insan.
raabe: Genişlik, vüs'at. * Büyük olmak.
ra'ad: Geveze kimse. çok konuşan adam. * Torpil balığı.
raale: Hamakat, ahmaklık.
raaş: (Ra'şe-Ra'şen) Titretmek.
ra'b: Doldurmak. * Efsun, (sihir yapanlar okurlar.)
rab': Vasat, orta boylu. * Avlulu ev.
rab'at: (C.: Rabeât) Attarların dağarcığı ve kutusu. * Orta boylu kimse.
rabb: Sâhib, mâlik, seyyid. Cenab-ı Hak (C.C.) * Besleyen, yetiştiren, terbiye eden. Müstahik. Hüdâvend. (Kur'an-ı Kerim'de bu "Rabb" ismi ile Cenab-ı Hak 846 def'a zikredilir.) (Bak: âlem)( Yâni: Herbir cüz'ü bir âlem mesabesinde bulunan şu âlemi bütün eczasiyle terbiye ve yıldızlar hükmünde olan o cüz'lerin zerratını kemal-i intizamla tahrik eder. Evet Cenab-ı Hak herşey için bir nokta-i kemal tayin etmiştir. Ve o noktayı elde etmek için o şeye bir meyil vermiştir. Her şey o nokta-i kemale doğru hareket etmek üzere, sanki mânevi bir emir almış gibi muntazaman o noktaya müteveccihen hareket etmektedir. Esna-yı harekette onlara yardım eden ve mânilerini def'eden, şüphesiz Cenab-ı Hakk'ın terbiyesidir. Evet, kâinata dikkatle bakıldığı zaman, insanların taife ve kabileleri gibi, kâinatın zerratı, münferiden ve müçtemian Hâliklarının kanununa imtisalen, muayyen olan vazifelerine koşmakta oldukları hissedilir. " Yalnız bedbaht insanlar müstesna!" î.î.)
rabb: üveybaba.
rabb-üd dâr: Ev sâhibi.
rabb-ül âlemîn: Bütün âlemlerin Rabbi. Her âlemi doğrudan doğruya Rububiyyeti ile tâlim, terbiye, tedbir ve idâre eden Cenab-ı Hak.(Kur'an-ı Kerim) (bazan iki kelimede, meselâ... Rabbüke tabiri ile ehadiyyeti ve Rabb-ül âlemin ile vâhidiyyeti bildirir. Ehadiyyet içinde vâhidiyyeti ifade eder. Hattâ bir cümlede bir zerreyi bir göz bebeğinde gördüğü ve yerleştirdiği gibi; güneşi aynı âyetle, aynı çekiçle göğün göz bebeğinde yerleştirir ve göğe bir göz yapar. M.N.)(Her bir şey, hareketiyle bütün eşyayı vahdet nâmına zabteder. Demek, bütün yıldızları elinde tutmayan, bir tek zerreye Rabb olamaz. S.)
rabb-ül erbab: Bütün sâhiblerin, terbiyecilerin Rabbi, Allah. (C.C.)
rabb-ül mal: Mal sâhibi. Sermaye sâhibi.
rabbanî: (Rabbaniye) Rabbe âit. Cenab-ı Hakk'a dair ve müteallik. îlâhi. * ârif-i Billâh olan, ilmi ile amel eden âlim.
rabbanîyyun: (Rabbaniyyin) Kendisini tamamen Cenab-ı Hakk'a vermiş olanlar. Putperestlikle alâkası olmayanlar.
rabbat: Kadınların efendileri, sâhipleri, kocaları.
rabbe: üveyana.
rabbena: Ey bizim Rabbimiz! Ey Sâhib-i Hâlikımız! Ey bizi terbiye edip besleyen sâhibimiz! (meâlinde).
rabbî: Ey benim Rabbim.
rabbî yessîr velâ tüassîr: Ey Rabbim! Kolaylaştır, zorlaştırma, bana imdad eyle, yardım eyle (meâlinde).
rabe: Yoğurt damızlığı.
rabea: Devenin katı katı yelmesi.
rabit(a): Rabteden, bağlayan, bitiştiren. * Münasebet, alâka, bağlılık, yakınlık. îki şeyi birbirine bağlayan tertip. * Nefsini dünyadan men edip âhirete, Allah'a (C.C.) bağlanmak. * Tertip, sıra, düzen, usûl.(...Evet, tevhid-i imani, elbette tevhid-i kulûbü ister. Ve vahdet-i itikad dahi, vahdet-i içtimaiyyeyi iktiza eder. Evet inkâr edemezsin ki: Sen bir adamla beraber bir taburda bulunmakla, o adama karşı dostane bir râbıta anlarsın; ve bir kumandanın emri altında beraber bulunduğunuzdan arkadaşane bir alâka telâkki edersin. M.)
rabita-î îman: îman bağı, insanları hususan iman edenleri birbirine bağlayan iman.
rabita-î mevt: ölümünü düşünüp dünyanın fani olduğunu mülâhaza edip nefsin desiselerinden kurtulmak.
rabita-î şeyh: Tarikat-ı Nakşiyede, müridin hayalen şeyhinin huzurunda kendini tasavvur etmesine denir.
rabitabend: Rabtedici, bağlayıcı.
rabiz: Koyun ağılı.
rabî': Dördüncü.
rabî-î aşer: Ondördüncü.
rabîa: (Müe.) Dördüncü. * Saatteki sâlisenin altmışta biri.
rabîa-î adevîye: (Hi: 95 - 185) Basra'lı bir hatun. Bütün hayatını dine hizmet için vakfetmiş, zengin kimseler evlenmek teklifinde bulundukları halde; "Allah'ı anmaktan, dine hizmetten beni alıkor" fikri ile reddetmiş, fakirliği ve istiğnayı kabul edip dine hizmetten vaz geçmemiştir. Talebe okutmuş meşhur bir veliyedir. (R. Aleyha) 
rabîan: Dördüncü olarak.
rabîb: Yoğurt.
rabîh(a): (Ribh. den) Kârlı, kazançlı, faydalı.
rabît: Bağlı, bağlanmış, merbut.
rabîye: (C.: Revâbi) Yüce, yüksek yer.
rabt: Bağlamak, bitiştirmek, bir şeye bağlamak. * Nizam vermek, intizam bulmak. * Gr: Cümleleri lüzumlu edatlarla birbirine bağlamak. 
rabt edati: Gr: Bağlama edatı. Kelimeyi veya cümleyi birbirine bağlayan harf veya kelime. (Hem, ve... gibi)
rabt-i kalb: Kalb bağlama, gönül bağlama.
rabtîyye: Rabtiye. * Bağlayacak şey.
ra'c: şimşeklerin birbiri ardınca şakımaları.
rac: Mide.
racî: Rica eden, eden, uman, yalvaran. Niyaz eden. ümitli.
racî': (Rücu. dan) Geri dönen, ric'at eden. * Dair, aid, alâkası olan, dokunur olan, müteallik. * Gr: Bir şahıstan kinaye olan zamir.
racîbe: (C.: Revâcib) Parmağın el ayasına bitişik olan boğumu.
racîfe: şiddetle sarsan sarsıntı. Dünyayı yerinden oynatan vakıa. îlk nefha.
racîh: üstün olan. Kıymetli, faziletli ve itibarı fazla olan. * Fık: Beyyinatta, bürhan ve delilin tercihinde delili üstün, beyyinesi evlâ ve makbul olan taraf.
racîh-î mercuh: Bürhan ve delillerin tercih ve üstünlük esasları.
racîha: Tercihli, daha önce diğerlerinden üstün.
racîl: Yaya olarak, yürüyerek.
racîlen: Yaya. Piyade. * Mc: Cahil, bilgisiz. 
racîn: Adama alışmış davar.
racîyane: Rica ederek, yalvararak.
ra'd: Gök gürültüsü. * Bulutları sevk ve nezaret ile vazifeli bir melek adı. * Tehdit etmek, korkutmak.(Terennümat-ı hava, na'rât-ı ra'diye, nağamat-ı emvac, birer zikr-i azamet. Yağmurun hezecatı, kuşların seceatı birer tesbih-i rahmet, hakikata bir mecaz... Lemeat'tan)
rad: Cömert, eli açık, faziletli, üstün, değerli.
rad': Men'etmek, engel olmak. * Bırakmak, terk etmek. * Güzellik eseri. * Kına.
ra'd suresî: Kur'an-ı Kerim'in 13. Suresi.
ra'd u berk: Gök gürültüsü ve şimşek.
ra'd-i kasif: Korkunç gök gürültüsü.
ra'd-i kaza: Kaza yıldırımı, kaza şimşeği.
radaf: üzerine ateş yakıp kızdırdıkları taş.
radafe: (C.: Razf) Kızdırılmış sıcak taş (süte bırakıp sıcaklık verirler.)
radd: Süt ile pişmiş hurma. * Vurmak, dövmek. 
râdd: (Redd. den) Geri döndüren, reddeden, geri bırakan.
râdd-üs selâm: Başkasının verdiği selamı alan.
radde: Derece. Rütbe. Sıra. Kerte. Mertebe. * Aşağı yukarı. * Fayda, menfaat. * çizgi, hat.
ra'de: Muztarib oluş, azablı ve sıkıntılı hâl. (Rı'de şeklinde de okunur) 
rade: Faide, menfaat.
ra'dendaz: (Ra'd-endaz) Gürleyen, gürleyici. Gök gürültüsü gibi gürleyen.
radga: (C.: Radg-Ridag) Sulu ve sıvı balçık.
radh: Az bir şey verme. Az verilen şey. * Fık: Cihada iştirak eden kadınlara, kölelere, çocuklara ve zimmilere ganimet malından verilen mal.
radhe: (C.: Radh-Ridh) Taşlı yer, taşlık arazi. * Büyük taşlardan olan çukur yer. (îçinde su birikip kalır.)
radi': (Rıda'. dan) Süt kardeş. * Süt emen çocuk. * Levmedilen kimse.
radiyallahü anh: Allah (C.C.) ondan razı olsun, mealinde duâdır. Aslında Allah ondan razı oldu demektir.(Sahabe-i Kiram Hazeratına Radıyallahu Anh denildiğine binaen, başkalara da bu mânada söylemek muvâfık mıdır?Elcevab: Evet denilir. çünki Resul-i Ekrem'in bir şiarı olan Aleyhissalâtü Vesselâm kelâmı gibi Radıyallahu Anh terkibi, Sahabeye mahsus bir şiar değil, belki Sahabe gibi veraset-i nübüvvet denilen velâyet-i kübrada bulunan ve makam-ı rızaya yetişen Eimme-i Erbaa, şâh-ı Geylani, îmam-ı Rabbani, îmam-ı Gazali gibi zatlara denilmeli. Fakat örf-ü ulemâda sahabeye, Radıyallahu Anh; Tâbiin ve Tebe-i Tâbiine, Rahimehullah; onlardan sonrakilere, Gaferehullah; ve Evliyaya, Kuddise Sırruhu denilir. M.)
radiyallahü anha: (Kadın için) Allah ondan razı olsun.
radiyallahü anhüm: Allah onlardan razı olsun.
radiyallahü anhüma: Allah onların ikisinden razı olsun.
radî: (Râdiye) Razı olan, rıza gösteren, itaat eden.
radî': (C.: Ruzâa-Ruzâ) Süt emen çocuk.
radîb: Zayıf yağan yağmur. * Sidre ağacından bir cins.
ra'dîd: Korkak.
radîf: Binicinin ardına binen kişi.
radîf: Kızmış taşla ısıtılan süt. * Kızmış taş üzerine pişirilen et. (Merzuf da derler.)
radîfe: Kıyametteki ikinci Sur'un ismi. (O'nunla bütün ölüler hayat bulurlar.)
radîg: Ahmak, akılsız kimse.
ra'dîn: Gürleyen. * Gürültülü.
radîn: Za'feran çiçeği.
radîyen: Razı olarak, beğenilerek, hoşnud olmak suretiyle.
radk: Her nesnenin evveli. 
radm: Büyük set.
radm: Binayı taşla yapmak ( O binaya "razim" derler.)
radme (radmâ): Büyük taş.
radua: Kuzusunu emziren ve hem de sağılır olan koyun.
radyasyon: (Fr. Radiation) Bir enerjinin ışık demeti halinde yayılması.
rafiz: Terk eden. Salıveren. Bırakan.
rafiza: şii fırkalarından bir tâife. Hak mezhepten ayrılmış, namazsız, itikadı bozuk kimse. * Asker kaçağı güruhu. * Düstur, akide ve nizam kabul edilen esaslardan ayrılanlar. 
rafizî: (Râfiziyye) Rafıza fırkasından olan. Hazret-i Ebu Bekir'in ve Hazret-i ömer'in (R.A.) halifeliklerini kabul etmeyenlerden olan.
rafizîyyun: (Rafızi. C.) Rafıziler.
rafî': Yükseltici. Hâmil. Sâhib. Kaldırıcı, kaldıran. * Esma-i îlâhiyedendir.
rafî-üd derecat: Dereceleri yükselten. Allah. (C.C.)
rafîa: Yükselten. * Kaldırmak için destek.
rafîdan: Dicle ve Fırat ırmakları.
rafîde: Binanın direği.
rafîh: Rahat içinde ve refahla yaşıyan.
rafît: Nikâh. Cima. Fuhşiyyat.
rafz: Bırakma. * Rafızilik.
rag: çimenlik, çayırlık, bahçelik, bağlık. * Dağ eteği.
ragabat: Rağbetler, istekler, istekle karşılamalar.
ragad: Refah, genişlik, kolaylık. * Geçim kolaylığı.
ragame: (C.: Rugâm) Toprak.
ragba': Rağbet etmek.
rağbet: (Ragbet) îstek, arzu. îyi sayılmak. Bir şeyi çok iştiyakla istemek. îhlasla dua etmek, teveccüh etmek.
rağbet-î umumîye: Umum tarafından rağbet edilip beğenilme. Herkes tarafından istenme.
rağbeten: Rağbet ederek, istekle.
ragd: Maişet genişliği, geçim bolluğu.
ragib: (Râgıbe) (Ragbet. den) îsteyen, rağbet eden.
ragim: Galebe eden, galip olan.
ragiye: Dişi deve.
ragîb: îçi geniş olan nesne.
ragîbe: Rağbet olunan veya rağbetle istenilen şey. * îhsan, hediye.
ragîd: Süt bulamacı.
ragîf: Pide. Yufka.
ragîfe: Sütlü bulamaç.
rağm: (Ragm) Bir şeyden hoşlanmayıp kerih görmek. Bir işi birisine zor ile tutturmak. Züll ve hakaret. Kahretmek.
rağmen: Aksine olarak, inadına, zıddına olarak, zoraki.
rağmen alâ-enfîhî: Tahkir maksadıyla, birinin kibrini, burnunu kırmak için.
rağmen lî-enfîhî: (ve alâ rağmihi) Zoraki ve mahsus tahkir ve tezlil için olan hareket.
ragmîyyat: Aksine, rağmına, inadına, zıddına yapılan işler.
ragn: Meyletmek, yönelmek, eğilmek.
rags: Nimet. Lütf-u îlâhi. Bereket. Hayır. * çoğalmak ve uzamak.
ragsa': îçinden sütün aktığı meme içindeki damar.
rah: Zan, sanma. Kaygı, keder.
rah: (Reh) Yol. Tarz. Usûl. Meslek.
rah: (C.: Rayâh) şarap, içki, hamr. * El ayası mânâsına olan "Râha'nın C." * Gitmek.
rah-i hak: Hak yolu.
rah-i necat: Kurtuluş yolu.
rah-i rast: Doğru yol.
rah-i vatan: Vatan yolu.
rah-nüma: Yol gösteren, kılavuz. (Bak: Rehnüma)
rah-var: Sarsmadan yürüyen at, rahvan at. * Atın sarsmadan yürüyüşü.
raha: Değirmen.
rahabe: Genişlik, vüs'at.
rahah: Davanın tırnağının geniş ve büyük olması.
rahal: (C.: Rihâl) Semer. Palan.
rahamet: Rahim hastalığı.
rahasa: Yumuşaklık.
rahat: üzüntüsüz, tasasız, kedersiz bir halde olmak. îstediği her şeyi bulup telâşsız olmak. Müsterih. * Dinlenmek. * El ayası.
rahat-efza: Rahat arttıran.
rahat-i dîl: Gönül rahatı.
rahat-nîşîn: Rahat eden, rahat oturan.
rahcen: Ağırlık, sıklet. * Meyletmek, eğilmek, yönelmek.
rahdan: Yol bilen.
rahe: Avuç içi, el ayası.
rahf(e): Kaymak. * Elde durmaz derecede sıvı olan hamur.
rahî: Yola ait, yolla alâkalı, yola dâir.
rahî: Rahat yürüyüşlü binek. * Sâkin, rahat.
rahîb: âbid. Allah'tan (C.C.) korkan. * Manastırda oturan nasrani âlimi veya papazı. Keşiş. * Aslan.
rahîb: Kendisinden korkulan şey. Korkulu.
rahîb: Bol, geniş. * Obur, çok yiyen kişi.
rahîb-ür râhe: Cömert, eli geniş.
rahîban: (Râhib. C.) Râhibler. Keşişler.
rahîbe: Kadın rahib.
rahîh: Yumuşak, sulu balçık.
rahîk: Safi şarap, Cennet şarabı.
rahîl: Göç eden, göçen, ölen, rıhlet eden.
rahîl: (C.: Ruhal-Rihâl) Dişi olan koyun kuzusu. (Erkeğine "hamel" derler.)
rahîl: Göç. Göçme, hicret etme.
rahîle: Yük hayvanı. * Yük getiren deve. * Topluluk, kafile. * üzerine binilen deve.
rahîlezen: Yük hayvanını süren.
rahîm: (Rahmet. den) Rahmet edici, merhamet eyleyen. Rahmedici. Muhafaza eden, bağışlayan. Rahmet ve merhamet sahibi, şefkat eden, gufran sahibi. (Kur'an-ı Kerim'de bu isim 220 defa zikredilir.)
rahîm: (Rahm. dan) Rahmet edici, acıyan, merhamet eden.
rahîm: (Rehm) Döl yatağı. çocuğun, içinde yetiştiği ve dişi canlılara mahsus organ. * Karabet, akrabalık.
rahîmallah: Allah rahmet eylesin.
rahîmane: şefkat ederek, acıyarak. Merhamet ve rahmet ile Cenab-ı Hakk'a yakışır tarzda.
rahîm(e): Hafif sesli, lâtif sözlü kız. 
rahîme: Rahmet eylesin.
rahîmehullah: "Allah ona merhamet eylesin, Allah rahmet eylesin" meâlinde duâdır.
rahîmehumallah: "Onların ikisine de Allah rahmet eylesin" meâlinde duâdır.
rahîmehumullah: "Allah onlara rahmet eyleye" meâlinde duadır.
rahîmîn: (Rahimûn) Merhametliler, acıyıp esirgeyenler, rahmet edenler, şefkat edenler.
rahîmîyyet: (Bk: Rahmaniyet)
rahîn: Rehin veren, malını rehine koyan. *Sâbit, dâim, devamlı. * Devenin ve adamın zayıfı.
rahîs: Ucuz, yumuşak elbise. * Ansızın ölüm.
rahîye: (C.: Revâhi) Bal arısı.
rahîyye: Yolluk. Yol masrafları.
rahk: Sarmak, istilâ etmek. 
rahl: (C.: Rihâl) Semer, palan. * Yağmurluk ve saire gibi yol levâzımı.
rahl (rihl): Göçmek, irtihal etmek.
rahlâ': Arkası beyaz, diğer yerleri siyah olan dişi koyun. * Yalnız arkası kara olan deve.
rahle: Küçük masa.
rahle-î tedrîs: üzerine ders verilen veya alınan rahle. * Bir âlimden alınan ders.
rahm: Acıma, koruma, esirgeme, şefkat etmek. * Hısımlık, karabet, akrabalık.
rahm ü şefkat : Merhamet ve şefkat etmek.
rahma': Başı beyaz olan dişi koyun.
rahman: Bütün yaratıklara rızıklarını veren, her an bütün mahlukat hakkında hayır ve rahmet irade buyuran, bütün mahlukatına sayısız nimetler veren. Nizam ve adâlet sâhibi. (Allah)
rahman suresî: (Errahman Suresi de denir.) Kur'an-ı Kerim'in 55. suresidir. Bu sureye Arus-ül Kur'an da denilmiştir. Mekkidir.
rahmanî: Rahman'a ait ve müteallik. Allah'tan gelen, her hususta hayırlı olan.
rahmanîyyet: Cenab-ı Hakk'ın Rahman oluşu.(Yâni: Gözümüzle görüyoruz, birisi var ki, bize zemin yüzünü rahmetin binlerle hediyeleri ile doldurmuş, bir ziyafetgâh yapmış ve Rahmâniyetin yüz binlerle ayrı ayrı lezzetli taamları içinde dizilmiş bir sofra etmiş ve zemin içini rahimiyyet ve hakimiyetin binlerle kıymettar ihsanlarını câmi' bir mahzen yapmış. Ve zemini devr-i senevisinde bir ticaret gemisi hükmünde her sene âlem-i gaybdan levâzımat-ı insaniyye ve hayatiyyenin yüz bin çeşitlerinden en güzellerini içine alarak yüklenmiş bir nevi sefine veya şimendifer gibi; ve her baharı ise, erzak ve elbisemizi taşıyan bir vagon hükmünde olarak bizlere gönderir. Bizi gayet rahimane beslettirir. Ve bütün o hediyelerden, o nimetlerden istifade etmemiz için bize de yüzlerle ve binlerle iştihalar, ihtiyaçlar, duygular, hissiyatlar, hisler vermiş...Evet, bize öyle bir mide vermiş ki, hadsiz taamlardan lezzet alır. Ve öyle bir hayat ihsan etmiş ki, duyguları ile bir sofra-i nimet gibi koca cismâni âlemde hadsiz nimetlerinden istifade eder. Ve öyle bir insaniyet bize lutfetmiş ki, akıl ve kalb gibi çok âletleri ile hem maddi hem mânevi âlemin nihâyetsiz hediyelerinden zevk alır. Ve öyle bir îslâmiyet bize bildirmiş ki; âlem-i gayb ve âlem-i şehâdetin nihâyetsiz hazinelerinden nur alır. Ve öyle bir iman hidayet etmiş ki, dünyâ ve âhiret âlemlerinin hasra gelmez envarından ve hediyelerinden tenevvür edip müstefid eder. Güyâ Rahmet tarafından bu kâinat hadsiz antika ve acib ve kıymetli şeylerle tezyin edilmiş bir saraydır. Ve bütün o saraydaki hadsiz sandıkları ve menzilleri açacak olan anahtarlar insanın ellerine verilmiş ve bütün onlardan istifade ettirecek olan ihtiyaçlar, hissiyatlar insanın fıtratına verilmiş.îşte böyle dünyayı ve âhireti ve her şeyi kaplamış bir rahmet, elbette o rahmet, Vahidiyyet içinde bir Ehadiyyetin cilvesidir.Yani nasıl ki güneşin ziyası, mukabilindeki umum eşyayı ihâta etmesi ile Vahidiyyete bir misâl olduğu gibi, parlak ve şeffaf her bir şey dahi kabiliyetine göre güneşin hem ziyasını, hem hararetini hem ziyasındaki yedi rengini, hem aks-i misâlini almakla Ehadiyete bir misâl olduğundan elbette o ihâtalı ziyayı gören adam, arzın güneşi vâhiddir, bir tektir diye hükmeder. Ve her parlak şeyde hatta katrelerde güneşin ışıklı, harâretli aksini müşâhede eden o adam, güneşin ehadiyyetini, yâni; bizzat güneşi sıfatları ile "her şeyin yanındadır ve her şeyin âyine-i kalbindedir" diyebilir.Aynen öyle de: Rahmân-ı Zülcemâlin geniş rahmeti dahi ziya gibi umum eşyayı ihatası o Rahmânın Vahidiyetini ve hiç bir cihette şeriki bulunmadığını gösterdiği gibi, her şeyde hususan her bir zihayatta ve bilhassa insanda o cemiyetli Rahmetin perdesi altında o Rahmânın ekser isimlerinin ışıkları ve birnevi cilve-i zâtiyyesi bulunarak, her ferdde bütün kâinata baktıracak ve münâsebettarlık verecek bir cem'iyyet-i hayatiye vermesi dahi, O Rahmânın ehadiyyetini ve herşeyin yanında hâzır ve herşeyin her şeyini yapan (O) olduğunu isbat eder.Evet nasıl ki, O Rahmân, o rahmetin vahidiyyetiyle ve ihatası ile kâinatın mecmuunda ve zeminin yüzünde celâlinin haşmetini gösteriyor. öyle de ehadiyyetin cilvesi ile her bir zihayatta, hususan insanda bütün nimetlerin nümunelerini o ferdde toplayıp o zihayatın âlât ve cihâzâtına geçirip tanzim ederek mecmu-u kâinatı (parçalanmadan) o tek ferde bir cihette aynı hanesi gibi verdirmesi ile dahi cemâlinin hususi şefkatini ilân eder ve insanda enva-ı ihsanatının temerküzünü bildirir.Hem nasıl ki, bir kavunun (meselâ) her bir çekirdeğinde o kavun temerküz ediyor. Ve o çekirdeği yapan zat, elbette odur ki, o kavunu yapar. Sonra ilminin hususi mizanı ile ve hikmetinin ona mahsus kanunu ile o çekirdeği ondan sağar, toplar, tecessüm ettirir ve o tek kavunun tek ve vâhid ustasından başka hiç bir şey o çekirdeği yapamaz. Ve yapması muhaldir. Aynen öyle de: Rahmaniyyetin tecellisi ile kâinat bir ağaç, bir bostan; ve zemin bir meyve, bir kavun; ve zihayat ve insan bir çekirdek hükmünde olduğundan elbette en küçük bir zihayatın Hâlikı ve Rabbi bütün zeminin ve kâinatın Hâlikı olmak lâzım gelir.Elhâsıl: Nasıl ki, ihâtalı olan Fettahiyet hakikatı ile bütün mevcudatın muntazam suretlerini basit maddeden yapmak ve açmak, vahdeti bedahetle isbat eder. öyle de, her şeyi ihata eden Rahmaniyyet hakikatı dahi vücuda gelen ve dünya hayatına giren bütün zihayatları ve bilhassa yeni gelenleri kemâl-i intizamla beslemesi ve levazımatını yetiştirmesi ve hiç birini unutmaması ve aynı rahmet her yerde, her anda ve her ferde yetişmesi ile bedahetle hem vahdeti, hem vahdet içinde ehadiyyeti gösterir. ş.)
rahme: (C.: Ruham) Kartal. * Rahmet, muhabbet.
rahmet: Merhamet, acımak, şefkat etmek, ihsan etmek, esirgemek. * Mc: Yağmur.(...Sâni-i âlem'in her şeyi içine almış ve her şeyi istilâ ve istiab etmiş bir rahmet -i vâsiası vardır. Vâlidelerin, hattâ bir cihette nebatatın evlâdına olan şefkatleri ve küçük, zayıf yavrularının sühulet-i rızkları, o rahmet deryasından bir katredir. M.N.)
rahmet-î bîpayan: Sonsuz rahmet.
rahmeten-lî-l-âlemîn : Bütün âlemlere rahmet olan Hz. Muhammed Aleyhissalâtü Vesselâm.
rahmetullâhî-aleyh: "Allah'ın (C.C.) rahmeti onun üzerine olsun" meâlinde vefat etmiş müslümanlar için söylenen duâ.
rahmî: Rahmete mensub, rahmetle alâkalı, rahmete müteallik.
rahmut: Mübalağa ile esirgemeklik.
rahname: Yol ve yön gösteren kâğıt. Harita.
rahne: Gedik, yarık. Gemilerin bordalarında veya su kesimlerinin altında mermi isabetiyle veya herhangi bir te'sirle açılan delikler, yarıklar. * Yara. * Bozukluk. Zarar.
rahnedâr: Eksiği, bozuğu olan. * Zarara uğramış. * Yıkığı olan.
rahrev: Yolcu.
rahs: Yıkamak. * Yumuşak.
rahş: Gösterişli, güzel at. * Rüstem adlı bir pehlivanın atı.
rahşa: (Rahşân) Parlak.
rahşende: Parıldıyan, parıldayıcı.
rahşîş: Parlayış.
raht: (C.: Ruhut) Binek atlarına vurulan eyer, takım. * Pencere ve kapıların menteşe takımı. * Yol levazımı. * Döşeme ve ev takımı.
raht-i arus: Gelin eşyası.
raht-i hümayun: Padişahın mücevherli eyer takımı.
rahtlamak: Ata raht ve takım takmak.
rahum: Doğurduktan sonra rahminde hastalık meydana gelen deve.
rahv: Gevşek, sölpük, rahâvetli.
rahve: (Bak: Rihve)
rahyan: Kaburganın omuz kemiği ile bitişmesi.
rahye: Düz meydan.
rahz: Yıkamak.
rahzen: Yol vuran. Yol kesen. Eşkiyâ, haydut.
rahzenî: Haydutluk, eşkiyâlık. Yol kesicilik.
raî: (Rü'yet. den) Görücü, gören. * Gr: R harfiyle alâkalı. R harfine mensub.
raî: çoban. * Gözetleyici ve koruyan kimse. * Vâli. * Güvercin kuşundan bir kısım.
raîb: Korkmuş. * Semizliğinden yağı damlar olan. * Dolu.
raîb: Göz bağlayıcı, büyücü. * Doldurucu.
raîc: Revaçta olan, sürümü olan. Rağbet bulan.
raîc-î mal: Malın değeri.
raîc-î vakt: Bir şeyin şimdiki değeri. 
raîd: Gürleyen, gürüldeyen.
raîd: Konaklanacak yeri görmek için önceden gönderilen kimse. * El değirmeni.
raîde: (C.: Revâid) Gürleyen bulut. * Sözü çok olan kişi.
raîf: Merhametli, re'fetli.
raîf: önde giden at. ("pişnek" derler) * Burun ucu. * Dağ burnu.
raîk(a): Hâlis, sâfi, sâde, katışıksız.
raîn: Muhkem, sağlam yapılı, berk yer.
raîş: Huk: Rüşvet veren kimse ile rüşvet alan arasında vasıtalık eden kimse.
raîyane: çobanca. çobanlığa ait.
raîyye: (C.: Raâyâ) Saklı, mahfuz.
raîyyet: Bir hükümdar idaresinde olanlar, birinin idaresine bağlı olanlar. Devletin idâresindeki umum insanlar. * Sürü. Otlatılan hayvan sürüsü.
raîyyet-perver: Halka iyi bakan, iyi idare eden. însanların ihtiyacını te'min eden, onların iyiliğini seven ve onlar için iyilik isteyen.
raîz: (Râyiz) öfkeli, kızgın.
rak: Erkek yengeç.
rak': Eğilmek.
rak': Kaftana yama vurmak. Elbiseyi yamamak.
rakaat: Hamâkat, ahmaklık.
rakabat: (Rakabe. C.) Boyunlar. Ense kökleri. * Köleler, câriyeler. Kullar.
rakabe: Ense kökü, boyun. * Kul, köle, câriye.
rakadan: Oynayıp sıçrama.
rakaha: Ticaret. * Kesb, kazanma.
rakak: üstü yumuşak, altı sert olan düz yer.
rakam: Bütün satıcı, bütün satan.
rakam: Yazı ile işaret, sayıları gösteren işaret. * Yazı yazmak.
rakamî: Rakam ve sayıya ait. Rakamla alâkalı.
rakamkeş: Rakam atan. Yazan çizen.
rakamzede: Yazılan, söylenen. Yazılmış.
rakamzen: Yazıcı, yazan. Kayıt ve işâret eden.
rakan: (Rakun) Za'feran çiçeği. * Kına.
rakb: Muntezir olmak, beklemek.
rakd: Uyumak üzere bulunma. Uykuya dalar gibi olma.
rakde: Uyku. Berzah.
rakib: Gözeten, bekleyen.
rakide: Mertek adı verilen uzun ince ağaç.
rakim: Bir yerin deniz seviyesinden yükseklik derecesi. Kod. * Rakam yazan. çizen. Tahrir eden, yazan.
rakim: Belâ, musibet. Zahmet. Dâhiye.
rakî': Rüku' eden. Huzur-u îlâhide eğilen.
rakî': Ahmak kimse. * Gökyüzü.
rakîan: Rüku' ederek, huzur-u îlâhide eğilerek. Rüku' etmek suretiyle.
rakîane: Rüku' eder gibi. Eğilerek.
rakîb: (Rekabet. den) Daima görüp kontrol eden, gözeten. * Bekçi. * Herhangi bir işte birbirinden üstün olmaya çalışanlardan her biri. Rekabet edenlerin beheri. * Esma-i Hüsna'dandır.
rakîb: Binen. Binici. * Herhangi bir nakil vasıtasına binmiş olan.
rakîban: (Rakib. C.) Rakibler. Birbirleriyle yarışanlar. * Bekçiler.
rakîben: Binmiş olarak, binerek.
rakîd(e): Hareketsiz, durgun.
rakîk ü nîzâr: înce ve zayıf.
rakîk-ül kalb: Yufka kalbli, çok merhametli, ince duygulu.
rakîk(a): (Rikkat. den) Yufka yürekli, ince merhamet ve şefkat sahibi olan. * Köle, câriye.
rakîm: Yazılmış nesne. Yazı yazılacak levha. * Ashab-ı Kehf'in mağarasının bulunduğu dağ; veya bazılarınca mağaranın bulunduğu dere; veya Ashab-ı Kehf'in başka bir ismi. * Ashab-ı Kehf'in isim ve kıssalarının yazılı bulunduğu kitabe.
rakîme: Yazılmış kâğıt. Mektub.
rakîs: Yol gösteren, kılavuz. * Harman yerinde harmanı döğerken öküzün dönmesi.
rakk: Kitap, sahife. * Kâğıt yerine kullanılan ince deri parçası. * Tomar. * Yama.
rakka: Dere yanında olup sel geldiğinde üzerine yayılan arazi. * Bir yerin adı.
rakkas: Oynayan, dans eden, köçek.
rakkasâne: Oynar şekilde. Raksederek.
rakkase: Oynayıp dans eden kadın.
rakle: (C.: Rikal) At sürüsü. * Uzun hurma ağacı.
rakm: Yazmak. * Mühür yapmak.
rakme: Derenin kenarı. * Bahçe.
rakmîyyat: Medine yakınında bir yere nisbet edilen oklar.
rakrak: şuleli ve ziyâlı, parlak, nurlu.
rakraka: Su dökmek. * Su gelip gitmek. * Parlamak. * Suyun akması.
rakraka: Nâzik ve derisi yumuşak olan kadın.
rakrakan: Serap.
raks: Sıçrayarak oynamak, dansetmek.
raks-i mükerrer: Tekrar tekrar yapılan raks. Döne döne oynama.
raksân: Rakseden, dans eden, oynayan.
rakskünân: Raksederek, raksede ede, oynıyarak, oynıya oynıya.
rakş: Nakşetme, süsleme.
rakşa': (C.: Rukaşâ) Alaca yılan. * Süslü kadın.
rakud: (C.: Revâkıd) Derinliği fazla olan küp.
raky: Yükselmek, terakki etmek.
ra'l: Koyunun kulağından kesilen parça.
ral: (C.: Rilâl-Ri'lân-Er'ül- Reele) Deve kuşunun yavrusu.
ra'la': (C.: Rual) Akılsız kadın. * Kulağının ucu kesilip ilişik duran dişi koyun.
ra'le: (C.: Riâl-Erâl-Erâil) At sürüsü. * Hurma ağacının uzunu.
ram: îtaat eden, boyun eğen, itaatli, münkad.
ramad: Kül, ateş külü.
ramak: Nefes alacak kadar kalan hava, az bir hayat eseri. * çok az şey.
ramas: Göz çapağı.
ramaz: Güneşin sıcaklığı şiddetle ve yakarak gelmek, şiddetli olmak, yakmak. * Kesinleştirmek.
ramazan: Mübarek ayların en mühimmi ve mübarek üç ayların sonuncusu. Kur'an-ı Kerim'in nâzil olmağa başladığı oruç ayı. Arabi ve Kameri olan takvime göre 9. ay. Oruç tutanın günahlarını yaktığı, mahveylediği için bu isim verildiği rivayet edilir.(Ramazan-ı şerif'te mü'minler, derecatına göre ayrı ayrı nurlara, feyizlere, mânevi sürurlara mazhar oluyorlar. Kalb ve ruh, akıl, sır gibi letâifin o mübârek ayda oruç vasıtasiyle çok terakkiyat ve tefeyyüzleri vardır. Midenin ağlamasına rağmen onlar masumâne gülüyorlar. M.)(îşte Ramazan-ı şerif, âdeta bir âhiret ticareti için gayet kârlı bir meşher, bir pazardır. Ve uhrevi hasılat için gâyet münbit bir zemindir. Ve neşv ü nema-i a'mâl için, bahardaki mah-i nisandır. Saltanat-ı Rububiyet-i îlâhiyeye karşı ubudiyet-i beşeriyenin resm-i geçit yapmasına en parlak, kudsi bir bayram hükmündedir. Ve öyle olduğundan yemek, içmek gibi nefsin gafletle hayvani hâcatına ve mâlâyani ve hevâperestane müştehiyata girmemek için oruçla mükellef olmuş. Güya muvakkaten hayvaniyetten çıkıp melekiyet vaziyetine veyahut âhiret ticaretine girdiği için, dünyevi hâcâtını muvakkaten bırakmakla uhrevi bir adam ve tecessüden tezahür etmiş bir ruh vaziyetine girerek, savmı ile Samediyete bir nevi âyinedarlık etmektir. Evet, Ramazan-ı şerif; bu fani dünyada, fani ömür içinde ve kısa bir hayatta bâki bir ömür ve uzun bir hayat-ı bakiyeyi tazammun eder, kazandırır.Evet bir tek Ramazan, seksen sene bir ömür semeratını kazandırabilir. Leyle-i Kadir ise nass-ı Kur'ân ile bin aydan daha hayırlı olduğu, bu sırra bir hüccet-i katıadır. M.)
ramazanîye: Ramazana ait. Ramazan hakkında. * Ramazan ayına dair medhiye veya kaside.
rametmek: Boyun eğdirmek, itaate getirmek.
ramî: çok itaatkâr olan.
ramî: (Remy. den) Ok, mermi v.b. şeyler atan atıcı.
ramîh: Süngü batıran, mızrak saplayan.
ramîk: Miskle karıştırılan siyah bir madde.
ramîle: Yelmek. * şam vilâyetine bağlı bir yerin adı.
ramîs: Toprağı her yöne sürüp savuran rüzgâr.
ramîşe: îyilik, gökçelik, hasene.
ramîşger: çalgıcı. Saz çalan.
ramk: Nazar etmek, bakmak.
rampa: Fr. îki geminin birbirine veya bir geminin iskeleye yanaşıp bitişmesi. * şose veya demiryolundaki yokuş. * Trenin eşya almağa mahsus yanaştığı set.
rampaci: Eski deniz muharebelerinde yakından dövüşerek zabtedilmek istenilen bir düşman gemisine hücumla borda bordaya gelindiği sırada düşman gemisindeki askerlerin vuku bulacak hücumunu menetmek için güverteye yayılan silâhendazlar.
ramt: Ayıplama.
ramuz: Deniz.
ra'n: (C.: Ruun-Riân) Ahmaklık. * Sarp dağ. * önüne sivrilmiş dağ burnu.
ran: (Reyn. den fiil) Kalb katılaşması, lekelenmek. Kalbin kasavetlenmesi. * Pas, kir. (Bak: Reyn)
ran: Bacağın uyluk kısmı. Uyluk. * Kelimenin sonuna getirilerek. " Süren, sürücü" mânasını ifade eden birleşik kelimeler yapılır. Meselâ: Hükümrân $: Hüküm süren.
ra'na: îyi, güzel, hoş, lâtif. Pür ve revnak olan.
ranec: Hindistan cevizi.
ranîn: Pantolon. şalvar. Don.
rapor: Fr. Bir tedkik neticesini bildiren yazı.
rapörtaj: (Bak: Röportaj) 
ra'ra': (C. Raâri') Kötü, alçak kimse. * Yaramaz gönüllü. * çok uzun boylu adam. * Güzel itidalde olan kimse.
ra'raa: Suyun şiddetle akması. * Depretmek. (çocuk) büyümek. * Bitirmek.
ra's: Boyanmış renkli yün. * Süt vermek. * Süt içmek.
ra's: Yorulduğunda yab yab yürümek. * Birşeyi silmek.
ras': Yapışmak.
ra'sa': Kulakları küpe gibi uzunca sarkık olan yahut ucunu kesmekten ilişik kalıp sallanıp duran kulakları asılı olan dişi koyun. 
rasaa: (C.: Rusâ) Bal arısının yavrusu.
rasad: Gözetlemek, beklemek, pusuda olmak.
rasadgâh: Bekleme yeri, gözetleme yeri. Gözlemevi.
rasadhâne: Havanın değişen şekillerini, sıcaklık ve soğukluğu tesbit etmek için veya yıldızların hareketlerini tesbit ve takib maksadiyle çalışılan yer.
rasaf: Kaldırım. Kaldırım taşları.
rasafe: (C.: Risâf) Ok üstüne sarılan kiriş.
rasafet: Dayanıklılık, sağlamlık.
ra'san: Yorgunluktan dolayı yab yab yürümek.
rasanet: Sağlamlık, dayanıklık. * Sabit, muhkem, metin.
rasas : Kurşun, kalay, lehim.
rasas-i müzab: Eritilmiş kalay.
rasasî: Kalaycı. * Kurşun renginde olan.
rasd (rusud): Yol gözlemek.
ra'se: (C.: Riâs) Kulağa takılan küpe.
rasf: Oka kiriş sarmak. * Birbirine zammetmek. * Kaldırım döşemek.
rasğ: Bilek, elbileği.
rasid: (C.: Râsıdân) (Rasad. dan) Gözleyen, gözeten, rasad eden. Dikkatle bakan.
rasidân: (Râsıd. C.) Dikkatle bakıp gözliyenler, rasad edenler.
rasî: Kımıldamıyan, sâbit. * Lenger atmış olan gemi. Demirlemiş gemi.
rasî': Hırs ve tama eden.
rasîa: (C.: Rasâyi) Halka.
rasîb (râsîbe): Tortulaşan, dibe çöken.
rasîd: Muntazır, bekleyen kimse. * Avını bekleyen ve yaklaştığında hemen üzerine sıçrayan canavar.
rasîf: Dayanıklı, sağlam, muhkem. * Taş temel, rıhtım. * Denizin yüzüne çıkmış kayalar.
rasîfe: Su içinde yapılan sed. Rıhtım.
rasîh(a): (C.: Râsihin-Râsihûn) (Rüsuh. dan) Temeli kuvvetli, sağlam. * Bilgisi, bilhassa dini bilgileri çok geniş olan. * îyice oturmuş, dem ve damarlarına yerleşmiş, temeli sağlam ve kuvvetli olan.
rasîhâne: Sağlamca, sağlam delil ve bürhana dayanmak suretiyle.
rasîhun: (Rasihin) (Râsih. C.) âlimler, din bilgisi çok sağlam ve derin olan büyük zatlar. * Temeli kuvvetli ve sağlam olanlar.
rasîm: Resim yapan, çizgi çizen. * Akar su.
rasîme: âdet. Eskiden kalma âdet.
rasîn: Sağlam, dayanıklı. * Sabit hüküm.
rasîn: Andız otu.
rasîye: (C.: Revâsi) Büyük dağ.
rasn: îkmal etmek, tamam etmek, muhkem kılmak.
rasras: Sağlam ve sert yer. 
rasrasa: Muhkem etmek, sağlamlaştırmak.
rass: Binayı sağlamlaştırmak. * Birbirine darlık getirmek. * Bazısını bazısına ulaştırmak.
rassad: (Rasad. dan) Rasad eden. Dikkatle gözleyen.
rassas: Kalaycı.
rast u çep: Sağ sol, sağdan soldan.
rastan: (Râst. C.) Doğru olanlar. Haklı kimseler.
rastbîn: Herşeyin hak ve doğrusunu görüp farkeden.
rastgû: (C.: Râstguyân) Doğru konuşan, hak konuşan. 
rastî: Doğruluk, gerçeklik.
rastkâr: Doğru adam.
rasyonalîzm: Fr. Fls: Akliyecilik. Her şeyin yalnız akıl ile bilinebileceğini iddia eden bir felsefi görüş. (Bak: Felsefe)(Nazar-ı nübüvvet ve tevhid ve iman; vahdete, âhirete, uluhiyyete baktığı için hakaiki ona göre görür. Ehl-i felsefe ve hikmetin nazarı; kesrete, esbaba, tabiata bakar, ona göre görür. Nokta-i nazar birbirinden çok uzaktır. Ehl-i felsefenin en büyük bir maksadı ehl-i usul-id din ve ülemâ-i îlm-i Kelâm'ın makasıdı içinde görünmeyecek bir derecede küçük ve ehemmiyetsizdir.îşte onun içindir ki, mevcudatın tafsil-i mâhiyetinde ve ince ahvâllerinde ehl-i hikmet çok ileri gitmişler. Fakat hakiki hikmet olan ulûm-u âliye-i îlâhiye ve uhreviyede o kadar geridirler ki, en basit bir mü'minden daha geridirler. Bu sırrı fehmetmeyenler, muhakkikin-i îslâmiyeyi hükemâlara nisbeten geri zannediyorlar. Halbuki akılları gözlerine inmiş, kesrette boğulmuş olanların ne haddi var ki, veraset-i nübüvvet ile makasıd-ı âliye-i kudsiyeye yetişenlere yetişebilsinler. Hem her bir şey, iki nazar ile bakıldığı vakit iki muhtelif hakikatı gösteriyor. îkisi de hakikat olabilir. Fennin hiç bir hakikat-ı kat'iyyesi Kur'anın hakaik-ı kudsiyyesine ilişemez. Fennin kısa eli onun münezzeh ve muallâ dâmenine erişemez. Nümune olarak bir misâl zikrederiz.Meselâ: Küre-i arz, ehl-i hikmet nazarı ile bakılsa, hakikatı şudur ki: Güneş etrafında mutavassıt bir seyyare gibi hadsiz yıldızlar içinde döner. Yıldızlara nisbeten küçük bir mahluk. Fakat ehl-i Kur'ân nazarı ile bakıldığı vakit hakikatı şöyledir ki; semere-i âlem olan insân, en câmi, en bedi' ve en âciz, en aziz, en zayıf, en lâtif bir mu'cize-i kudret olduğundan beşik ve meskeni olan zemin semaya nisbeten maddeten küçüklüğü ile ve hakareti ile beraber, manen ve san'aten bütün kâinatın kalbi, merkezi; bütün mu'cizat-ı sanatının meşheri, sergisi, bütün tecelliyat-ı esmâsının mazharı, nokta-i mihrakiyesi; nihayetsiz faaliyet Rabbaniyenin mahşeri, ma'kesi; hadsiz hallakıyet-i îlâhiyenin, hususan, nebatat ve hayvânâtın, kesretli enva-ı sagiresinden cevadane icadın medarı, çarşısı ve pek geniş âhiret âlemlerindeki masnuatın küçük mikyasta nümunegâhı ve mensucat-ı ebediyenin sür'atle işleyen tezgâhı ve menazır-ı sermediyenin çabuk değişen taklidgâhı ve besatin-i daimenin tohumcuklarına sür'atle sünbüllenen dar ve muvakkat mezraası ve terbiyegâhı olmuştur.îşte arzın bu azamet-i maneviyesinden ve ehemmiyet-i san'aviyesindendir ki, Kur'an-ı Hakim semâvata nisbeten büyük bir ağacın küçük bir meyvesi hükmünde olan arzı, bütün semavata karşı küçücük kalbi büyük kalıba mukabil tutmak gibi denk tutuyor. Onu bir kefede, bütün semavatı bir kefede koyuyor, mükerreren $ diyor. îşte sair mesaili buna kıyas et. Ve anla ki, felsefenin ruhsuz, sönük hakikatları Kur'anın parlak, ruhlu hakikatları ile müsademe edemez. Nokta-i nazar ayrı ayrı olduğu için ayrı ayrı görünür. S.)(...Acaba akıllarına güvenen akılsız feylesoflar gibi "aklımız bize yeter" deyip sana ittiba'dan istinkâf mı ederler? Halbuki akıl ise, sana ittibaı emreder. çünkü bütün dediğin mâkuldür. Fakat akıl kendi başı ile ona yetişemez...Yahut inkârlarına sebeb, tâgi zâlimler gibi hakka serfüru etmemeleri midir? Halbuki mütecebbir zâlimlerin rüesaları olan fir'avunların, nemrudların âkibetleri mâlumdur... S.) (Bak: îsbatiyecilik)
rasyonel: Fr. Fls: Akla uygun, hesaplı, ölçülü, biçili.
ra'şan: Titreme, titreyiş.
ra'şe-î dest: El titremesi.
ra'şeaver: (Ra'şe-âver) Titretici.
ra'şedar: Titreyen, ürken.
ra'şe(t): Titreme, titreyiş. * Korkmak, havf ve dehşete giriftar olmak.
ra'şever: Titretici.
raşî: Rüşvet veren.
raşîd(e): (Rüşd. den) Hak dinini kabul eden, doğruya giden, rüşde erişmiş olan. * Akıllı.
raşîdîn: Hakka erişmiş olanlar. Kâmil ve çok ileri olgun kimseler. Akıllılar.
raşîh: Yürüyebilen geyik yavrusu.
raşîn: Adı tufeyli olan ve davetsiz olarak ziyafetlere giden kimse.
rat': (Bak: Ret')RATA': Hamakat, ahmaklık.
ratabet: (Ratb. dan) Rutubet, nem, yaş.
ratanet: Arapçanın hâricindeki bir dille konuşma.
ratb: Rutubet, nemlilik yaşlık. * Rutubetli, yaş. * Yaş hurma. * Mülâyim, yumuşak.
ratb-ül lîsân: Yumuşak sözlü. Mülâyim lisanlı.
ratbe: (C: Ritâb) Genç ve güzel sevgili. * Yonca otu.
rath: Yoğurmak. * Yumuşak etmek, yumuşatmak.
ratib: Islak, nemli, çok yaş, rütübetli. Tâze.
ratik: Bir şeyin yarığını bitiştiren, yırtığını kavuşturup birleştiren.
ratik: Bitişik etmek, bitiştirmek, beraber etmek, karıştırmak. * Yırtık bir şeyin parçalarını bitiştirmek.
ratîb: Tertib edip sıraya koyan.
ratîbe: (C.: Revâtib) Maaş. Vazife.
ratîbehâr: Vazifeli. Görevli.
ratîc: çam sakızı.
ratîn: Reçine. çam sakızı.
ratît: Avaz, ses. * Ahmak, akılsız kişi.
ratîyan: (Râtiyâne) çam sakızı, reçine.
ratk: Ulaşmak, yetişmek.
ratl: (Ratıl) Eskiden kullanılan sıvı ölçüsü olup bâzı yerlerde yüzotuz dirhem sayılmıştır. Bâzen oniki kıyyedir. Kıyye kırk dirhemdir. 
ratrat: Bir nevi pelte. * Deve su içtiğinde havuz içinde artıp kalan su.
rats: El ayasıyla vurmak.
rauf: çok acıyan, esirgeyen, merhamet sâhibi. * Esmâ-i îlâhiyedendir.
raufe: Kuyuyu temizleyen kişinin üzerine oturması için kuyunun dibine konan taş. * Davarlarını sulayan veya su içen kimselerin oturması için kuyunun kenarına konan taş.
rauk: Süt süzeği.
raum: Burnundan sümükleri akan zayıf hasta koyun.
raus: îhtiyarlıktan dolayı başını titreten kişi.
rav': ürkmek, korku, halecan. Hareket-i nefsaniye. Havf.
ravh: Rahatlık. Rahmet ve kolaylık. * Serin serin esen rüzgârın vücuda dokunmasiyle verdiği serinlik ve sefa. * Koklamak.
ravhullah: Allah'ın verdiği rahatlık.
ravî: Rivayet eden. însanlara haberleri nakleden. * Hadis nakleden. * Söyleyen, anlatan.
ravî-î hadîs: Hadis rivayet eden.
ravî-î kissa: Bir hâdiseyi hikâye eden. Hikâye anlatan.
ravîyan: (Râvi. C.) Rivayet edenler. Hikâye anlatanlar.
ravîye: Su taşıyan hayvan.
ravuk: Süzek, süzgeç.
ravvah: Rahat ettirmek. (Bak: Ravh)RAVZ: Bahçeler. Ağaçlık ve çimenlik yerler.
ravza: Sulu yer, bahçe, bostan, çimenlik yer.
ravza-î cînân : Cennet bahçeleri. Cennetlere giden yol.
ravza-î mutahhara: Fahr-i Kâinat Aleyhi Efdal-üs-Salavat ve Efdal-üt-tahiyyât Efendimizin Kabr-i şerifiyle Minberin arasındaki saha.
ravza-î ridvân: Cennet.
ravzat: (Ravza. C.) Bahçeler. çimenlik ve ağaçlık yerler.
ra'y: Teslim olma. * Otlatma, gütme. Otlama.
ray: Re'y, fikir, Hüküm ve itikad. (Bak: Re'y)
ray'an: Her nesnenin evveli.
rayat: (Râyet. C.) Bayraklar.
rayb: şek, şüphe, reyb.
rayb-el menun: Zamanın hâdiseleri. * ölüm. * Iztırab veren hâdiseler.
rayet: Bayrak, alem, livâ, sancak. * Gerdanlık.
raygan: Parasız, bedâva. * Pek fazla, pek çok.
rayî': Acib nesne. * Cömert kişi.
rayîc: (Bak: Râic)
rayîha: Koku, hoş koku.
rayîhadar: Kokulu. Hoş kokulu.
rayîhanîsar: Koku saçan.
rayîk: Acib ve hâlis nesne.
rayîş: (Bak: Raiş)
rayîz: Seyis.
raz: Gizli sır, saklı şey. * Mimar. * Marangozların işini tanzim eden.
raz puş: Sır saklayan, sır gizleyen.
raz-aşna: Bir sırrı bilen.
raz-dan: Sırrı bilen, sırra ortak olan dost.
raz-i nîhan: Gizli tutulan sır.
razan: Gizli sırlar, gizlilikler.
razi: Hoşnud, rıza gösteren, kabul eden. * Boyun eğen, itaat eden.
razia: Emzikli, çocuklu kadın.
razik: Rızık veren; yiyecek, içecek, giyecek gibi canlı mahlukata lüzümu bulunan her çeşit ihtiyacını te'min edip veren. (Allah)
razik-i hakîkî: Hakiki rızık veren. Hiç bir vasıtaya ihtiyacı olmadan en güzel nimetleri yaratan ve bütün rızıkları ancak kendisi veren Allah (C.C.)
razîyane: (Rezene) Dere otu nev'inden bir nebat adı.
razîz: Dökülmüş ve parçalanmış.
razraz: îri vücutlu kimse. * Dökülmüş ve ufanmış taş.
razz: Kesmez âlet.
razze: (Razz. dan) Ezen, ezici.
realîst: Fr. Fls: Hakikatçı. Nefs-ül emre uygun düşünen. Realizm taraftarı.
realîte: Fr. Gerçekten olan şey. Olduğunun tıpkısı. Gözümüzle gördüğümüz gibi. (Bak: Rasyonalizm)
realîzm: Umumi fikirleri birer hakikat sayan felsefi görüş. Hadiseleri olduğu gibi anlatma ve gösterme gayesi güden san'at çığırı, fikri.
reaya: (Raiyet. C.) Bir kimsenin emri altında bulunanlar. * Bir hükümdar idaresi altında bulunan halk. * Hristiyan tebaa. * Bütün halk.
re'b: Mantar. * Toplamak, cem'etmek. * Islah etmek, düzeltmek.
reb': Ev, arazi. Barınılan, iskân olunan yer.
reba': Uzunluk.
rebabe: (C.: Ribâb) Bazısı bazısına binmiş olan beyaz bulut.
rebace: Bönlük, ahmaklık, biladet.
rebah: Faide, menfaat. * Kediye benzer bir canavarın adı.
rebaîye: (C.: Rebâıyyât) Seniyye ile nâb arasında olan dört diş.
rebaz: şehrin yarısı ve etrafı. * Her nesnenin eğlenecek ve duracak yeri. * Koyun ağılı. * "Göden bağırsak" denilen büyük bağırsak. 
rebaze: Zeki ve anlayışlı kimse. Zarif kimse.
rebbî: îlmiyle amel eden kişi.
rebeb: Tatlı ve çok su.
re'bele: Cür'et, ikdam.
rebele: (Buğday) çok olmak.
rebez: Ayağı hafif. Hızlı yürüyüşlü.
rebeze: (C.: Rebez-Rebezât) Devenin boyun yünü.
rebî': Yaz günü. * Küçük nehir.
rebî-î evvel: îlkbahar. çiçeklerin açıp otların bittiği mevsim. (Bak: Rebi-ül Evvel)
rebî-î sânî: Sonbahar.
rebî-ül ahîr: (Rebi-i Sâni) Kameri ayların dördüncüsü.
rebî-ül evvel: Arabi ayların üçüncüsü.
rebîb: (C.: Rebâib) üvey oğul. * Evde beslenen koyun. (Müe: Rebibe)
rebîbe: üvey kız. * Dadı.
rebîe: (C.: Rabâyâ) Gözcülük eden kişi.
rebîh: Organları sülpük ve sarkık olan iri insan. 
rebîî: Bahara ait, baharla ilgili.
rebîka: îp ile bağlanan davar.
rebîke: Hurmayı yağla ve keş ile karıştırıp hamur ederek yapılan bir yemek. * öğünmüş keşi, un ve yağ ile karıştırıp yapılan yemek. * Bulamaç aşı.
re'bîl: Câriye, kadın esir.
rebîl: (C.: Rubul) Yoğun, semiz, besili. * Yer kuruyunca biten bir ot. * Uyluğun iç yanı.
rebîle: Semizlik, besililik.
rebîs: Bahadır, kahraman. * Meşakkat.
rebîz: Koyun sürüsü.
rebîz: Semiz ve kuyruğu büyük olan koç.
rebk: Karıştırmak.
rebrak: Tilki üzümü.
rebreb: Yaban sığırı sürüsü.
rebs: Hapsetmek. * Engel olmak, men'etmek.
rebs: El ile vurmak.
rebsa': Müenneslik özelliğindendir. * Katı nesne.
rebt: şişmek. * Terbiye etmek. * Uyusun diye çocuğun yan taraflarına yab yab vurmak.
rebub: üvey oğul. * üvey baba.
rebun: Pey akçesi, pey olarak verilen para.
rebuz: Büyük.
rebvet: (Rubve - Ribve - Rebâvet) Yüce, yüksek yer.
rec': Geri döndürmek. * Döndürülmek. * Yağmur. * Menfaat, fayda. * Rücu' etmek veya ettirmek. 
rec'a: Geri gelme, dönüş. * öldükten sonra tekrar diriliş.
reca: Emel, ümit, yalvarmak. * Cânib, taraf. * îstek, arzu, dilek. 
reca: Kenar, yan. Taraf.
recac: Her şeyin zayıfı.
recah: (C: Rucah) Oturak yeri etli ve büyük olan kimse.
recaî: Ricacı. Ricayla ilgili. Dua ve yalvarmağa, ümide dair.
recale: Yayan yürümek.
recaze: Mahfeden küçüktür ve deve arkasına vurup üzerine binerler.
recc: Deprendirmek. Sarsılmak. Gidip gelmek.
recca': Hörgücü büyük dişi deve.
receb: Azametli, heybetli. Ta'zim etmek. * Cennet'te bir nehir ismi. * Mübarek üç ayların birincisi ve Kameri aylardan yedincisi. * Erkek ismi.
receban: Receb ile şaban ayları.
recefan: şiddetle sarsılma, sallanma. * şiddetle gürüldeme. şiddetli ıztırab, büyük acı.
recefe: Zelzele. * Ortalığı sarsacak kışkırtmalar yapmağa ircaf denir. Yalan, yanlış haberlerle umumi efkârı şaşırtıcı neşriyatlara ise Eracif denmektedir. (Bak: Mürcif)
recel: Saçın ne sarkık ve ne de çok kıvırcık olması. * îstedikçe emsin diye davarı yavrusuyla beraber otlağa salmak.
recen: Hapsetmek.
recez: Vezni altı defa müstef'ilün'den ibaret olan bir nevi şiir veya bahire denir. * Kaside tarzında yazılan manzume. (Bak: Kaside, Ercüze)
recf: şiddetle sarsmak veya sarsılmak.
recfe: (C: Recefât) Zelzele, deprem.
recî': Necis, pislik. Terslemek.
recîf: şiddetli ıztırab.
recîl: çok yürüyen.
recîm: (Recm. den) Taşlanmış, taşa tutulmuş. * Lânetlenmiş, mel'un.
recîn: Devecilerin ini.
recla': Katı, sağlam, sert. * Bir ayağı beyaz olan dişi koyun. (Müz: Ercel)
reclan: (C.: Raclâ-Rıccâl) Yayan kimse.
recm: Taşlamak, taşa tutmak, taş ile insan öldürmek. * Atılan taş. * Kabre taştan nişan dikmek. * şeytan üzerine atılan nücum. * Tardetmek, kovmak, sövmek. Terketmek. * Zan ve kıyas etmek. (L.R.)
recmetmek: Taşlamak, taşlamak suretiyle öldürmek. * Mc: Aleyhte konuşmak.
recrace: Asker kalabalığı. * Ses çokluğu.
recrece: Sarsılma, titreme, sallanma.
recs: (Recse) şiddetli gök gürültüsü. * şiddetli ses.
recsan: Gök gürlemesi sesi.
recül: Yetişkin erkek. Bir işin ehli. Er kişi. Adam.
recüle: Giyiniş ve hareketleriyle kendini erkeklere benzeten kadın.
recület: Erlik, erkeklik.
recülîyet: Erkeklik, erkek olmak. * Cesâretlilik, erişkenlik.
red': Geri verme, reddetme.
red'-î ceyb: Mc: îçinden sıkıntıyı atma.
reda': önleme, men'etme, yasaklama.
reda': (Redaet) Süt emmek.
redaet: Kötülük, fenalık, bayağılık.
redah: (C.: Rudüh) Dolu büyük çanak. * Etli ve şişman kadın.
redane: Tentelerin kenarlarında açılan ufak deliklerin yırtılmaması için o deliklere geçirilen mâdeni halka.
redd: Geri döndürmek, kabul etmemek, çevirmek, def etmek. * Bir şeyin karşılığını icra etmek. * Sözü selâset ve talâkatla eda edemeyip harfleri geri çevirerek konuşmağa sebep olan dilin tutukluğuna denir. * Cerhetmek. * Kötü ve fena şey.
redd-î cevab: Suâlin cevabını vermek.
redd-î hâkîm: Taraf tutan hâkimi kabul etmeyip reddetmek.
redd-î kelâm: Söze itiraz etme, karşılık verme.
redd-î selâm: Selâm verenin selâmını almak.
reddet: Güzellikler arasında nazara çarpan çirkinlik. * Bir defa reddediş.
reddîye: Bir mes'ele hakkında zıt karşılık. Cevap. Beğenilmeyen bir şeye cevap vermek.
rede: Sıra. Bir duvardaki tuğla veya taş sırası.
reden: Hazz denilen kumaş. * Silâhların biribirine dokunmasından çıkan ses. * îplik eğirmek.
redî: (Rediye) Fenâ, kötü, bayağı.
redîf: Arkadan gelen, birisinin ardından giden. * Birbiri ardınca zuhur etmek. * Terhis olup ihtiyata geçen asker. * Edb: Beytin sonunda kafiyeden sonra tekrarlanan kelime.
redîg: Yere vurulmuş. * Nâdan, ahmak.
redîm: Eski, köhne kaftan.
redm: (C.: Rüdum) Bir şeyin önüne sed yapma. * Bir şey dâimi olmak ve akmak. * Pencere, kapı ve delik gibi yerleri tıkama. Tamâmen kapama. * Zülkarneyn seddinin ismi.
redm-î azîm: Zülkarneyn Seddi'nin ismi.
reds: Taş atmak.
redyan: Davar yelmek.
ree: (Bak: Rie) 
reel: Fr. Gerçek, hakiki, sahici.
ref': Kaldırma, yüceltme, yukarı kaldırma. * Lağvetme, hükümsüz bırakma. * Gr: Arapça bir kelimenin sonunu merfu' (ötreli) okumak.
ref'-î cîdal: Kavga ve çekişmeye son verme.
ref'-î îmtîyaz: îmtiyazın, sınıflamanın kalkması. Aynı hakka sahip herkese aynı muâmele yapılması.
refagat: Bolluk içinde geçinme.
refah(et): Bolluk, rahatlık.
refakat: Arkadaşlık, beraberlik.
refd: Atâ etmek, hediye vermek. * Yardım etmek. * Büyük kadeh.
re'fe: Esirgemek, korumak. Acımak. şefkat etmek.
refenn: Kuyruğu uzun olan at.
refes: (Rüfâs) Kinayesi icab eden şeyi açık söylemek. * Kinâye olarak. * Cimâ, nikâh. * Fuhşiyyât.
re'fet: Merhamet, acımak. * Yüce.
re'fetlü: Eskiden kumandanlara, serdarlara mahsus resmi ünvan.
re'fetmeâb: çok merhametli.
refez: Bölük bölük olan cemaat. (C: Erfaz) Kap dibinde kalmış azıcık su.
reff: Elbise koymak için duvara çıkıntı yapmak veya duvara tahta çakmak. Raf.
refh: Yağlanmak.
refhan: (Refâh. dan) Varlık içinde yaşıyan.
refî': Yüksek, bülend, âli, yüce.
refî'-üd derecât: Derece ve itibarı yüksek olan.
refî'-ül kadr: şanı, kadri, değeri yüce olan.
refîf: (Ateş) Parlamak.
refîg: Bolluk ve rahat içinde geçinen adam.
refîh: Rahatlık ve huzur içinde geçinen. Refah ve rahat ile yaşıyan.
refîk-î a'lâ: En iyi, en yüksek refik. Cenab-ı Hak (C.C.)
refîk-î râh: Yol arkadaşı.
refîk(a): Ortak, arkadaş, eş, yardımcı, yoldaş.(Ne mutlu o kocaya ki, kadınının diyanetine bakıp taklid eder, refikasını, hayat-ı ebediyede kaybetmemek için mütedeyyin olur. Bahtiyardır o kadın ki, kocasının diyânetine bakıp, " Ebedi arkadaşımı kaybetmiyeyim" diye takvaya girer. Veyl o erkeğe ki: Saliha kadınını ebedi kaybettirecek olan sefahete girer. L.)
refîl: Kaftanını yukarı kaldırıp sallana sallana yürüyen. * Ahmak kimse. * Kuyruğu uzun at.
refîş: Ağaç kürek. * Dövmek.
refîz: (Rafz. dan) Atılmış, bırakılmış, terkedilmiş. Metruk.
refl: Kaftanını uzun diktirip yürürken eteklerini çekip sallamak.
reform: Fr. Düzeltme, tanzim. Asıl şeklini verme. Islah etme. Avrupa'da başlayan dinde reform hareketini, îslâm dinine tatbik etmenin yeri yoktur. çünkü îslâm dini, bütün zaman ve mekânların insanlarına her cihetle cevap verecek câmiiyette olduğundan ve ilmi esaslara dayanmış olarak asliyetini muhafaza ettiğinden, îslâm dininde reform olamaz. Ancak dinde yeni izah ve isbat şekli vardır. (Bak: Müceddid, Ehl-i bid'a)
refref: Kuşu çok olan çimenlik, kır. * Mânevi bir binek. * Dalları salkım salkım olan ağaç. * Kenar saçağı. * Yeşil elbise. * înce yumuşak kumaş. * Döşek. * Cennet.
refrefe: Kuşun kanatlarını oynatıp açması.
refs: Edeb hârici söz söyleme. * Kadınlara lâf atma.
refs: Ayakla vurmak.
refse: Tokuşmak.
refş: Küçük kazma. * çapa. * Büyük kulaklık. * Kulağı büyük olma.
reft: Gitmek, yürümek. * "Gitti" mânasında fiildir.
reft: Bir şeyi ufalıyarak kırıntı hâline getirme. Bir şeyi ufalama.
reftar: Gidiş, salınarak yürüyüş.
refte: Gitmiş.
refte refte: Git gide, azar azar.
reften: Gitmek.
refuşe: Lâtife, şaka. * Suç, günah.
refv: Sabretmek. * Korkudan emin etmek. * Islah etmek, düzeltmek.
refz: Terketmek.
reg: Damar.
reg-î cân: Can damarı, şah damarı.
regabe: Yumuşak arazi.
regad: Varlık, genişlik.
regaîb: (Ragibe. C.) çok istenilecek şeyler. Hediye, atiyye. çok rağbet olunan şeyler. Bol bol ihsan etmek.
regaîb gecesî: Receb ayının ilk perşembe gününün akşamı (Cuma gecesi).
regamî: çekirge çokluğu.
reh: Yol, kaide, tarz, usul. (Bak: Râh)
reh-averde: Yolcunun getirdiği hediye.
reh-güzer: (Reh-güzâr): Geçilen yol. Yol üstü. Geçit.
reh-î narefte: Gidilmemiş yol.
reha: Kurtuluş, kurtulma. Halâs. * Urfa şehrinin eski ismi. (Bak: Rüha)
reha': Geniş yer.
reha': Geçim bolluğu. * Genişlik, gevşeklik, pörsüklük, yumuşaklık.
rehabe (rîhâbe): Göğüs üzerinde olan yumuşak kemik.
rehabîn(e): (Ruhban. C.) Râhibler. Ruhbanlar.
rehafe: încelik.
rehafeşan: Kurtarıcı.
rehah: Yumuşak. * Geniş.
rehaîn: (Rehine. C.) Rehineler. Garanti olarak elde tutulanlar.
rehak: Gaşyetmek, sarıp bürünmek. Bir adamın arkasından yaklaşıp çatmak. * Haramlara ve menhiyata dalıp, hep onunla uğraşmak. (E.T.)
rehakâr: (C.: Rehakâran) Kurtarıcı.
rehamet: Sözün, sesin yavaş, ince ve tatlı olması.
rehan (rîhân): Bahadırlık, kahramanlık. * Denemek, tecrübe etmek. * At yarıştırmak, müsabaka.
rehaset: Tazelik, yumuşaklık, incelik. * Ucuzluk. * Bir işi gevşek tutma.
rehavet: Tembellik, gevşeklik, pörsüklük, ihmalkârlık.
rehavî: Urfa'lı.
rehayab: Kurtulan. * Yolcu olan.
rehayafte: Kurtulmuş.
rehayî: Kurtulma, halâs, necat.
rehb: Korku. Havf.
rehbanîyyet: Râhiblik. Papazlık.
rehbele: Yelmek.
rehber: Yol gösteren, kılavuz. (Bak: Mürşid)(...Hem Rabb-ül-âlemin, meyve-i âlem olan insana âlemi içine alacak bir vüs'at-ı istidat verdiğinden ve bir ubudiyet-i külliyeye müheyya ettiğinden ve hissiyatça kesrete ve dünyaya mübtelâ olduğundan; bir rehber vasıtasiyle yüzlerini kesretten vahdete, fâniden bâkiye çevirmek istemesine mukabil; en âzami bir derecede, en eblâğ bir surette, Kur'an vasıtasiyle en ahsen bir tarzda rehberlik eden ve risaletin vazifesini en ekmel bir tarzda ifa eden yine bilbedahe O Zâttır... S.)
rehberî: Kılavuzluk, rehberlik.
rehbet: Fazla korku, yılmak, çekinmek.
rehbeten : Korkup çekinerek, çekingenlikle.
rehc: Toz, gubar. * Fitne.
rehd: Bastırarak ezme.
rehden: (C.: Rahâdin) Serçeden büyük bir kuş.
reheb: Korkmak, yılmak. çekinmek. * Korku, havf.
rehebut: çok korkmak.
rehec: Toz.
rehf: Keskinleştirmek, bilemek.
rehhas: Kârgir bina yapan.
rehîde: Sıkıntı ve dertten kaçmış olan.
rehîn: (Rehn-Rehine) Bir şeyin yerine teminat olarak tutulmuş olan şey, rehin edilmiş. * Mevkuf ve mahpus kılmak.
rehk: Aradan yetişip yaklaşma. * Yürüme. * şaşa kalma, taaccüb etme, hayrette kalma. * Kötü şeylere düşkünlük.
rehket: Güçsüzlük, kuvvetsizlik, zayıflık.
rehl: Sülpük olmak. Kendini salıvermek. * Acı çekmek, muztarib olmak. * çok uyumaktan yüzü şişip uyuşuk olmak.
rehlet: şişkinlik, şişme.
rehmet: Yağmur, rahmet.
rehn: Sâbit ve dâim olmak. *Devamlı oluş. * Hapsetmek.
rehneverd: Yola çıkan. Yolcu.
rehnüma: Yol gösteren. Kılavuz.
rehnümun: Rehberler, yol göstericiler.
rehnümunî: Kılavuzluk, rehberlik.
rehpeyma: Yol ölçen.
rehpeymayî: Yolculuk.
rehrehe: Parlamak.
rehrev: Yolcu. Yola giden.
rehs: Bir şeyi ayakla çiğniyerek ezme.
rehs: Kârgir bina yapmak. * Bir nesneyi çok sıkmak.
rehş: Asmacık.
reht: (C.: Erhüt-Erhât-Erâhit) Cemaat, kalabalık. * Kavim, kabile. * Ondan az olan adamlar. * Göbekle diz arası miktarı deri. (Hayızlı avretler giyerler)
rehvac: Kebabı iyi pişirmek.
rehv(e): (C.: Rahâ) Yüksek mekân, yüksek yer. * Alçak, çukur yer, (içinde su toplanır) * Mahalle içinde, yağmur suyu ve çeşme suyu akan ark. * üveyik kuşu. * Arası açılmış ve ayrılmış.
rehvece: Sür'atle gitmek.
rehyab: Yolunu bulabilen, girebilen.
rehyat: Acizlik. * Zayıflık, süstlük. * Bir dengi birinden ağır etmek.
rehz: Hareket etmek. 
rehzen: Yol kesen, haydut, eşkiya.
reîm: (C.: Arâm) Beyaz geyik.
reîs: Baş, başkan.
reîs-î âlem: âlemin reisi. Hazret-i Muhammed'in (A.S.M.) bir ismi. (Bak: Mefhar-ı Kâinat)
reîs-î kabîle: Kabile reisi.
reîs-î vükelâ: Vekillerin başı. Başvekil. Başbakan.
reîs-ül küttab: Eskiden Hâriciye Nâzırı, Dışişleri Bakanı.
rejîm ©: Fr. Bir devletin sevk ve idare usulü, yolu. * Tıb: Hastanın tedavisinde tatbik edilen gıdalandırma yolu. Perhiz.
rekabet: Kıskanmak. * Hıfzetmek. * Gözetmek. * Terakkub üzere olmak, başkalarından ileri geçmeğe çalışmak, benzerleriyle üstünlük yarışına çıkmak. * Kendi işini yürütmeğe çalışmak.
rekaîk: (Rakik. C.) înce ve nâzik olan şeyler.
rekaket: Kekeleme, dil tutukluğu. * Sözün kusurlu oluşu. Belagattan mahrum olmak. * Zayıf ve ince olmak, yufka olmak. * El ile cismin hacmi ve cüssesini anlamak için yoklamak. * Gevşeklik, zayıflık, dermansızlık.
rekam: Birbiri üstüne kat kat yığılmış nesne.
rekanet: Vakarlılık, ağırbaşlılık.
rek'at: (Rik'ât) Huzur-u îlâhide beli eğip yüzü üzeri kapanmak. * Bir kıyam, bir rüku' ve iki secdeden ibaret olan namazın bir rüknü.
rek'at-i sânîye: îkinci rekât.
rek'at-i ulâ: Birinci rekât.
rek'ateyn: îki rekât.
rekb: Atlılar alayı, süvari takımı. * Diz ile vurmak. Dizi vurmak.
rekd: Kımıldamamak, durgun olmak.
rekeat: (Rek'at. C.) Rekâtlar.
rekeb: (C.: Erkâb) Kasığın kıl bittiği yeri.
rekîk: Dili tutuk, kusurlu, peltek. * Rey ve idraki zayıf olan. * Gayret ve namusu olmayan. * Zayıf, kuvvetsiz.
rekîk-ül lîsân: Dili tutuk. Peltek. Kekeme.
rekîn: Yüce, yüksek, âli. * Ağırbaşlı, ciddi, vakarlı.
rekîz: (Rekz. den) Sağlam. * Gizli, gömülü define.
rekk: îlzâm etmek, susturmak. * Birbiri üstüne bırakmak.
rekl: Ayağıyla vurmak.
rekm: Biriktirme, yığma.
rekme: Cem'olmuş, toplanmış. * Yön, cânip. * Parça, cüz'.
rekn: Meyletmek, yönelmek, eğilmek.
reks: (Rekkese) Geri döndürmek, çevirmek, tepesi aşağı etmek.
rektör: Fr. üniversitenin başkanı.
reku': Sâkin olmak. * Kesilme.
rekub: Binek hayvanı, binilecek şey.
rekub: Erkeğinin ölümünü bekleyen kadın. * Evlâdı durmayan avret. * Kalabalıktan suya yaklaşamıyan deve.
rekud: Uyumuş.
rekve: (C.: Rukâ-Rekavât) îbrik.
rekye: (C.: Rekâyâ-Rekâ) örülmemiş kuyu.
rekz: Dikme, yere saplayıp sabit kılma.
rekz: Harıl harıl ayak ile tepmek. Hayvana tekme ile vurmak. Kakıvermek. * Kaçmak. Seğirtmek, koşmak. * Hicret. Gaza.
rekz-î alem: Bayrağı bir yere dikme.
rekz-î hîyâm: çadır kurma.
re'l: (C.: Riâl-Ri'lân-Er'ul) Deve kuşu yavrusunun erkeği.
rem: Titreme. * ürkme. * Sürü.
rema: Bir yerde ikamet eylemek. * Ziyade olmak. * Riba, faiz. * Bir haberi zan ile anlayıp idrak etmek.
remad: Kül. (Bak: Ramad)
remadet: însan veya hayvan kırımı.
remak: Bedende ruhun bakiyyesi. * Koyun sürüsü.
reman: (Remen) Sürü. * ürken, ürkücü.
remas: Göz pınarında toplanan çapak.
remaz: Güneşin harâretinin çoğalması.
remaze: Oturak yeri. * Zina eden kadın.
remd: Helâk olmak. * Gözün çapaklanması. Göz hastalığı.
reme: ürkek, ürken. * îyi nesne.
remed: Gözün ağrıması, göz kapağı iltihabı.
remeke: (C.: Rimâk-Ramek-Ramekât-Ermâk) Kısrak.
remel: (C.: Ermâl) Yelmek. * Yağmurun az yağması. * Vahşi sığırın ayağında olan hatlar.
remende: ürkek, ürkücü.
remes: (C.: Ermâs) Denizde üzerine binilen sal. * Kalan süt artığı.
remg: Bâtıl etmek. * Baş yarmak.
remgerde: Titremiş. * ürkek, ürkmüş.
remh: Süngü ile vurmak. * Tekme vurmak.
remî: (C.: Ermiye) Yağmuru iri olan ve yere şiddetle inen bulut.
remîde: ürkmüş, korkmuş, çekingen.
remîm: Kemiğin çürümesi. çürük.
remîyye: Bir nesne ile atılmış olan av.
remk: Durmak, ikâmet. * Boz renk.
reml: (Remil) Kum falı, bir takım nokta ve çizgilerle fala bakmak oyunu. * Filistin'de bir kasaba.
remla': Ayakları siyah, diğer tarafları beyaz olan dişi koyun.
remlî: (şihâbüddin Remli) (Mi: 1371-1440) Filistin'in Reml kasabasında doğmuş, şeyhülislâm'dır. Mecmuat-ul Ahzab'da namı Kutb-ül ârifin diye geçer. Kimya-yı Saadet namında salâvatları ile meşhurdur. Fıkh ve tevhide, tasavvufa dair manzumeleri vardır. " îmam-ı Remli" diye anılır.
remm: Islah etmek, düzeltmek. * Yemek, ekletmek.
remma': Beyaz tenli kadın.
remmaa: Oturak yeri. * çocukların başındaki oynak yer.
remmah: Mızrakçı, süngücü.
remmaz: (Remz. den) îşaretlerle konuşan.
remram: Bir ağaç cinsi. * Yazın biten bir ot.
rems: (C.: Rumus) Mezar, kabir.
rems: Sürtme odunu. * El ile meshetmek. * Islah etmek, düzeltmek.
remy: Atma. Tüfek atma.
remz: îşaret. îşaretle anlatmak. * Güç anlaşılır. * Gizli ve kapalı söyleme.
remza': Güneşin tesiriyle kızmış taş.
remzen : îşaretle. Remz olarak.
remzî: îşarete ait, işaretle alâkalı.
remzşînas: Bir maksad anlatan şekil, resim vb. * Gizli ve kapalı olarak anlatılan şeyleri ve işaretleri bilen.
rena: Nazar olunan, bakılan.
renak: Mastar. * Suyun bulanık olması. * Kederli olmak, mükedder olmak.
renanet: înleme.
renc: Sıkıntı, zahmet, eziyet. * Ağrı, sızı. * öfke, gazab, hışım.
renc-ber: (Renc; sıkıntı, zahmet. Ber; çeken) Tarla ve bahçede yahut başka işlerde kazmak veya taş, toprak taşımak gibi işlerde çalıştırılan gündelikçi. Amele, ırgat. * çiftçi.
rencîde: încinmiş, kırılmış.
rencîdegî: încinip hatırı kırılmış olma. * Dertlilik, kederlilik.
rencîdehâtir: Gücenmiş, hatırı kırılmış.
rencîş: Sızlanış, inciniş, eziyet ve sıkıntı veriş. Keder.
rencur: încinmiş. Sıkıntılı, rahatsız, dertli, hasta.
rencurî: Dertlilik, rahatsızlık, hastalık. încinmiş olma.
rend: Mersin ve defne ağaçları.
rende: Tahtaların yüzlerini pürüzlerden kurtarıp dümdüz etmek için marangozların kullandıkları âlet. * Mutfakta peynir, soğan, havuç gibi şeyleri ufalamak için kullanılan tenekeden veya ona benzer maddelerden yapılan âlet.
rendelemek: Pürüzlerini gidermek. Rende ile düzlemek, pürüzlü yerlerini kazımak. Rende ile ufalamak.
rendîde: Rendelenmiş, ufalanmış.
renem: Avaz, ses, savt. * Ayrılmak.
renevna: Dâim sâkin olmak, devamlı durmak.
renf: (Davar) zayıflığından kulaklarını sarkıtmak.
reng: Renk, levn. * Suret, şekil. * Oyun, hile, dalavere.
reng ü bu: Renk ve koku.
reng-amîz: Renk renk, çeşitli renkli.
reng-aver: Dalavereci, hilekâr.
rengâreng: Renkli, çeşit çeşit.
rengîn: Renkli, boyalı. Parlak. Hoş. Süslü. Mülevven. Lâtif.
renîm: Türkü söylemek.
renîn: Bağırma, haykırma. * înleme, inilti.
renk: Bulanık su.
renna': Devamlı kadınlara bakan kimse.
rennan: çok ses çıkaran, inleyip duran. çınlıyan.
renne (rînne): Avaz, ses, savt.
renv: Bakma hususunda mübâlağa etmek.
re'ree: Gözü tez tez döndürmek. * Koyun çağırmak.
re's: Baş, kafa. * Tepe. Uç. * Başlangıç. * Reis.
res: (Residen: Erişmek mastarının emir köküdür.) "Ulaşan, erişen, yetişen" mânasına gelir ve birleşik kelimeler yapılır.
re's-ül mal: Ana para, sermaye, kapital. * însanın ömrü. Hayat.
re's-ül mal: Ana para, sermâye, kapital. * însan ömrü, hayat.
re'sa: Başı ve yüzü siyah olan koyun.
resa: Yetişen, erişen. Yetiştiren.
resa': Tatlı sütü ekşi yoğurtla karıştırmak. (O yapılan yemeğe "resise" derler.)
resa': şiddetli hırs.
resae: ölünün üzerine ağlayıp, onun iyiliklerini saymak.
resag: Devenin ayaklarında olan gevşeklik.
resaîl: (Risale. C.) Risaleler, bir mevzuda yazılan mektuplar veya küçük kitaplar. * Dergiler, mecmualar.
resaîl-ün nur: Nur Risaleleri. (Bak: Risale-i Nur)
resalet: Saçı salıverme. * Deveyi eşkin yürütme. (Bak: Risalet)
resan: (Residen mastarından) "Yetişenler, ulaşanlar, getirenler" mânalarına gelerek birleşik kelimeler yapılır.
resan: Ulaştırı yağan yağmur.
resane: Teessüf. * Hasret.
resanehâr: Hasret çekici.
resanende: Ulaştırıcı, getirici.
resanet: (Bak: Rasanet)
resas : (Bak: Rasas)
resaset: Eskilik, köhnelik. Yıpranmış olma.
resatîk: (Rustâk. C.) Köyler, çiftlikler.
resd: Eşyaları birbiri üstüne yığmak.
resed: Lâyık, şâyan, şâyeste.
resed: Ev eşyası.
resel: (C.: Ersâl) Deve ve koyun sürüsü. Topluluk, cemaat.
resem: Atın üst dudağında olan beyazlık.
re'sen: Kendi başına, bizzat. * Kimseye danışmadan. Müstakil olarak. * Doğrudan doğruya.
resen: (C.: Ersân) Atı veya davarı ip ile bağlamak. * îp, halat, urgan.
resenbaz: îple oynayan. îp cambazı.
resenbend: Halat atmış, halatla bağlı.
resf (resfân): Ayağı köstekli gibi yürümek.
resh: Bir şeyin, yerin sabit olması.
resh: âcizlik, zayıflık. * Uyluk etleri az olmak.
resîbe: (C.: Rasibât) Dizlerde ve mafsallarda olan hastalık.
resîde: Erişmiş, ulaşmış, yetişmiş.
resîde-î hîtâm: Sona ermiş, hitâm bulmuş, bitmiş.
resîf: Su yüzüne kadar gelen sıralanmış kayalar.
resîl: (C.: Rüsül - Rüselâ) Elçi.
resîm: Bir çeşit deve yürüyüşü.
resîs: Yaralı, mecruh. * Köhne, eski. Eskimiş, yıpranmış.
resîs: Sâbit, devamlı. * Bakıyye, artık. * Akıllı, zeki kimse. * Sahih olmayan haber. * Aşk-ı muhabbetin ibtidası. * Hastalık başlangıcı.
resîyy: Hayır veya şerde musırrâne direnen. * çatıyı ayakta tutan direk.
resl: Kıvırcık olmayan saç.
resm: (Resim) Yazma, çizme, desen. * Eser, iz, nişan, alâmet. * Suret. * Tertib. Tarz, üslub. * Fotoğraf resmi. * âdet, usul, tavır, davranış. * Alay, merâsim. * Man: Bir şeyi başkalarından ayırdeden tarif.
resm-î geçît: Askeri bir kıt'anın yahut bir mektebin talebelerinin gösteri mahiyetinde geçişi. Geçit resmi.
resm-î gümrük: Gümrük vergisi.
resm-î kadîm: Eski usûl.
resm-î küşad: Yeni yapılan mekteb, fabrika, kışla, hükümet konağı, demiryolu vs. gibi şeylerin umuma açılışı yerinde kullanılan bir tâbirdir. Yeni tabirde " Açılış töreni" demektir.
resmen: Devlet namına, resmi olarak, devlet tarafından. * Kat'i olarak anlaşıldığına göre. * îsteye isteye. Bile bile. * Görünüşte, âdet yerini bulsun diye. Nezaket icabı olarak.
resmî: Devlet adına veya devlet tarafından. * Ciddi. çok sert. * Resme, yazıya, çizgiye ait. Resme dair.
resmîyât: Resmi olan işler.
resmîyet: Resmilik. Resmi olmaklık.
ress: Taşla yapılmış, taşla örülmüş kuyu. * Semud taifesinden kalmış bir kuyunun adı. * Maden. * Dere. * însanlar arasında ıslah ve ifsad etmek.
ressam: Resim yapan, resim çizen.
resse: (C.: Rises-Risâs) Eski ve çürümüş, köhne. * Ev eşyasından eskiyip atılanı.
resse: Avcıların gizleneceği yer. * Hastalığın başkasına bulaşması.
reste: (C.: Restegân) Kurtulmuş.
restegân: (Reste. C.) Kurtulmuş olanlar.Restgâr: Kurtulan.
restgârî: Kurtulma, necat.
restorasyon: Fr. Tarihi eserlerin aslına uygun tarzda tamiri.
resül: Peygamber. Yeni bir kitap ve yeni bir şeriat ile bir ümmete veya bütün beşeriyete Allah tarafından Peygamber olarak gönderilmiş olan zât. Mürsel de denir. Yeni bir kitap ve şeriatla gelmeyip kendinden evvelki Resülün getirdiği kitap ve şeriatı devam ettirirse, ona Nebi denir. * Haberci. * Huk: Tasarrufta hakkı olmaksızın, birisinin sözünü olduğu gibi bir başkasına bildiren kimse. * Elçi.
resül-î ekrem (a.s.m.): (Bak: Muhammed (A.S.M.)
resül-ül melâhîm: Resül-i Ekrem'in (A.S.M.) bir ismidir. Cenk ve muharebe ile de vazifeli olduğundan ümmeti ve kendisi din için, dinin ihyası uğrunda büyük muharebelere mükellef olduğundan bu isim ile de yâd edilmiştir.
resül-ür rahat: Resül-i Ekrem'in (A.S.M.) bir ismidir. Kendisine tâbi olup onun getirdiği hakikatları tasdik ve iman ile insanlar büyük nimetlere ve rahatlara mazhar olduklarından kendisine bu isim verilmiştir. Ve kendisi buyurmuştur ki: "Ben dinin doğruluğu ve kolaylığı için peygamber gönderildim." ... însanlara en büyük selâmeti ve rahatı bahş eden Resül-i Ekrem'in (A.S.M.) getirdiği îlâhi hakikatlar, beşeriyeti Cemalullâh'a ulaştırır ve en büyük rahata kavuşturur. (D.H.)
resül-ür rahmet: Peygamberimize (A.S.M.) verilen bir isim. çünkü bütün âlemlere rahmet olarak gönderilmiştir. Rahmeten lil-âlemin'dir.
resülullah: Allah'ın (C.C.) gönderdiği Peygamber. Hazret-i Muhammed'in (A.S.M.) bir ismi.
resve: (C.: Rasa) Kadınların kollarına boncuktan veya inciden yaptıkları kolbağı.
resy: Sâbit olmak, devamlı olmak.
resye: Romatizma.
reşa': Yürüyebilen geyik yavrusu.
reşad: Hak yolda yürümek. Doğru yolda olmak. Doğru yolu bulup ondan sapmamak. * Aklın kuvvetli olması.
reşad-penah: Reşada sebep olan. Kurtuluşa sebep.
reşahat: (Reşehât) (Reşha. C.) Reşhalar. Sızıntılar, serpintiler.
reşahat-î îhtîyar: îstekle yapılma alâmetleri. îhtiyar sızıntısı, yâni bir irade ve tercih ile yapıldığını gösteren alâmetler.
reşahat-î kalem: Kalem sızıntısı, kalemden dökülen fikirler, yazılar.
reşak: Helâk etmek. * Atmak.
reşakat: Bel inceliği. * Davranma ve kımıldanıştaki incelik ve hoşluk.
reşaş: (Reşâşe) Serpinti ve toz gibi ince yağmur.
reşaşat : Su sızıntıları, serpintiler.
reşaşet : Su serpintisi. * Emmek, emerek içmek.
reşat: (Bak: Reşad)
reşed: Hayır. Rahmet. Hidayet.
reşehat: (Reşha. C.) Reşhalar, damlalar, sızıntılar. 
reşem: îlk evvel çıkan ot.
reşen: Tar: Yeniçeri maaşlarının üçüncü üç aylığı.
reşf: Suyu dudakları ile emmek, emerek içmek.
reşh: Sızma, terleme, sızıntı.
reşha: Damla, katre. Sızıntı, ter, rutubet, yaşlık.
reşhapâş: Damla saçan.
reşharîz: Damla döken.
reşhayâb: Sızıntı bulmuş.
reşîd(e): Doğru yolda giden, hak yolunda olan. * Akıllı, iyi davranan. Ergin, olgun. * Büluğ çağına girmiş kimse. * Doğru yola sevkeden, hayra delâlet eden. * Fık: Malını muhafaza hususunda aklı eren, istediği gibi meşru yolda sarfedebilen kimse.
reşîdîyye: Reşid olanla ilgili. * şeker ve nişasta ile yapılan bir çeşit tatlı.
reşîh: Ter.
reşîk: Boyu, endamı lâtif ve güzel olan.
reşk: Kıskanma. Kıskanmayı uyandıran. Kıskanılmış. Hased ve gıpta veren.
reşk-âver: Hasede düşüren, kıskanmayı uyandıran.
reşk-endâz: îmrendirici, gıpta ettirici. Kıskandırıcı.
reşk-î âlem: Herkesi kıskandıracak kadar üstün durumda olan.
reşk-saz: Gıpta ettiren, imrendiren.
reşkîn: Kıskanç. Kıskanan. Hased eden. Hâsid.
reşn (rüşün): Köpeğin, başını kaba sokması.
reşraş: Kavak ağacı. * Su veya yağ damlayan kebap. * Su saçmak.
reşreş: Yumuşak döş kemiği.
reşş: Serpmek, püskürtmek. * Serpinti, serpintili yağmur, çisilti.
reşv: Rüşvet almak.
ret': (Rita' - Rütu') Yemek, içmek. Bolluk içinde dilediğini yiyip içmek. * Oynamak.
retaîm: (Retime. C.) Bir şeyi hatırlayabilmek için parmağa bağlanan iplikler.
retc: Kapıyı sürgülemek. Kapının kilitlenmesi.
reteb: Zahmet. şiddet. * şehadet parmağı ile orta parmak arası.
retec: (Ritâc) Büyük kapı.
reted: Defne ağacının yaprağı.
reteh: Bündük-i Hindi denilen yuvarlak taş.
retel: Muntazam, hoş. Gönül çeken.
reteme: (C.: Ratem) Bir ağaç cinsi. 
retîme: (C.: Retaim) Bir şeyi hatırlayabilmek için parmağa bağlanan iplik.
retk: Yırtığı onarmak, yarığı düzeltmek, bitiştirmek.
retk (retkân): Adımların birbirine yakın olması. * Deve kuşunun sür'atle gitmesi.
retk ü fetk: Noksanları düzelterek idare etme. * Ayırmak ve bitiştirmek. * îyi idare etme.
retl: (Diş) seyrek olmak. * Bir şeyi okurken her kelimenin arasını ayırıp açıklamak.
retm: Kırmak.
retn: Karıştırmak.
rett: şerif, seyyid.
retv: Kuyudan kova çekmek.
retve: Adım. Hatve.
reum: Yavrusunu seven deve. * Yanından geçen kimsenin elbisesini yalayan koyun.
rev: (Reften mastarının emir kökü) "Giden, yürüyen" mânasında olup birleşik kelimeler yapılır. Meselâ: Piş-rev $: önde giden.
rev': Korku, halecan. ürkmek. * Nefsani hareket.
rev'a: Korkak kadın. * Kendisini görenleri şaşırtacak derecede güzel olan kadın veya kız. (Müz: Ervâ)REVA': Tatlı.
reva: Lâyık, uygun. Meydana gelmek. * Gidici.
revabit: (Rabıta. C.) Râbıtalar, bağlılıklar. Münasebetler. * Düzenler, sıralar, tertibler.
revac: Sürüm. Kıymet, değer, geçerlik, makbuliyet.
revacdâr: Sürümlü ve revâcda olan mal.
revadaşte: Uygun bulmuş.
revah: öğleden akşama kadar olan vakit. * Bir şeyin tahsilinden dolayı gelen sürur ve şâdlık, neş'e.
revahî: (Râhiye. C.) Bal arıları.
revahîl: (Râhile. C.) Yük hayvanları.
revaîd: Göçebe topluluk.
revaîh: (Bak: Revâyih)
revak: (Rivak) Ev önündeki saçak. * Kemer. Kubbe. çardak. önü açık, üstü örtülü yer.
revak-i uhrevîye: âhirete açılan yer, mezar. * Cennet bahçesi. âhiretin mukaddemesi.
revak-ül ayn: Kaş.
revakîd: (Râkid. C.) Durgun olanlar.
revalver: (Bak: Rovelver)
revan: Giden, akıcı. * Derhal. * Ruh, can. Nefs-i nâtıka. * Edb: Su gibi akıp giden güzel söz.
revan-bahş(a): Canlandırıcı, can bağışlayıcı.
revan-i tabîat: âlemin canlılığı, akıcılığı, hareketli oluşu.
revane: Yürüyen, giden.
revanî: Değerli, rağbetli revaçlı. * Tepside pişirilen irmik veya undan bir tatlı çeşidi.
revanî-füruş: Revanici. Revani satan.
revasî: (Râsiye. C.) Büyük dağlar.
revasîb: (Rüsub. C.) Tortular.
revasîb-î remlîye: Kum tortuları.
revasîm: Akarsu.
revasîr: (Reysar. C.) Reçeller.
revatîb: Vazifeler, maaşlar. * Farz namazından önce kılınan müekked sünnetler.
revayîh: (Revâih) Râyihalar, güzel kokular. (Aslı: Revâih)
revazîn: (Revzen. C.) Pencereler.
revb (rub): Sütün yoğurt olması.
revban: (C.: Rübâ) Sütün yoğurt olması. * Sarhoşluk şiddetinden birbirine karışmış olan insanlar.
revc: (Revac) Geçmek. * Rüzgârın karışık esmesiyle ne taraftan geldiği belli olmaması.
revende: Giden, gidici. * çok yürüyen.
revendegân: (Revende. C.) Yürüyenler, gidenler.
revg: Talep etmek, istemek. * Yönelmek, eğilmek, meyletmek.
revgan: Yağ. * Hafif hafif esen rüzgârın verdiği serinlik, rahatlık. * üstü yağ gibi kayan parlak nesne. * Parlak deri.
revgan-i zeyt: Zeytinyağı.
revgandân: Yağ kandili.
revganî: Revani tatlısı.
revh u reyhan: Rahat ve rızık, bolluk ve hoşluk.
revh(a): îç açıklığı. Rahat. * Rahmet. * Hafif esen rüzgârın verdiği tatlılık, canlılık. (Bak: Ravh)
revhanî: îyi ve pâk olan, ferahlık veren yer.
revhanîyet: Gönül açıcılık, güzel görünüşlülük.
revhat: öğlen vaktinden akşama kadar gitmek.
revhullah: (Bak: Ravhullah)
revîr: Alm. Okul, kışla gibi yerlerde ufak hastalıkları olanların yatırıldıkları hasta odası, ilk bakım yeri. * Bölge, mıntıka.
revîş : Gidiş, hal, tavır. * Tutum, yol.
revîy: Edb: Kafiye olan kelimenin son harfi. şiirde kafiye harfi.
revîyyet: (C.: Reviyyât) Bir işin her cihetini iyice düşünme.
revk: (C.: Ervâk) Perde, hicâb. * Boynuz. * Ev önü. * Saf, hâlis, katıksız.
revk-uş şebab: Gençlik başlangıcı.
revm: Maksad. Taleb, istek. * Tevcidde: Sükûndan ayırd edilmeyecek derecede olan belirsiz hareke.
revnak: Zinet. Parlaklık. Göz alıcılık, güzellik. Safa, taravet.
revnak-bahş: Güzellik, tazelik ve parlaklık veren.
revnak-dâr: Parlak, lâtif, güzel, hoş.
revnak-efza: Bir şeyin parlaklığını artıran. Güzelleştiren.
revnak-i bahar: Baharın güzellik ve tazeliği.
revnak-i cemal: Yüzün güzellik ve parlaklığı.
revnak-nüma: Tâzelik, güzellik ve parlaklık gösteren.
revnüma: (Ru-nüma) Zuhur eden, kendini gösteren. * Yüz görümlüğü.
revs: Sabit olmak.
revse: Pislik. * Fışkı, tezek.
revv: çift, karı-koca, zevc.
revy: (Davar) Suya kanmak.
revz: Sınamak, denemek, tecrübe.
revzat: (C.: Ravz-Ravzât-Riyaz-Rizât) çayırlı, çimenli ve sulu yer. * Bostan.
revzeke: (C.: Revâzik) Küçük kuzu ve oğlak.
revzen: (C.: Revâzin) Pencere.
revzen-î mahlu: îndirilmiş pencere.
revzene: (C.: Revâzin) Pencere.
re'y: Görüş, görmek, rey. Hüküm ve itikad. Kıyas etmek. Bir iş hakkında söylenen söz, fikir.
rey': Arpa, buğday, tahıl. * Rücu', geri dönme, avdet. * Ziyade, çok.
re'y-î âm: Umumun re'yi, ekseriyetin fikri. Umumun görüşü.
re'y-î sâlîm: Doğru fikir ve düşünce.
re'y-ül ayn: Kendi gözüyle görerek.
reyah: (Râh. C.) şaraplar. * Gökçek kokulu küçük bir kuyu.
reyb: (Bak: Rayb)
reyc: Akça, para, pul. * örtülmüş ve kilitlenmiş olan büyük kuyu.
reyde: (C.: Ruyud) Dağın sivri ve yumru tarafı. * Yavaş ve yumuşak esen rüzgâr.
reyean: Artma, çoğalma, ziyâdeleşme, bereketlenme. * Her şeyin evveli, tazelik zamanı.
reyean-i şebab: Gençlik çağı.
reyhan: Hoş güzel koku. * Rızık ve maişet, rahmet. * Ekin yaprağı. * Fesleğen denilen kokulu bir ot.
reyhanî: Fesleğen gibi ince nakışlı. * Divani hat da denilen bir yazı tarzı.
reyhekan: Za'feran.
reyk: Her nesnenin evveli ve efdali, iyisi.
reym: Alçak yer. * Kabir. * Derece. * Deveyi boğazlayıp taksim ettikten sonra kalan kemik. * Ziyâde çok, fazla.
reyn: Leke, kir, pas. * Gönül karası, kalb katılığı, günahın artması. * Uyku, mestlik galebe etmek. * çıkması mümkün olmayan şey.
reys: Eğlenmek, eğlendirmek.
reys: (Reysân) Sallanmak. * Gururlanmak, tekebbürlenmek.
reyş: Ok yeleklemek.
reyta: (C.: Riyat-Riyâtâ) Car denilen örtü.
reyya: Güzel koku.
reyyan: (C.: Rivâ) Suya kanmış, sudan doymuş. * Sarhoş.
reyye: çokluk, fazlalık, kesret.
rez: Bağ kütüğü, asma.
reza': (Bak: Reda')
rezaat: Süt emme.
rezag: Sıvı balçık. * înce çamur.
rezahat: Yorulmak. * Hali yaramaz, vaziyeti kötü olmak.
rezaîl: (Rezile. C.) Utanılacak çok fena işler, alçakça hareketler.
rezalet: Utanç verici şey. Utanılacak hal. * Alçaklık, rezillik. * Maskaralık. * Arsızlık.
rezan: Ağır, ciddi, vakarlı, ağırbaşlı ve temkinli kimse.
rezanet: Ağırbaşlılık, vakarlılık, temkinlilik, ciddilik.
rezaya: (Rezie. C.) Musibetler, belâlar.
rezayîl: (Rezile. C.) çörçöp. * Faydasız ve asılsız nesne.
rezaz: Zayıf yağan yağmur.
rezban: Bağ bekçisi, bağcı.
rezeme: (C.: Ruzum) Devenin ağzını açmadan boğazından çıkan ses.
rezen: (C.: Revâzin) îçeri çukurca olup su toplanabilen yüksek ve sağlam yer.
rezîe: (C.: Rezâyâ) Musibet, felâket, belâ.
rezîl: Alçak, adi, utanmaz, hayâsız, soysuz.
rezîl ü rüsva : Kusur ve ayıpları meydana çıkarılmış, kepâze olmuş olan.
rezîle: (C.: Rezâil) Fenâ ve kötü huy.
rezîm: Arslan kükremesi.
rezîn: Vakarlı, temkinli, ağır başlı, sağlam.
rezîz: Elbise boyamada kullanılan bir ot cinsi.
rezm: Deve avazı. * Gök gürlemesi. * Cem'etmek, toplamak.
rezm: Akmak, seyelân.
rezm: Cenk, muharebe, çarpışma, savaş.
rezmgâh: Savaş meydanı, muhârebe sahası.
rezmî: Savaşla ilgili.
rezmyuz: Savaşçı, kavgacı, muhârib.
rezn: Bir şeyi kaldırıp ağır mı hafif mi diye görmek.
rezn: Koparmak.
rezz: Bir şeyi yere batırmak. * çekirgenin, kuyruğunu yere batırıp yumurtasını dökmesi.
rezzak: Bütün mahlukatın rızkını veren ve ihtiyaçları karşılayan. (Allah)
rezzakane: Rızık verene, rezzaka yakışır surette.
rezzakîyet: Her mahluka münasib rızkını verici olmak.
rezzaz: Pirinç satan. Pirinç satıcı.
rezze: îçine kilit sokulan kapı razzesi.
ri: Kur'an alfabesinin onuncu harfi olup, ebcedi değeri 200'dür.
rias: Tâç.
ribh: (Bak: Ribh)
ribka: (C.: Ribak) Davar bağlamada kullanılan ip.
rid': Yardımcı, muavin. * Gözleyici.
rida': (Bak: Red'a)
riddîdî: Reddetmek.
riddîs: (Mübalağa ile) Taş atan.
ri'de: Titremek, hareket etmek.
ridfe: (C.: Ruzuf) Diş aşığı kemiği.
ridvan: Memnunluk, razılık, hoşnudluk. * Cennet'in kapıcısı olan büyük melek.
ridvanullahî aleyh: "Allah ondan razı olsun" meâlinde dua.
rifk: Yumuşaklık, yavaşlık, tatlılık, nezaket. (Zıddı: unf)
rifkî: (Rıfkıye) Yumuşaklıkla, tatlılıkla ilgili.
rihal: Büyük halı.
rihlet: (Bak: Rihlet)
rihtim: Gemilerin yanaşmalarına müsait şekle getirilmiş kıyı.
rihv (rahv): Yumuşak.
rihvet: Gevşek ve sölpük olma. Rahavet.
rik'a: Kur'an-ı Kerim'in harfleri ile bir yazı çeşidi.
rika: üzerine yazı yazılan deri veya kağıt parçaları. * Kısa mektublar. * Yamalar. * îstidalar. Müzekkereler. Dilekçeler.
rika: Darbolunmuş dirhem.
rikak: Yer yarığı.
rikk: (C.: Erkâ) Kul, abd. * Kulluk, esirlik, kölelik, ubudiyet. * Yufka nesne.
rikkiyyet: Kölelik, kulluk.
rişk: Atılan ok.
ritane: Arap lisanından başka dille konuşmak.
ritl: (Bak: Ratl)
ri've: Depretmek.
riyy: Suya kanmak. * Beni Amir vilâyetinde bir dağın adı.
riza: Memnunluk, hoşluk, razı olmak. * îstek, arzu. Kendi isteği.
riza-cu: Allah'ın rızasını arayan. Razı etmeyi gaye edinen.
riza-dâde: Razı olmuş, kabul etmiş.
riza-yi bârî: Allah'ın rızası.
riza-yi îlâhî: Allah'ın kulundan memnun olması. Her hangi bir hareketinde mü'minin en yüksek derecesi.(Rıza-yı îlâhi ve iltifat-ı Rahmani ve kabul-ü Rabbani öyle bir makamdır ki; insanların teveccühü ve istihsanı, ona nisbeten bir zerre hükmündedir. Eğer teveccüh-ü rahmet varsa yeter. însanların teveccühü, o teveccüh-ü rahmetin in'ikası ve gölgesi olmak cihetiyle makbuldür. Yoksa arzu edilecek bir şey değildir. çünkü kabir kapısında söner, beş para etmez. M.)
riza-yi tarafeyn: îki tarafın isteği.
rizaen: Razı olarak.
rizaen-lîllâh: Allah rızası için.
rizam: Büyük kaya parçası.
rizk: Yiyip içecek şey. Maddi mânevi ihtiyaca lâzım nimet. Allah'ın herkese lütuf ve kısmet ettiği ve bekaya sebeb olan nimet.(Rızk-ı helâl, iktidar ile alınmadığına, belki iftikara binaen verildiğine delil-i kat'i; iktidarsız yavruların hüsn-ü maişeti ve muktedir canavarların dik-ı mâişeti; hem, zekâvetsiz balıkların semizliği ve zekâvetli, hileli tilki ve maymunun derd-i maişetle vücutça zaifliğidir. Demek rızık, iktidar ve ihtiyar ile mâkusen mütenasiptir. Ne derece iktidar ve ihtiyarına güvense, o derece derd-i maişete mübtelâ olur. S.)(Rızk ise; hayattan sonra ni'metlerin en büyük bir hazinesi ve şükür ve hamdin en zengin bir menbaı ve ubudiyet ve dua ve ricaların en cem'iyetli bir mâdeni olmasından, suret-i zâhirede müphem ve tesadüfe bağlı gibi gösterilmiş. Tâ her vakit Rezzak-ı Kerim'in dergâhına iltica ve rica ve yalvarmak ve hamd ve şükür şefaatiyle rızk istemek kapısı kapanmasın. Yoksa muayyen olsa idi, mâhiyeti bütün bütün değişecekti. şâkirane, minnetdarane ricalar, dualar, belki mütezellilâne ubudiyet kapıları kapanırdı. ş.)( $ sarahatiyle; ummadığı tarzda yaşayacak kadar rızkını bulacak. çünki şu âyet taahhüd ediyor. Evet, rızk ikidir:Biri hakiki rızktır ki, onunla yaşıyacak. Bu âyetin hükmü ile o rızk, taahhüd-ü Rabbani altındadır. Beşerin su-i ihtiyarı karışmazsa, o zaruri rızkı her halde bulabilir. Ne dinini, ne namusunu, ne izzetini feda etmeğe mecbur olmaz.îkincisi: Rızk-ı mecazidir ki, su-i istimâlât ile hâcât-ı gayr-ı zaruriye hâcât-ı zaruriye hükmüne geçip, görenek belâsiyle tiryaki olup, terkedemiyor. îşte bu rızk, taahhüd-ü Rabbani altında olmadığı için, bu rızkı tahsil etmek, hususan bu zamanda çok pahalıdır. R.N.)
rizvan: (Bak: Rıdvan)
rîa: (Râi. C.) çobanlar.
rîa: Yüksek yer.
rîat: (Rie. C.) Akciğerler.
rîayet: îyi karşılamak, ağırlamak, hürmet etmek. * Uymak, tâbi olmak. * Otlamak veya otlatmak. * Hıfzetmek, korumak.
rîayeten: Saygı ve hürmet göstererek. Sayarak. Hürmet ederek. * Tâbi olarak.
rîayetkâr: Hürmetkâr, itaatkâr. Sevgi ve saygı gösteren.
rîb': Sıtmanın bir gün tutup iki gün tutmaması ve dördüncü gün yine tutması.
rîba: Tartısı ve ölçüsü belli olan bir malı aynı cinsten daha fazla olan bir mal ile, bir karşılığı olmaksızın, peşin olarak veya veresiye değiştirmektir. * Faiz. * Muamelede meşru miktardan tecavüz. * Bir şeyin artması, çoğalması. * Verilen borç para veya mal karşılığında kâr isteyip zarara ortak olmamak suretiyle hâsıl olan haram kazanç. (Bak: Faiz)
rîba: Bahar evleri, çadırlar. Arazi. * Yaz yağmurları.
rîba-har: Faizle para işleten, tefeci.
rîba-î fazl: Tartılan veya ölçülen bir cins eşyanın kendi cinsi karşılığında fazlasıyla satılması. Meselâ: Bir kilo buğdayı aynı cins bir kilo yüz gramla değiştirmek gibi.(Beşerin hayat-ı içtimaiyesinde bütün ahlâksızlığın ve bütün ihtilâlâtın menşei iki kelimedir. Birisi: "Ben tok olduktan sonra başkası açlıktan ölse bana ne..." îkincisi: "Sen çalış, ben yiyeyim.." Bu iki kelimeyi de idame eden; cereyan-ı riba ve terk-i zekâttır. Birinci kelimenin ırkını kesecek tek bir devası var ki; o da vücub-u zekâttır. îkinci kelimenin devası hürmet-i ribadır. Adalet-i Kur'aniye âlem kapısında durup ribaya: "Yasaktır, girmeğe hakkın yoktur" der. Beşer bu emri dinlemedi, büyük bir sille yedi. Daha müdhişini yemeden dinlemeli. M.)(Ribanın kap ve kapıları olan bankaların nef'i, beşerin fenası olan gâvurlara ve onların en zâlimlerine ve bunların en sefihlerinedir. âlem-i îslâm'a zarar-ı mutlaktır. Mutlak beşerin refahı nazara alınmaz, zira gâvur harbi ve mütecaviz ise, hürmetsiz ve ismetsizdir. M.)
rîbab: Arap kabilelerinden Zubeh, Sevr, Akl, Teym ve Ady denilen beş kabilenin adı.
rîbabe: Ahd, söz, yemin, misak.
rîbac: Kanatlarının ortasında küçük kapısı bulunan büyük kapı.
rîbah: (Ribh. C.) Kazançlar, kârlar, ticaretten elde edilen kârlar.
rî'bal: (Ri'bân) Arslan.
rîbat: (C.: Ribâtât) Han gibi konaklanacak yer. Tekke. * Bağ, ip. * Sağlam yapı.
rîbatet: Kalb kuvveti. * Tahammül, sabır. * Kalbi sağlam olma.
rîbatî: Hancı, odacı.
rîbbî: (C.: Ribbiyyun) Büyük kalabalık.
rîbbîyyun: (Rabb. dan) âlimler, fakihler. * Büyük topluluk.
rî'be: (C.: Riâb) Sihir.
rîbet: (C.: Riyeb) şüphelilik. şüpheye düşme.
rîbh: Kâr, kazanç. * Fâiz.
rîbh-î tîcarî: Ticaret kazancı.
rîbhale: Azası büyük olan, organları iri olan.
rîbka: Kement. Kement bağı. îlmekli ip.
rîbze: Deveye katran sürmede kullanılan yün parçası.
rîca: Yalvarmak, niyaz eylemek. * Canib. Taraf. (Bak: Recâ)
rîcal: (Recül. C.) Erkekler, er kişiler. * Mevki sahibi kimseler, devlet adamları. * Yaya olanlar.
rîcal-î devlet: Devlet adamları, devletin ileri gelenleri. Devlet ricali.
rîcal-î gayb: Her devirde bulunan ve herkesçe görülmeyen ve bilinmeyen ve Allah'ın (C.C.) emirlerine göre çalışan mübârek, büyük zatlar. Ricâlullâh.
rîcalen: Yaya olarak. Yayan. * Erkek olarak.
rîcalullah: Mânevi kudret ve kuvvet sahipleri olan evliya. (Bak: Ebdal)
rîcam: Büyük taş.
rîcaname: Bir iş için yazılan rica mektubu.
rîc'at: Geri dönme, çekilme, kaçma, vazgeçme.
rîc'î: Geri dönmeye ait ve mensub. * üç talakla boşanmamış kadın. Tekrar kocasına dönmesi mümkün olan. Buna talak-ı ric'i denir.
rîcl: Ayak, kadem.
rîcl-ül bahr: Körfez.
rîcle: Semizlik otu.
rîcs: Dinin haram kıldığı şey. Günah, pislik, murdarlık.
rîcz: Azab, vesvese. * Maddi ve mânevi pislik. * Puta tapma.
rîçal: Reçel.
rîçar: Reçel.
rîda: örtü, belden yukarı örtülen şey, çar ve şal. * Akıl. îlim. Seha. * Zinet. Parlaklık veren şey. * Hırka.
rîda-yi memat: ölüm örtüsü.
rîdas: Taş atmak.
rîddet: îslâm dininden dönme. îrtidad. * Doğumdan evvel davarın memesinin süt ile dolu olması.
rîdf: (C.: Erdâf) Arka.
rîdfan: Gece ve gündüz.
rîe (re'): Akciğer.
rîeteyn: îki akciğer.
rîf: (C.: Eryâf) Mâmur, bayındır yer. * Ekini bol ve ucuz olan yer.
rîfa': Ekini tarladan getirip harman yerine ilettikleri vakit.
rîfade: Yara üstüne sarılan bez. * Ziyâfet.
rîfas: Ayakla vurmak, tepmek.
rîf'at: Yükseklik. Yüksek ve büyük rütbe sahibi olmak, âlişan olmak.
rîfd: (C.: Erfâd - Rufud) Atâ, hediye, bahşiş. * Yardım, muavenet.
rîg: Kum. * Toz.
rîh: Rüzgar, yel. * Sızı, romatizma. * Mc: Galebe, kuvvet. Rahmet. * Devlet. Hoş ve iyi şey. * Koku.
rîhal: (Rahl. C.) Deve palanları.
rîhale: At semeri, eyer.
rîhat: Kayış yapımında kullanılan deri.
rîhlet: Geçmek. Göç etmek, göçmek. ölmek.
rîhme: (C.: Ruhum-Rihâm) Yağmur çisintisi.
rîhs: (C.: Revâhıs) Alçak duvar.
rîhte: Dökülmüş, akıtılmış.
rîhte-ger: (C.: Rihte-gerân) Dökmeci.
rîhve: (Ruhve) Rehâvetli, gevşek. * Tecvidde: Harf sükun ile söylenirken sesin akması hâli.
rîhve-î mechure harflerî: Dad, zı, zel, gayın, ze, vav, yâ, elif.
rîhve-î mehmuse harflerî: "Fe, ha, se, he, şın, hı, sad, sin" Bu harflerde sesin kemâli ile nefes birlikte akar. Rehavet ve hems sıfatı, zayıf sıfatlardır, bunun için rehavet sesin kâmilen akmasını, hems de nefesin kâmilen akmasını icabettirir.
rîk: Salya. Ağız suyu.
rîkab: (Rakabe. C.) Boyunduruk altında olanlar. Kullar, köleler. * Boyun, ense kökü.
rîkâb: özengi. * Büyük bir kimsenin huzuru, önü, makamı.
rîkâbdar: Padişahların atla bir yere gidişleri sırasında özengiyi tutmak suretiyle ata binip inmelerine yardım eden kişi.
rîkâbî: Binici, binen.
rîkase: Davar bağlanan yer.
rîkaz: Yer altında bulunan madenler. * Câhiliyet zamanından kalmış gömülü mal.
rîkbe: (C.: Rikeb-Rekebât) Diz. (Diz, insanın ayaklarında olur; dört ayaklının ön ayaklarında olur.)
rîkk: Kulluk, ubudiyet. * Ist: Esir olmuş, hürriyetini kaybetmiş olan ehl-i harb. * Yufka, yumuşak nesne.
rîkk: (C.: Rikâk-Rekâik) Yağmur çisintisi.
rîkkat: Acıma, incelik, yufka yüreklilik. Yumuşaklık.
rîkkat-âmîz: Acıma veren, kalbe hüzün verecek olan, acındıran.
rîkkat-âver: Acıma ve merhamet uyandıran.
rîkkat-engîz: Acıklı.
rîkkat-î cînsîye: Cinsi şefkat. însanın kendi cinsinden olana acıması.
rîkkat-î kalb: Kalb rikkati, kalb yufkalığı.
rîkkat-yâb: Acıyan, merhamet eden.
rîks: Adam topluluğu. * Pis, necis.
rîkz: Gizli söz.
rîm: îrin.
rîm: (C.: Arâyim) Beyaz geyik.
rîma: Atmak. * Atışmak. * Bırakmak.
rîmah: (Rumh. C.) Mızraklar, kargılar, süngüler.
rîmaha (remuh): Tepici davar, tepen davar.
rîmahat: Mızrakçılık sanatı.
rîmak: Nifak, ayrılık. * Darlık.
rîmal: (Reml. C.) Kumlar.
rî'mam: Sevmek.
rîman: Eğilip meyletmek.
rîmayet: Ok, gülle, kurşun gibi şeyleri atmada mâhir olma. Atıcılık.
rîmdîda': Gül.
rîme: çapak.
rîme-î çeşm: Göz çapağı.
rîmm: (Rimme) çürümüş kemik. Kemik çürümesi. * Yer. * çok mal.
rîmme: (C.: Rimem-Rimâm) çürümüş kemik.
rîmnak: Murdar, pis. * îrinli.
rîms: Devenin yediği otlardan ekşi cins bir ot. * Islah etmek, düzeltmek.
rînd: Kalender. Aldırışsız, dünya işlerini hoş gören. * Laübali meşreb feylesof. * Bâtını irfan ile müzeyyen olduğu halde zâhiri sâde görünen hakim. Dış görünüşü laübali olduğu halde, aslında kâmil olan kimse.
rîndân: Kalenderlik. * Rindler.
rîndî: Kalenderlik, rindlik, aldırışsızlık.
rîr: Fâsid, bozuk, yaramaz.
rîs: öfke, gazab, gayz.
rîsaîl: (Bak: Resail)
rîsale: Mektub. * Bir ilme dair yazılmış küçük kitap. * Haber göndermek. * Elçinin götürdüğü mektub, name. * Fık: Bir kimsenin sözünü veya emrini başka birisine tebliğ etmek.
rîsale-î nur: Nurun Risalesi. Kur'an'dan alınan âyetlerin tefsiri ile tahkiki iman dersi veren kitap. Büyük mücahid Bediüzzaman Hazretlerinin eserleri.(Risale-i Nur'un vazifesi:... Hayat-ı ebediyeyi mahveden ve hayat-ı dünyeviyeyi de dehşetli bir zehire çeviren küfr-ü mutlaka karşı, imani olan hakikatlarla, gayet kat'i ve en mütemerrid zındık feylesofları dahi imana getiren kuvvetli bürhanlarla Kur'ana hizmet etmektir. ş.)
rîsalet: Birisini bir vazife ile bir yere göndermek. * Peygamberlik. Büyük kitapla gelen peygamberlik. * Elçilik.
rîsalet-penah: Risaletin kendine istinad ettiği Hazret-i Muhammed (A.S.M.). (Risalet-meab da denir)
rîsalet-ün nur: Risale-i Nur tabirinin Arapçası. (Bak: Risale-i Nur)
rîsar: (C.: Ravâsır) Reçel. * Turşu.
rîsde: însan cemaatı, insan topluluğu.
rîse: Miras yemek.
rîsl: Vakar, ciddiyet, sekinet. * Sabır.
rîsm: Kırmak. * Bulaştırmak.
rîsman: îp, halat.
rîsman-bâz: îp oynayan. * Mc: Cambaz.
rîş: Yara. * Yaralı. * Tüy. Kıl. Kuş kanadı. * Sakal.
rîş (rîyâş): çok pahalı elbise.
rîşa: (Rişvet. C.) Rüşvetler.
rîşa': (C.: Erşiye) Kuyudan su çekmekte kullanılan urgan. * Menazil-i Kamer'den "Balık karnı" dedikleri menzilin adı.
rîşaş(e) : Döküntü, serpinti.
rîşbüz: Keçi sakalı gibi sivri olan sakal.
rîşdar: Sakallı.
rîşdet: Doğruluk, dürüstlük. Temizlik.
rîşe: Saçak, püskül.
rîşe-gîr: Kökleşmiş, kök tutmuş.
rîşhand: Bıyık altından gülme. Alay.
rîşsaz: Cerrah.
rîştab: Kıvırcık saç ve sakal.
rîşte: Tel, iplik, hayt.
rîşte-füruş: îplik satan. îplikçi.
rîşte-î hürmet: Sevgi, hürmet bağı.
rîşvet: Bir işi yapmak veya bitirmek için haksız yere alınan mal veya para. (Bak: Rüşvet)
rîşvet-hâr: Rüşvet yiyen.
rîtam: (Retime. C.) Bir şeyi hatırlayabilmek için parmağa bağlanan iplikler.
rîtîc: çıkmaz yol. Yasak olan şey. Haram.
rîtl: (Retl) Hoş, lâtif, pâkize şey.
rîtm: (Reythme) Fr. Mısra ve cümlelerdeki ses uygunluğundan gelen iç âhengi. Duygunun ses hâline gelişi. * Müvazeneli ve tenasüblü hareket.
rîtmîk: ölçülü, âhenkli.
rîv: Hile, düzen.
rîva: (Reyyân. C.) Suya kanmış olanlar.
rîva': (C.: Erviye) Deve üstünde yük bağlanılan ip.
rîvad: Talep etmek, istemek, arzulamak.
rîvak: (Bak: Revak)
rîvayat: (Rivâyet. C.) Rivayetler.
rîvayet: Hikâye edilen hâdise veya söz. * Bir hâdisenin başkalarına anlatılması. * Peygamberimiz'den (A.S.M.) işittiklerini veya sahabeden duyduklarını birisinin başkasına anlatması. * Kuyudan halk için su çekmek.(Eğer denilse: Resül-i Ekrem Aleyhissalâtü Vesselâm'ın her hal ve hareketini kemal-i ihtimam ile Sahabeler muhafaza ederek nakletmişler. Böyle mu'cizat-ı azime, neden on-yirmi tarik ile geliyor? Yüz tarik ile gelmeli idi. Hem neden Hazret-i Enes, Câbir, Ebu Hüreyre'den çok geliyor; Hazret-i Ebu Bekir ve ömer az rivayet ediyor?Elcevab: Nasılki insan, bir ilâca muhtaç olsa, bir tabibe gider; hendese için mühendise gider, mühendisten nakleder; mes'ele-i şer'iyye, müftüden haber alınır ve hâkezâ.. öyle de, sahabe içinde, ehadis-i Nebeviyeyi, gelecek asırlara ders vermek için, ulemâ-i sahabeden bir kısım, ona mânen muvazzaf idiler. Bütün kuvvetleriyle ona çalışıyorlardı. Evet Hazret-i Ebu Hüreyre, bütün hayatını, hadisin hıfzına vermiş; Hazret-i ömer, siyaset âlemiyle ve hilafet-i kübra ile meşgul imiş. Onun için, ehâdisi, ümmete ders vermek için, Ebu Hüreyre ve Enes ve Câbir gibi zatlara itimad edip; ondan, rivayeti az ederdi. Hem mâdem sıddık, saduk, sâdık ve musaddak bir sahabenin meşhur bir namdarı, bir tarik ile bir hâdiseyi haber verse; yeter denilir, başkasının nakline ihtiyaç da kalmaz. Onun için bâzı mühim hâdiseler, iki-üç tarik ile geliyor. M.)
rîvayet-î sâdika : Senet ve delillerle sâbit, şüphesiz, doğru rivâyet.
rîvayetkerde: Söylenilen. Rivayet edilen.
rî'y: Hey'et. * Güzel halet, iyi hal. * Güzel elbise.
rîya: özü sözü bir olmamak. înandığı gibi hareket etmeyiş. îki yüzlülük etmek. Gösteriş için yapılan hareket. (Bak: îhlâs)
rîyad: Ot aramak.
rîyah: (Rih. C.) Rüzgârlar, yeller. * Letaif ve in'amlar. * Mc: Galebe, kuvvet, rahmet, devlet. * Mazarrat.
rîyakâr: Riya eden. Adam kandırmak için yalan söyleyen. Sahte iş yapan. îki yüzlü.
rîyakârâne: îkiyüzlülükle. Riyakârlıkla.
rîyaset: Reislik. Bir işi idarede başta bulunmak. Başkanlık.
rîyasetpenah: Başkanlık makamında bulunan. Başkanlık eden, başkan olan. Reislik yapan.
rîyaz: (Ravza. C.) Bahçeler. Ağaçlık, çimenlik yerler. Yeşil bahçeler.
rîyaz-i cennet: Cennet bahçeleri.
rîyazat: (Riyazet. C.) Nefsi terbiye maksadıyla az gıda ile geçinmek, nefsini hevesattan men' ile faydalı fikir ve işle meşgul olmak.
rîyazet: Nefsi kırma. Fani şeylerden nefsini çekerek kanaat içinde yaşamak. * Bir hastalıktan dolayı veya nefsini terbiye maksadıyla çok yemek ve içmeyi terkederek faydalı fikirlerle, ibadet ve ilimle meşgul olmak. Az gıda ile yaşamak. * îdman.
rîyazet-î bedenîye: Cimnastik. Bedeni riyazet.
rîyazî: Hesap ve hendeseye dair. Matematiğe dair.
rîyazîyat: Matematik ilmi, hesap-hendese ilmi. Aritmetik-geometri.
rîyazîyat-i âlîye: Yüksek matematik.
rîyazîye: Hesap ilmi. Matematik bilgisi. Hesapla alâkalı. * Bir yazı çeşidi.
rîyazîyyun: (Riyazi. C.) Matematik âlimleri.
rî'ye: (C.: Riin) Sihir.
rîyeb: (Ribet. C.) şüpheye düşmeler.
rîz: Döken, saçan, akıtan.
rîzam: Serkeş adam veya at.
rîzam: Kabile, kavim, topluluk.
rîzan: Akan, dökülen.
rîze: Döküntü, kırıntı. Ufak parça.
rîze rîze: Parça parça, ufak ufak.
rîzeçîn: Kırıntı ve döküntü toplayan.
rîzehâr: Kırıntı ve döküntü yiyen.
rîzehor: Kırıntı, döküntü yiyen.
rîzîş: Akış, dökülüş.
rîzme: Esvap koyulan bohça.
rîzne: Su toplanacak yer.
rîzz: Gizli ses.
robot: Fr. Elektrikle veya mekanik yollarla hareket ettirilerek çeşitli işler yaptırılabilen otomatik cihaz.
rol: Fr. Oyun. Sahnede gösterilen oyun hareketlerinden her bir oyuncuya düşen kısım.
roman: Hayali veya hakiki, kitap halinde yazılmış büyük hikâye. * Eski Roma devletinin diline de Roman denirdi.(Edebsizlenmiş edeb, "müsekkin hem münevvim" hakiki fayda vermez. Tek bir ilâcı bulmuş o da romanları imiş.Kitab gibi bir hayy-ı meyyit, sinema gibi bir müteharrik emvat! Meyyit hayat veremez...Hem tiyatro gibi tenasuhvari, mâzi denilen geniş kabrin hortlakları gibi şu üç nevi romanları ile hiç de utanmaz. Beşerin ağzına yalancı bir dil koymuş. Hem insanın yüzüne fâsık bir göz takmış. Dünyaya bir alüfte fistanını giydirmiş. Hüsn-i mücerred tanımaz... Lemaat)
roman-vârî: Roman gibi hayali olabilen. Hakikatla alâkası olmayan veya az olan.
romörk: Fr. Denizde veya karada başka bir vasıta tarafından çekilen motorsuz taşıt.
rota: Vapur ve gemilerde istikamet yolu. Geminin seyir yolu.
rovelver: Fr. (Aslı: Revolver-Lüverver) Tabanca. Küçük silâh. Toplu tabanca. Altı patlar denilen, altı mermi alan tabanca.
röntgen: Röntgen adında bir Alman âliminin 1896' da keşfettiği ışıklar. Bunlar gözle görülmediği halde fotoğraf camına tesir eder, vücuddan, tahta, kâğıt gibi maddelerden bu ışık geçebilir. Bazı hastalıkların teşhis ve tedavisinde de kullanılır. * Vücuddaki iç uzuvların filmini çekmek.
röportaj ©: Fr. Bir gazete muharririnin gördüklerini anlatan yazısı.
ru: Olan, biten manalarında birleşik kelimeler yapılır. Meselâ: Hod-ru: Kendiliğinden.
ru': Kalb, fuad. Kalbde korku ârız olacak yer. * Zihin ve akıl.
ru (ruy): Yüz, cihet. Sebep. çehre.
ru-mal: Yer süren.
ru-nüma: Yüz gösteren, meydana çıkan. * Yüz görümlüğü.
ru-nümun: Meydana çıkan, yüz gösterici.
ru-puş: Yüz örtüsü, peçe. * Yüz örten.
ru-sîyah: Kara yüzlü. Ayıbı olan.
ru-şînas: Bilen, tanıyan.
ru-şînasî: Aşinâlık, tanırlık.
ru-zerd: Sararmış, sarı yüzlü.
ruaf: Burun kanaması.
ruam: Burun suyu, sümük. * Sakağı (mankafa) hastalığı.
ruama: çekirge çokluğu.
ruat: (Râi. C.) çobanlar.
ru'b: Korku, havf. Korkudan dolayı iş ve hareketten kesilmek. Korkutmak. * Kesmek. * Sihir, büyü, efsun.
ru'b: Sütün yoğurt olması.
rub: Süpürge. * Süpürme.
rub': Dörtte bir. Bir şeyin dört kısmından bir kısmı.
rub'-i daîre: Dairenin dörtte biri.
rub'-î meskûn: Dünyanın kara olan dörtte bir kısmı.
ruba: (Bak: Rüba)
rubah: (Rubeh) Tilki. * Mc: Kurnaz, hilekâr.
rubaî: (Bak: Rübai)
rubaî-î mezîd: Kendisine harf ilâve edilmiş olan aslı dört harfli mastar.
rubb: Meyva suyu.
rubban: Kaptan.
rubbe: Gr: Harf-i cerdir, nekre ile beraber olur. çokluk veya azlığa işaret eder. "öylesi var ki" mânâsındadır.
rubbema: (Rubbe-mâ) Bâzan, bâzı kere.
rubehane: Kurnazca, tilkicesine.
rubehî: Kurnazlık. Tilkilik.
ruberah: Gitmeğe hazır, yüzü yola doğru.
ruberu: Yüzyüze.
rubh: Deve yavrusu. * Bir kuşun adı. * îç yağı.
rubu': (Rub'. C.) Dörtte birler. * Metrenin kabulünden evvel ipekli, yünlü, basma ve emsali kumaş, bez ve sairenin ölçülmesinde kullanılan çarşı arşınının kesirlerinden birinin adıdır.
ru'bub: Zayıf, korkak kişi.
rububîyet: Cenab-ı Hakk'ın her zaman her yerde her mahluka, muhtaç olduğu şeyleri vermesi, terbiye ve tedbir etmesi ve mâlikiyyeti ve besleyiciliği keyfiyyeti. * Artırmak. Ziyade kılmak.(Ey gözleri sağlam ve kalbleri kör olmayan insanlar, bakınız! însan âleminde iki daire ve iki levha vardır. Birinci daire: Rububiyyet dairesidir. îkinci daire: Ubudiyyet dairesidir. Birinci levha, hüsn-ü san'attır. îkinci levha ise tefekkür ve istihsandır. Bu iki daire ile iki levha arasındaki münasebete bakınız ki, ubudiyet dâiresi bütün kuvvetiyle rububiyyet dairesi hesabına çalışıyor. Tefekkür, teşekkür, istihsan levhası da bütün işaretleri ile hüsn-ü san'at ve nimet levhasına bakıyor. Bu hakikatı gözün ile gördükten sonra rububiyet ve ubudiyyet dairelerinin reisleri arasında en büyük bir münasebetin bulunmamasına aklınca imkân var mıdır? Ve Sâniin makasıdına kemal-i ihlas ile hizmet eden ubudiyet reisinin Sâni' ile azim bir münasebatı ve kavi bir intisabı ve o intisab ile her iki daire reisleri arasında bir muârefe ve mükâleme ve alış verişin olmamasına ihtimal var mıdır? öyle ise, bilbedahe tahakkuk etti ki; Ubudiyyet Reisi, Rububiyyetin hâss mahbub ve makbulüdür. M.N.)
rububîyyet-î mutlaka: Herşeyi kaplayan ve idaresi altına almış olan Allah'ın rububiyeti.(Evet bütün kâinatta hususan zihayatlarda ve bilhassa terbiye ve iaşelerinde her tarafta aynı tarzda ve umulmadık bir surette beraber ve birbiri içinde hakimâne, rahimâne bir dest-i gaybi tarafından olan bir tasarruf-u âmm elbette bir Rububiyyet-i mutlakanın tereşşuhudur ve ziyasıdır ve tahakkukuna bir bürhan-ı kat'idir. Madem bir Rububiyyet-imutlaka vardır; elbette şirk ve iştirâki kabul etmez. çünkü, o Rububiyyetin kendi cemâlini izhar ve kemâlâtını ilân ve kıymetli san'atlarını teşhir ve gizli hünerleri göstermek gibi en mühim maksad ve gayeleri cüz'iyyatta ve zihayatta temerküz ve içtimâ' ettiğinden en cüz'i bir şeye ve en küçük bir zihayata kendi başı ile müdahale eden bir şirk, o gayeleri bozar ve o maksatları harab eder. Ve zişuurun yüzlerini o gayelerden ve o gâyeleri irade edenden çevirip esbaba saldığından ve bu vaziyet Rububiyyetin mahiyetine bütün bütün muhâlif ve adavet olduğundan elbette böyle bir Rububiyyet-i mutlaka hiçbir cihetle şirke müsaade etmez. ş.)
rubuz: Koyun, sığır, at, katır ve köpeğin ayaklarını büküp yatması. (Yattıkları yere "merbaz" derler)
rubz: Her nesnenin ortası. * Bazısı bazısının üzerine sağılmış süt.
rud: Irmak, çay. * Saz teli, saz kirişi. * Kemençe.
rud: Yavaş yürümek.
rud-averd: Nehir sularının akarlarken etraftan sürükleyip getirdikleri ağaç, dal gibi şeyler.
ruda': Hastalığın insana yine dönmesi. * Gövde ve beden ağrısının her birisi.
rudaa': (Radi. C.) Süt emen çocuklar. * Süt kardeşler.
rudab: Ağızdan akan su.
rudbar: Irmak kenarı. * Büyük ırmak.
rudda': (Râdı. C.) Süt emenler.
rude: (C.: Rudegân) Bağırsak.
rudha: Perde, setre.
rudsaz: çalgıcı.
rufse: Su nöbeti.
rufud: (Rifd. C.) Bahşişler.
ruga': Sada, ses. * Deve, sırtlan ve deve kuşunun bağırması.
rugba': Rağbet etmek, istemek, arzulamak.
rugerdan: Yüz döndüren, yüz çeviren.
rugl: Bir acı ot. * Sünnetsizlik. * Bol olmak, bolluk.
ruh: Yanak, yüz, çehre. * Arabçada: Efsânevi bir kuş. (Bak: Ruhsâr)
ruh: Can, nefes, canlılık. * öz, hülâsa, en mühim nokta. * His. * Kur'an. * îsa (A.S.). * Cebrail (A.S.). * Korkmak. (Bak: Vicdan)(Ruh, bir kanun-u zivücud-u haricidir. Bir namus-u zişuurdur. Sabit ve dâim fıtri kanunlar gibi, ruh dahi âlem-i emirden, sıfat-ı iradeden gelmiş, kudret ona vücud-u hissi giydirmiştir. Bir seyyale-i lâtifeyi o cevhere sadef etmiştir. Mevcud ruh, mâkul kanunun kardeşidir. îkisi hem dâimi, hem âlem-i emirden gelmişlerdir. şâyet, nevilerdeki kanunlara kudret-i ezeliye bir vücud-u harici giydirseydi, ruh olurdu. Eğer ruh, şuuru başından indirse yine lâyemut bir kanun olurdu. H.)(Ruha bir derece müşabih ve ikisi de âlem-i emirden ve iradeden geldiklerinden masdar itibariyle ruha bir derece muvafık, fakat yalnız vücud-u hissi olmayan nevilerde hükümran olan kavânine dikkat edilse ve o namuslara bakılsa görünür ki: Eğer o kanun-u emri, vücud-u harici giyse idi, o nevilerin birer ruhu olurdu. Halbuki o kanun dâima bakidir. Dâima müstemir, sabittir. Hiçbir tegayyürat ve inkılâbat, o kanunların vahdetine te'sir etmez, bozmaz. Meselâ: Bir incir ağacı ölse, dağılsa; onun ruhu hükmünde olan kanun-u teşekkülâtı, zerre gibi bir çekirdeğinde ölmeyerek baki kalır. îşte madem en âdi ve zaif emri kanunlar dahi böyle beka ile devam ile alâkadardır. Elbette ruh-u insani, değil yalnız beka ile, belki ebed-ül âbâd ile alâkadar olmak lâzım gelir. çünki: Ruh dahi Kur'an'ın nassı ile: $ ferman-ı celili ile âlem-i emirden gelmiş bir kanun-u zişuur ve bir namus-u zihayattır ki: Kudret-i Ezeliyye, ona vücud-u harici giydirmiş. Demek, nasılki sıfat-ı iradeden ve âlem-i emirden gelen şuursuz kavânin, dâima veya ağleben baki kalıyor. Aynen onların bir nevi kardeşi ve onlar gibi sıfat-ı iradenin tecellisi ve âlem-i emirden gelen ruh, bekaya mazhar olmak daha ziyade kat'idir, lâyıktır. çünki: Zivücuddur, hakikat-ı hariciye sahibidir. Hem onlardan daha kavidir, daha ulvidir. çünki: Zişuurdur. Hem onlardan daha daimidir, daha kıymetdardır. çünki: Zihayattır. S.)
ruh-bahş : Ruh veren, ruh bahşeden.
ruh-efza: Cana can katan. Canlılık veren. (Ruhfeza da denir)
ruh-u revan: Ruhun zuhuru. Ruhun ferahlığı. Ruhun akışı.
ruh-ül emîn (ruh-ül kudüs): Cebrail Aleyhisselâm'ın iki ayrı ismi. Emin ve mukaddes ruh. * Allah'ın ism-i azamı. * încil. * Kur'an.
ruha: Ferahlık. * Yumuşak rüzgâr.
ruham: Mermer.
ruham-i hâm: îşlenmemiş mermer.
ruhama: (Rahim. C.) Rahim olanlar.
ruhamî: Mermerden yapılmış. Mermerle ilgili.
ruhanî: Cisim olmayıp gözle görülmeyen cin ve melâike gibi bir mahluk. Ruha ait. Ruhtan meydana gelmiş, melek. * Madde ile alâkalı olmayan, mânevi, ruh âlemine mensub olan.
ruhanîyyat: Madde âleminden başka olan ruh âlemleri, ruhaniler. (Bak: Cinn, Melek)(şu nihayetsiz feza-yı âlem ve şu muhteşem semavat; burçları ile, yıldızları ile; zişuur, zihayat, ziruhlarla doludur. Nârdan, nurdan, ateşten, ışıktan, zulmetten, havadan, savttan, rayihadan, kelimattan, esirden ve hattâ elektrikten ve sâir seyyâlât-ı lâtifeden halk olunan o zihayat ve o ziruhlara ve o zişuurlara şeriat-ı garra-i Muhammediye Aleyhissalâtü Vesselâm, Kur'an-ı Mu'ciz-ül Beyan, "Melâike ve cânn ve ruhaniyattır" der, tesmiye eder. Melâikenin ise, ecsamın muhtelif cinsleri gibi, cinsleri muhteliftir. Evet, elbette bir katre yağmura müekkel olan melek, şemse müekkel meleğin cinsinden değildir. Cin ve ruhaniyat dahi, onların da pek çok ecnas-ı muhtelifeleri vardır. S.)
ruhanîyyet: Yalnız ruhtan ibaret olan şeyin hali. ölmüş bir kimsenin devam etmekte olan ruhi kuvveti. * Ruhanilik.
ruhanîyyun: (Ruhani. C.) Ruh âlemine mensub olanlar. âlem-i gayba nüfuz eden çok nuraniyet kazanmış zâtlar.
ruhas: (Ruhsat. C.) îzinler, ruhsatlar, müsaadeler.
ruhasa': Sıtma teri.
ruhb: Genişlik, vüs'at.
ruhban: Korkmak, çekinmek, yılmak. * Rahib, Hristiyan din adamı. (Bak: Rehbaniyyet)(Hâsıl-ı kelâm; biz Kur'an şâkirdleri olan Müslümanlar, bürhana tâbi' oluyoruz. Akıl ve fikir ve kalbimizle hakaik-i imaniyeye giriyoruz. Başka dinlerin bazı efradları gibi, ruhbanları taklid için bürhanı bırakmıyoruz. Onun için akıl ve ilim ve fennin hükmettiği istikbalde elbette, bürhan-ı akliye istinad eden ve bütün hükümlerini akla tesbit ettiren Kur'an hükmedecek. Hutbe-i şâmiye)
ruhbanîyet: (Bak: Rehb, Rehbaniyet)
ruhda': Sıtma.
ruhî: Ruha ait, ruhla ilgili. Ruhça.
ruhîyat: Ruh ilmi, psikoloji.
ruhlet: Göçüp giden kimseler.
ruhperver: Ruha ferahlık ve kuvvet veren.
ruhs: Ucuzluk. * Hafif pahalı olmak.
ruhsar (ruh): Yanak. çehre. Yüz.
ruhsat: (C.: Ruhas-Ruhsat) îzin, müsaade. * Genişlik. * Kolaylık. * Fık: Kulların özürlerine mebni, kendilerine bir suhulet ve müsaade olmak üzere, ikinci derecede meşru' kılınan şeydir. Sefer halinde Ramazan-ı şerif orucunun tutulmaması gibi. Vuku' bulan ikraha mebni, birisinin malını itlaf etmek de bu kabildendir ki, bu halde bu itlaf hakkında bir ruhsat-ı şer'iyye bulunmuş olur. Bir hâdisede, azimet ile ruhsat içtima' edince, azimet tarikını iltizam etmek, bir takva nişanesi sayılır. (Bak: Azimet)
ruhsât: (Ruhsat. C.) Ruhsatlar, müsaadeler, izinler.
ruhsatîyye: San'at veya ticaret için verilen izin kâğıdı.
ruhsatname: îzin kağıdı.
ruhsatyâb: îzin ve müsaade alma.
ruhud: Etli, besili, şişman, semiz. (Müe: Ruhude)
ruhul: Binmek için kullanılan deve.
ruhullah: Allah'ın emriyle meydana gelen. * îsa Aleyhisselâm'ın bir lakabı.
ruhum: Esirgemek, korumak, rahmet.
ruhve: (Bak: Rihve)
ruk'a: (C.: Rıka'-Ruka') Kısa mektub. * üzerine yazı yazılan kâğıt veya deri parçası. * Dilekçe. * Yama.
rukaba': (Rakib. C.) Bekçiler.
rukad: Uyku, nevm. Uyuma.
rukak: Yufka ekmeği.
rukba: Muntazır olmak, beklemek. * Bir kimseye, "Ben senden evvel ölürsem bu elbiseler senin olsun, eğer sen evvel ölürsen yine benim olsun" demek.
rukde: Uyuma. * Berzah âlemi. (Bak: Rukud)
rukk: (C.: Rikâk) Yer, arz.
rukta: Siyah bir maddenin üzerinde yer yer beyaz beneklerin olması.
rukud: Uyuma, nevm.
rukum: (Rakam. C.) Rakamlar.
rukye: (C.: Rukâ) Duâ, efsun.
rum: Anadolu. * Osmanlı Devleti ve Arabistan hârici yerler. * Romalı.
rum suresî: Kur'an-ı Kerim'in 30. suresidir. Mekkidir.
rumelî: Osmanlı împaratorluğunun Avrupa Kıt'asındaki kısmı.
rumh: (C.: Rimah-Ermâh) Süngü. Mızrak. Saban kolu. Mc: Fakirlik.
rumî: Rumelinden olan, Anadolulu olan. * Rum. Türkiye'de yaşayan Yunanlı.
rumman: Nar. (Bir meyva adı)
rumus: (Rems. C.) Mezarlar, kabirler.
rumuz: (Remz. C.) îşaretler, remizler, ince nükteler, mânası gizli olan işaretler.
rumuzât: (Rumuz. C.) Remizler, işaretler.
rusde: (C.: Risâd) Ziynet, süs.
rusg: Bilek.
rusg-ül kadem: Ayak bileği.
ruspî: Fâhişe, orospu.
rusta: Köy, karye.
rustaî: Köylü.
rustak: (C.: Resâtik) Köy, karye. çiftlik.
rustakî: Köylü.
ruşen : Parlak, aydın. Belli, âşikâr.
ruşenbeyan: Fasih konuşan. Açık ifadeli.
ruşendîl : Kalbi nurlanmış. Kâmil ve çok temiz dindar.
ruşengîr: Cilâcı, parlatıcı.
ruşenî: Açıklık, aydınlık. * Belli olma.
ruşenzamîr : Hakikatları bilen. Kalbi, gönlü hakikatlara vakıf olan.
rutab: Hurma.
rutb: Yaş ot.
rutebî: Rütbelere ait.
rutube: (C.: Rutebât-Ruteb) Olmuş yaş hurma.
rutubet: Yaşlık, nem, ıslaklık. * Havadaki veya yapı içindeki nem.
ruud: (Ra'd. C.) Gök gürültüleri.
ruunet: însana ağır gelecek hâllerde bulunma. * Sünepelik, bönlük.
ruval: Salya.
ruvat: (Râvi. C.) Hikâye edenler. Rivayet edenler.
ruy: (Bak: Ru)
ruy: Tunç.
ruy-î derya: Denizin yüzü.
ruy-î hub: Güzel yüz.
ruy-î zemîn: Yeryüzü.
ruy-î zîşt: çirkin yüz.
ruy-ver: Tunçtan.
ruya: Yerden biten (bitki).
ruyîn: Tunç. * Tunçtan. 
ruyîn-ten: Güçlü kuvvetli, tunç vücutlu.
ru'z: (C.: Erâz) Okun, demirini sokacak yeri.
ruz: Gün, 24 saatlik müddet. * Gündüz.
ruz u şeb: Gece ve gündüz.
ruz-efzun: Uzun ömürlü.
ruz-î ceza: Kıyamet günü. * Haşir günü.
ruz-î haşîr : (Ruz-i hesab) Kıyamet günü. * âhiretteki toplanma günü. Haşir günü. Dirilip toplanıp hesap görülecek gün. (Bak: Yevm)
ruzaa': (Razi. C.) Süt emen çocuklar. * Süt kardeşler.
ruzan: (Ruz. C.) Günler. Gündüzler. 
ruzane: Gündelik. Yevmiye.
ruzban: Kapıcı.
ruzberuz: Günden güne.
ruze: Oruç.
ruzedâr: Oruçlu.
ruzegüşa: Oruç bozan, oruç açan, iftar eden.
ruzehar: Oruç yiyen. Oruçsuz.
ruzî: Azık, rızık. Nasib, kısmet. * Gündüzle alâkalı. Gündüze âit.
ruzîhâr: Rızık yiyici. Canlı, mahlûk.
ruzîne: Gündelikçi.
ruzîresan: Rızık yetiştiren, rızık ulaştıran, Allah (C.C.)
ruzmerre: Her günkü. Her günlük.
ruzname: Vakit cetveli, takvim. * Günlük gazete, günlük hâdiselerin yazıldığı kâğıt. * Bir meclis veya hey'etin müzakerat proğramı. * Hergünkü gelir ve giderin kaydedilip yazıldığı defter.
rüavî: Köy yakınında ve halk yöresinde güdülen deve.
rüba: Kapan, çalan, alan (mânâsına birleşik kelimeler yapılır). Meselâ: Dil-rüba $: Gönül kapan, gönül alan. îz'an-rüba $: Aklı alan, hayret veren.
rüba: (C.: Ravâbi) Tepe, yüksek yer.
rübaî: Dörtlük olan. Dörtle ilgili. * Edb: Dört mısralık belli vezinlerle yazılmış manzume. Aynı esasta 24 şekilli vezinle yazılan 4 mısralık şiir. * Gr: Mastarını meydana getiren dört harften hepsi de asli olan kelimeler.
rübb: (C.: Rubub) En aşağı derece ile pişmiş ve üçte birinden azı gitmiş olan sıkılmış üzüm.
rübba: (C.: Ribâb) Yakında doğurmuş koyun.
rübbah: Erkek maymun.
rübbema: (Bak: Rubemâ)
rübd: Kılıcın cevheri ve rengi.
rübde: Siyaha yakın boz renk.
rü'be: (C.: Rüâb) Ağaç parçası.
rübubîyet: (Bak: Rububiyet)
rübud: Dâim. * Yüreğin oynaması. * Durdurmak. * Hapsetmek.
rübude: Kapılmış, kapılan.
rübye: (C.: Rubâ) Arz haşeratından bir cins. * çok, ziyâde.
rüc'a: Rücu' mânâsına mastar.
rücbe: Canavar avlamak için yapılan yer. (îçine iple et bağlarlar ki canavar gelip yapıştığı gibi üzerine düşer.)
rüceme: (C.: Rucâm-Rucum) Büyük taş.
rüchan: üstünlük, yükseklik, üstün olma. Fazilet, haslet veya her hangi bir şey cihetiyle diğerinden üstün olmak.
rüchanîyet: üstün oluş, rüçhanlık, daha mühim olma hali.
rücu': Geri dönme, vazgeçme, cayma. Sözünden dönme. * Edb: Bir fikri daha kuvvetli anlatmak için söylenilen sözden caymış gibi görünmek.
rücum: (Recm. C.) Taşa tutmalar, taşlamalar.
rücun: Mahbus olmak, hapsolunmak. * Bir yere durmak.
rücz (rîcz): Devenin mak'adında olan bir hastalık. * Pis, necis. * Azap. * Put, sanem.
rüdab: Ağızdan akan su, salya.
rüdn: (C.: Erdân) Kaftan ve gömlek yeninin koltuktan tarafı.
rüdum: (Redm. C.) Bendler, sedler.
rüesa: (Reis. C.) Reisler, reislik yapanlar. Başkanlar.
rüfaî: Ahmed-i Rüfai tarikatına mensub.
rüfat: Parçalanmış, dağıtılmış. * çürümüş.
rüfaz: Müteferrik. dağılmış, parçalanmış.
rüfeka: (Refik. C.) Arkadaşlar.
rüfka: (C.: Rifâk) Yoldaş olan, aynı fikirde olan cemaat. 
rüft: Süpürme.
rüft: Bir küçük canavar. ("înâk-ul arz" da derler)
rüful: Sallanmak. * Gururlanmak, tekebbürlenmek.
rüha: Urfa şehri.
rühavî: Urfa'lı.
rühşuş: Sütlü deve.
rühun: (Rehin. C.) Rehinler.
rühus: çok yiyen obur, ekvel.
rükam: Yığın. Birbiri üzerine kat kat yığılmış olan.
rükban: (Râkib. C.) Biniciler, binenler, binmişler.
rükbe: (C.: Rükeb-Rükebât) Diz. Dizkapağı.
rükeb: (Rükbe. C.) Dizler, dizkapakları.
rükkab: (Râkib. C.) Biniciler, ata binenler.
rükn: Direk. Esas. * Kuvvet. * Bir şeyin en fazla sağlam olan tarafı veya köşesi veya temeli. * Bir cemaatin ileri gelenlerinden olan. * Nüfuzlu, kuvvetli ve ehemmiyetli kimse.
rükn-ü dâhîlî: îçteki esas unsur. Namazın içindeki farz ve şart olan esas.
rükû': Huzur-u îlâhide eğilmek. Namazda elleri dize dayamak suretiyle yere doğru eğilirken baş ile sırtı düz hale getirmek.
rükub: Binme. * Bir vasıtaya binme.
rükud: Durgunluk. Durgun olma.
rükud-î heva: Havanın durgun olması.
rükudet: Durgunluk, durulma.
rükun: Bir şeye samimi olarak meyletme. Can ve gönülden meyil.
rükunet: Ağırbaşlılık. Vakar ve temkin sâhibi olma.
rükuz: Seğirtmek, koşmak.
rüküb: (Rikâb. C.) üzengiler.
rükün: (Bak: Rükn)
rümam: Kuru ot.
rümh: (C.: Rimâh) Mızrak, kargı, süngü. * Mc: Yoksulluk, fakirlik.
rümîs: Sözüne güvenilmeyen kimse. Verdiği söze itimad edilmeyen kişi.
rümle: (C.: Ermal-Rumul) Siyah hat.
rümman: Nar denilen yemiş.
rümmane: Kapan taşı. * Kırkbayır.
rümme: (C.: Rumem-Rumam) Eskimiş urgan parçası.
rümuk: Durmak. * îkamet etmek, oturmak, mukim olmak.
rümye: Ağaçtan nakşolmuş bir suret.
rüs': Göz kapağında olan hastalık.
rüsela: (Resül. C.) Resüller, peygamberler.
rüsg: (C.: Ersâg) Bilek. * Hayvanların tırnağıyla baldırı arasında olan incecik yer.
rüsta-hîz: Mahşer, kıyamet.
rüstaî: (Rüstâyi) Köyle ilgili. * Köylü.
rüstak: (C.: Resâtik) Büyük köy.
rüste: "çıkmış, bitmiş, yetişmiş" anlamlarına gelir ve birleşik kelimeler yapılır. Meselâ: Nev-rüste $: Yeni yetişmiş bitki.
rüstem: şark edebiyatında kuvvet ve cesaretin timsali olarak bilinen ve Zaloğlu Rüstem diye veya "Rüstem-i Sistani" nâmiyle meşhur îran'lı bir kahramandır. 
rüstî: üstünlük, muvaffakıyet. * Yiğitlik. * Kuvvet.
rüsub: Kab içinde kalan su. * Suyun dibine batmak. * Tortu, dibe çöken, çöküntü.
rüsubat: çöküntüler, tortular. 
rüsuh: îlim ve fennin derinliğine vukufiyet. Sağlamlık. Devamlılık. Yerinde, sağlam, sâbit ve devamlı olmak. * Meharet, meleke.
rüsuhîyet: Rüsuhluluk, rüsuhlu oluş.
rüsum: Resimler, şekiller. âdetler. Vergiler, gümrükler, gümrük vergisi. * Merasim, usûl.
rüsumat: (Rüsüm. C.) Gümrük idâresi.
rüsül: (Resül. C.) Peygamberler, resüller. Bir kitapla gelen nebiler.
rüsva: (Rüsvay) Rezil, kepaze, maskara, ayıpları meydana çıkarılmış.
rüsva-yi âlem: En aşağılık ve âdi adam.
rüsvayî: Rezillik, itibarsızlık, haysiyetsizlik.
rüsve: Muhkem ve sağlam olmak. * Sâbit olmak.
rüşa: (Rişvet. C.) Rüşvetler.
rüşd: Doğru yol bulup bağlanmak. Hak yolunda salabet, metanet ve kemal-i isabetle dosdoğru gitmek. * Hayra isabet etmek. * Büluğa ermek. * îstikamette olmak. Dinine ve malına zarar gelecek şeyi bilmek, doğru düşünmek. * Kişinin akıl ve idraki kavi ve tedbiri metin olmak. (Bak: îrşâd)
rüşd ü îrşad : Rüşd ve irşad. Doğru yola sevketmenin mükemmeliyeti. îslâmiyeti en mükemmel şekilde öğretmek.
rüşdî: Rüşdle ilgili. Olgunluğa dair.
rüşdîye: Eskiden orta tahsil derecesindeki mektep. * Rüşde dair.
rüşeda: (Reşid. C.) Reşid olanlar. Rüşd, olgunluk sâhibleri.
rüşeym: Rahimde yavrunun bütün azalarının teşekkül etmiş şekli. (Harekete başlayan rüşeyme, cenin denir)
rüşvet: Kanunen bir iş gördürmek gayesi ile vazifeli olan kimseye, gayr-i meşru olarak verilen para vesâir menfaat ve fayda.
rütbe: Basamak, derece. * Memuriyet derecesi. * Sıra. Mertebe, menzile. * Efkârın sonu. * Merdiven ayağı.
rütbe-î akl: Aklın derecesi. 
rütbeşînas: Derece bilir. Rütbe tanır.
rüteb: (Rütbe. C.) Rütbeler, dereceler.
rüteb-î askerîye: Askerlik rütbeleri.
rütebî: Rütbeye dair ve rütbelere mensub.
rütte: Pelteklik, kekemelik.
rütte': Otlayan hayvan.
rütub: Sâbit olmak, kaim olmak, devamlılık, süreklilik.
rüus: (Re's. C.) Re'sler. Başlar. Kafalar.
rüüd: Genç kadın. Kız.
rüval: Salya, ağız suyu.
rüveyde: (Rüvide) înce, hoş, nazik. * Bitmiş, neşvünema bulmuş.
rüveyha: Zariflik, incelik.
rüya: (Rü'ya) Uykuda görülen misali âlem. Düş.(Hayalâtlara karşı kapısı açık olan rüyaları tahkiki bir surette mevzubahs etmek, tahkik mesleğine tam uygun gelmediğinden; o cüz'i hâdise-i nevmiye münasebetiyle, mevtin küçük bir kardeşi olan nevme ait ilmi ve düsturi olarak altı nükte-i hakikatı, âyât-ı Kur'aniyenin işaret ettiği vecihte beyan edeceğiz.Birincisi: Sure-i Yusuf'un mühim bir esâsı, rüya-yı Yusufiye olduğu gibi; $ âyeti misillü çok âyetlerle, rüyada ve nevmde perdeli olarak ehemmiyetli hakikatlar var olduğunu gösterir.îkincisi: Kur'an ile tefe'üle ve rüyaya itimada ehl-i hakikat tarafdar değiller. çünki Kur'an-ı Hakim, ehl-i küfrü kesretle ve şiddetli bir tarzda vuruyor. Tefe'ülde, kâfire ait şiddeti, tefe'ül eden insana çıktığı vakit, yeis veriyor; kalbi müşevveş ediyor. Hem rüya dahi hayr iken, bâzı aks-i hakikatla göründüğü için şer telâkki edilir, yeise düşürür, kuvve-i mâneviyeyi kırar, su'-i zan verir. çok rüyalar var ki: Sureti dehşetli, zararlı, mülevves iken; tâbiri ve mânası çok güzel oluyor. Herkes rüyanın suretiyle mânasının hakikatı mâbeynindeki münasebeti bulamadığı için; lüzumsuz telâş eder, me'yus olur, keder eder.üçüncüsü: Hadis-i sahih ile nübüvvetin kırk cüz'ünden bir cüz'ü nevmde rüya-yı sâdıka suretinde tezahür etmiş. Demek rüya-yı sâdıka hem haktır, hem nübüvvetin vezaifine taalluku var. şu üçüncü mes'ele, gayet mühim ve uzun ve nübüvvetle alâkadar ve derin olduğundan, başka vakte tâlik ediyoruz; şimdilik o kapıyı açmıyoruz.Dördüncüsü: Rüya üç nevidir: îkisi, tabir-i Kur'an'la $ da dahildir; tabire değmiyor. Mânası varsa da ehemmiyeti yok. Ya mizacın inhirafından kuvve-i hayaliye şahsın hastalığına göre bir terkibat, tasvirat yapıyor; yahut gündüz veya daha evvel, hattâ bir-iki sene evvel aynı vakitte başına gelen müheyyic hâdisatı, hayal tahattur eder; ta'dil ve tasvir eder, başka bir şekil verir. îşte bu iki kısım $ dır, tabire değmiyor. üçüncü kısım ki, rüya-yı sâdıkadır. O, doğrudan doğruya mâhiyet-i insaniyedeki lâtife-i Rabbaniye âlem-i şehadetle bağlanan ve o âlemde dolaşan duyguların kapanmasıyla ve durmasıyla, âlem-i gayba karşı bir münasebet bulur; bir menfez açar. O menfez ile, vukua gelmeye hazırlanan hâdiselere bakar ve Levh-i Mahfuz'un cilveleri ve mektubat-ı kaderiyenin nümuneleri nevinden birisine rastgelir, bâzı vâkıat-ı hakikiyeyi görür. Ve o vâkıatta, bazan hayal tasarruf eder, suret libasları giydirir. Bu kısmın çok envaı ve tabakatı var. Bazı aynen gördüğü gibi çıkar, bazan bir ince perde altında çıkıyor, bazan kalınca bir perde ile sarılıyor.Hadis-i şerifte gelmiş ki: Resül-i Ekrem Aleyhissalâtü Vesselâm'ın bidayet-i vahiyde gördüğü rüyalar; subhun inkişafı gibi zâhir, açık, doğru çıkıyordu.Beşincisi: Rüya-yı sâdıka, hiss-i kablelvukuun fazla inkişafıdır. Hiss-i kablelvuku ise, herkeste cüz'i-külli vardır. Hattâ hayvanlarda dahi vardır.Altıncısı ve en mühimmi: Rüya-yı sâdıka benim için hakkalyakin derecesine gelmiş ve pek çok tecrübatımla, kader-i îlâhinin her şeye muhit olduğuna bir hüccet-i katı' hükmüne geçmiştir. Evet bu rüyalar, benim için hususan bir birkaç sene zarfında o dereceye gelmiştir ki; meselâ: Yarın başıma gelecek en küçük hâdisat ve en ehemmiyetsiz muamelât ve hattâ en âdi muhaverat yazılı olduğunu ve daha gelmeden muayyen olduğunu ve gecede onları görmekle, dilim ile değil, gözüm ile okuduğum bana kat'i olmuştur. Bir değil, yüz değil, belki bin def'a; gecede, hiç düşünmediğim halde gördüğüm bazı adamlar veyahut söylediğim mes'eleler, o gecenin gündüzünde, az bir tabir ile aynen çıkıyor. Demek en cüz'i hâdisat vukua gelmeden evvel hem mukayyeddir, hem yazılmıştır. Demek tesadüf yok, hâdisat başıboş gelmiyor, intizamsız değillerdir. M.)
rüya-yi sâdika: Makbul ve muteber kimselerin gördükleri ve gördükleri gibi dünyada hakikatları zuhur eden sâdık rüya.
rü'yet: Görmek, bakmak. îdare etmek. Göz ile veya kalb gözü ile görmek. * Akıl ile müşahede derecesinde bilmek, idrak etmek, tefekkür etmek, düşünmek. * Araştırmak.
rü'yetullah: Cennet'te mü'minlerin Allah'ı görmeleri.(Ey insan! Bilir misin nereye gidiyorsun? Ve nereye sevk olunuyorsun? Dünyanın bin sene mes'udane hayatı, bir saat hayatına mukabil gelmeyen Cennet hayatının; ve o Cennet hayatının dahi bin senesi, bir saat rü'yet-i cemaline mukabil gelmeyen bir Cemil-i Zülcelâl'in daire-i rahmetine ve mertebe-i huzuruna gidiyorsun. Mübtelâ ve meftun ve müştak olduğunuz mecazi mahbublarda ve bütün mevcudat-ı dünyevideki hüsün ve cemal, O'nun cilve-i cemalinin ve hüsn-ü esmasının bir nevi gölgesi... ve bütün Cennet, bütün letaifiyle bir cilve-i rahmeti... ve bütün iştiyaklar ve muhabbetler ve incizablar ve câzibeler, bir lem'a-i muhabbeti olan bir Mâbud-u Lemyezel'in, bir Mahbub-u Lâyezâl'in daire-i huzuruna gidiyorsunuz ve ziyafetgâh-ı ebedisi olan Cennet'e çağrılıyorsunuz. öyle ise; kabir kapısına ağlayarak değil, gülerek giriniz. M.)
rüyub: (Reyb. C.) şekler, şüpheler.
rüyuh: Zelillik, horluk, hakirlik. * Zayıflık.
rüyun: Galebe etmek, üstün gelmek.
rüz': Noksan etmek, eksiltmek, noksanlaştırmak.
rüzah (rüzuh): Davarın çok zayıf olması.
rüzam (rüzum): Davarın çok yorulup zayıflaması.
rüzaz: Ufalanmış taş. * Her maddenin ufağı.
rüzdak: (C.: Rezâdik) Köy.
rüzela: (Rezil. C.) Reziller. 
rüzgâr: Zaman, devir, hengâm, vakit. * Dünya, âlem. * Yel.
rüzz: Pirinç.
