ıbare: Beyan etmek, açıklamak.
ıbb: (C.: E'bâ) Yük dengi, ağır yük.
ıblik: Erkek.
ıbt: (Ibıt) Koltuk. Omuzun alt ve iç tarafı.
ıcan: Kubl ile dübür arası. * Ahmak kimse.
ıcaz: înat etmek.
ıcre: Başına tülbent sarmak. * Besili ve semiz olmak.
ıcrîm: Kısa boylu bodur adam.
ıda': Bir şeyi birbiri ardınca yapmak.
ıdaa: (Bak: îdaa)
ıdad: Hazırlamak. * Ses, sada.
ıdad: Isırmak. * Geçinmekte darlık, maişet zorluğu.
ıdae: Parlamak veya parlatmak. Ruşen etmek veya ruşen olmak.
ıd'af: Zayıf etmek, zayıflamak. * Muzaaf etmek, fazlalaştırmak. îki kat yapmak.
ıdafe: Misafir edinmek. * Ulaştırmak. * Tâbi olmak, uymak.
ıdaka: Darlık vermek.
ıdat: (Bak: Izat)
ıdbab: Yaş olmak, ıslanmak. * Kin tutmak.
ıdca': Yatırmak.
ıdcac: çağırmak, çağırtmak.
ıdcar: Gönül kırmak. Iztırab vermek. Darıltmak.
ıdd: (C.: Adât) Pınar ve kuyu suları gibi aktıkça kesilmeyen, devamı gelen su. * çokluk, kesret.
ıdfe: Ondan elliye varana kadar olan erkekler. * Kıt'a. * Akşam vakti.
ıdgan: Kalbinde bir kimseye kin ve adavet olmak.
ıdgas: Karıştırmak. * Otu eliyle tutamlamak.
ıdha': Kuşluk vaktine girmek.
ıdhak: Güldürmek. Güldürülmek.
ıdhîyan: Nurlu, ruşen, parlak.
ıdîn: Dağılmış, perâkende olmuş.
ıdk: (C.: Adâk-Uduk) Hurma salkımı.
ıdl: Yük dengi, misil, eşit. 
ıdla': çok yemekten dolayı midenin dolması ve hasta olmak.
ıdlal: (îdlâl) Hak dinden, imân ve islâmiyetten saptırmak. Doğrudan, Hak ve hakikat caddesinden ayırmak. Azdırmak.
ıdmame: (C.: Ezâmim) Cemaat, topluluk.
ıdna': Hastalığın hastayı zayıflatması.
ıdrar: Zarar vermek. * Avret üstüne avret almak, evli iken bir daha evlenmek.
ıdrîc: îbrişim kilim.
ıdtiba': Hacıların ihramlarını sağ koltukları altından çıkarıp sol omuzlarına örtmeleri.
ıdtica': Yan yatmak.
ıdtigan: Ayağıyla kendi kendine vurmak.
ıdtihad: Zulmetmek, cefâ vermek.
ıdtila': Kuvvetlendirmek.
ıdtimar: înce belli, karınsız olmak.
ıdtirab: Deprettirmek, hareket ettirmek. Izdırap.
ıdtiram: Ateş yakılmak. * şule vermek, ışıklandırmak.
ıdva': Azık yapmak.
ıdve: (C.: Udât) Yüksek yer. * Dere kenarı.
ıfa': Devekuşunun yeleği. * Devenin yükünün çok olması.
ıfas: şişe ve divit ağzını kapatmakta kullanılan deri.
ıfdac: (C.: Ufâzic) Semiz, besili hayvan. * Yumuşak nesne.
ıflik: Eski çalgılardan birinin adıdır.
ıfrat: Davarın alın saçı. * însanın ense saçı.
ığlak: (Bak: îğlâk)
ığraz: (Bak: îğraz)
ığva: (Bak: îğva)
ıh: Deveyi çökertmek için kullanılır sestir. * Yorgunluk ve heyecanla hızlı nefes vermeği tasvir eder.
ıhafe: Korkutmak.
ıhaze: (C.: îhâzât-îhâz) Su birikip toplanacak yer. * Bir kimsenin kendisi veya sultanı için hıfzedip gözlediği yer.
ıhbas: îfsad etmek. Bozmak. * Yaramazlık öğretmek.
ıhbat: Huşu ve tevazu' etmek, alçak gönüllülük yapmak.
ıhdac: Doğan çocuğun bir yerinin eksik olması.
ıhdar: Kendini gözlemek. * Bir yerde durmak, ikâmet.
ıhdi: Deve çöktü.
ıhdilal: Yaş olmak, ıslanmak. * Ağacın budak ve yapraklarının çok olması.
ıhdirar: Yeşillik.
ıhfak: Gazâda ganimet malından pay almamak. * Avcıların av yakalayamaması.
ıhfas: çirkin olmak.
ıhla': çıkarmak.
ıhla': Hâli etmek, boşaltmak.
ıhlad: Meyletmek, yönelmek, eğilmek. * Sonsuzlaştırmak, ebedi kılmak. * Geç ihtiyarlamak.
ıhlaf: Su aramak. Yerine halef etmek. * Kılıç çıkarmak için elini uzatmak.
ıhlak: Elbise eskimek veya eskitmek.
ıhlal: Terketmek.
ıhlamak: Ih diyerek deveyi çökertmek. * Ih diyerek yorgunluk ve heyecanla hızlı nefes vermek.
ıhlamur: Kerestesi marangozlukta kullanılan ve çiçeği haşlanıp çay gibi içilen ağaç. * Ihlamur ağacından yapılmış.
ıhlîvlak: Eskimek. * Bulutun gökyüzünü kaplaması.
ıhmad: Ateşi söndürmek.
ıhmal: Saçak yapmak.
ıhmar: Gizli etmek, saklamak.
ıhn: Boyalı sof kumaş. * Renkli yün.
ıhn-î menfuş: Didilmiş kumaş. Hallac edilip atılmış renkli yün.
ıhna': îfsad etmek, bozmak. * Yaramaz söz söylemek.
ıhrab: Viran etmek, harabe haline getirmek.
ıhrivvat: Uzamak.
ıhrînmas: Sükut etmek, susmak.
ıhrît: îsmi işitilmeyen bitki.
ıhsa': Irak etmek, uzaklaştırmak.
ıhsa': Haya çıkarmak.
ıhsar: Noksanlaştırmak, eksiltmek.
ıhsas: Yaramaz iş yapmak.
ıhşîşan: Kabalığı, inatçılığı ve katılığı fazla olmak.
ıhta': Hatâ etmek, yanılmak.
ıhtîba': Gizlenmek, örtünmek.
ıhtîbar: îmtihan ve tecrübe etmek.
ıhtîdab: Boyamak.
ıhtîdad: Otu köküyle birlikte biçmek.
ıhtîdam: Hizmet etmek.
ıhtîla': Ot biçmek.
ıhtîla': çıkarmak.
ıhtîlab: Aldatmak.
ıhtîlac: Seğirtmek, koşmak. * Hareket etmek.
ıhtîlak: Yalan olmak. * Muhtaç olmak.
ıhtîlal: (îhtilal) Halel vermek, zarar vermek. * Muhtaç olmak.
ıhtîlas: Hırsızlık için gelip bir şey alıp kaçmak.
ıhtîmam: Ev süpürmek.
ıhtîmar: Mütegayyer olmak, bozulmak, değişmek.
ıhtînas: Kırılmak. * îkiye bükülmek, iki kat olmak.
ıhtîra': Vücud vermek, icad.
ıhtîraf: Cem'etmek, toplamak.
ıhtîrak: Kat'etmek, kesmek.
ıhtîram: Eksilmek, noksanlaşmak. * Kesilmek.
ıhtîrat: Kılıç çekme.
ıhtîsam: Husumet etmek, düşmanlık yapmak.
ıhtîsar: Elini böğrüne koymak. * Muhtasar yapmak.
ıhtîtaf: Sür'atle ahzetmek, çok hızlı almak.
ıhtîtan: Sünnet olmak.
ıhtîtat: Sakal bitmek. Yer tutmak. * Hatla işaret koymak.
ıhtîva': Kendini aç bırakmak.
ıhtîza': Parça parça edip taksim etmek. * Kat'etmek, kesmek.
ıhtîzal: Kesilmek. * Ayrılmak.
ıhtîzan: Sırrı gizlemek.
ıhve-î müteferrîkîn: Ana baba bir veya yalnız ana bir yahut da yalnız baba bir erkek kardeşler. (Müennesi: "Ahavat-ı müteferrikat'tır)
ıkab: Azap, mihnet.
ık'ad: Yüksek bir yere çıkarmak. * Oturtmak.
ıkak: Tırnaklı hayvanların gebeleri.
ıkal: îkl, bağ, bend. * Daha ziyade Arabların başlarına koyup sardıkları bağ, agel. (Bak: Sâhib-üt tac)
ıkam: şiddetli harpler. * Yaramaz huylu.
ık'ar: Derinletmek, derinleştirmek.
ıkd: înci. Gerdanlık. Mücevher, boyuna takılan dizilmiş kıymetli şey. * înci dizecek iplik. * Hurma salkımı.
ıkfal: Kilitlemek.
ıkhâr: Kahr etme, kahr edilme, kahr edilmiş olma.
ıkhâr-i düşmen: Düşmanın kahrolması.
ıkka: çocukların doğduklarında mevcut olan saçı.
ıklab: Aksine döndürmek. Tersine çevirmek veya çevrilmek.
ıklal: Azaltılma, azaltma.
ıklîd: (C.: Akalid) Anahtar, miftah.
ıklîm: Bir yerin hava şartları. Memleket. Küre-i arzın kıt'a ve her bir memleketi.
ıkma': Gelen bir kimseyi geri döndürme. * Birisini aşağılama.
ıkmah: Enaniyet ve azametle kafa tutma.
ıkmar: Ayın doğmasını bekleme.
ıkmas: Suya daldırıp çıkarma.
ıknas: Adi ve rezil bir kimse iken asaletlilik iddiasında bulunma.
ıknat: Allah'a dua etme. Aczini ve fakrını anlayarak Allah'a yalvarma. * Namazda kıyamı uzatma. * înkisar etmek.
ıksâ: Uzaklaştırılma. Uzaklaştırma.
ıksâ-yi âmâl: Emel ve isteklerinden uzaklaştırma.
ıksam: Kasem etme, and içme, yemin etme.
ıksar: Yapabileceği ve elinden geldiği halde ihmâl etme.
ıksat: Hakkâniyet, doğruluk gösterme.
ıkta': (Kat.'dan) Delil göstererek susturma. * Mülkiyeti devlete ait olan bir arazinin menfaatinin hazinede istihkakı bulunan kimseye padişah tarafından verilmesi. * Maktuan ihâle.
ıktaat: (Iktâ. C.) Sahibi olmayan ve üzerinde imaret eseri olmıyan yerlerden olup, ulülemr tarafından istihkak sahibine imar ve inşa etmesi için tahsis olunan arazi.
ıktar: Damlatma, damlatılma.
ıktida: Tâbi olma. Uyma.
ıktidaen: Uyarak, ıktıda ederek, tâbi olarak.
ıktîfa': (Kafa. dan) Arkasından gitme, izinden gitme.
ıktîfaen: îzinden giderek, örnek tutarak, misal kabul ederek.
ıkva': Ev boşalmak. * Azık tamam olmak. şâirin şiirin kafiyesini çeşitli yapması.
ıkval: Bir kimsenin söylemediği bir sözü, söyledi diye iddia etmek.
ıkvâlîyyât: Söylenmediği hâlde söylendi diye iddiâ edilen sözler. Lüzumsuz iddialar.
ıky: Yemek yemezden evvel çocuğun karnından çıkan necisi.
ıkyan: Halis iyi altın. * înci parçası.
ılab: Boyunda olan uzun nişan.
ılac: Bir şeyi yerinden alıp gidermek.
ılakiye: Aşikârelik, açıklık, meydanda oluş.
ılat: (C.: Alât) Devenin boynuna takılan ip.
ılba': (C.: Alâbâ) Boyun siniri.
ılc: (C.: Uluc-Aluc-Ilce) Kervan. * Yabani eşek. * Acem küffarından bir erkeğin adı.
ılgam: Sıcak mevsimlerde çöl veya ovalarda buharın yayılmasıyla uzaktan su gibi göüren yer. Serap, pusarık.
ılgamak: At başıboş olarak dörtnala koşması.
ılgar: Düşman topraklarına ansızın yapılan hücum, akın. * Başıboş hayvanın dörtnala koşması.
ılgarci: Akıncı.
ılgidir: Bir metre kadar uzunluğunda, uçlarına birer karış kadar iki çivi sokulmuş ağaçtan yapılma bir ölçü âletidir.
ılgimsalgim: Sıcak mevsimlerde çöl veya ovalarda, buharın yayılmasıyla uzaktan su gibi görünen yer. Serap, pusarık.
ılhîz: Büyük kene.
ılica: Sıcak pınar suyu. Bunların yerden kaynayanına kaynarca; üzerine bina veya kubbe yapılmış olanına ise kaplıca denir.
ılik: Ne sıcak ne soğuk. Az ısınmış veya sıcaklığı kırılmış.
ılk: (C.: Alâk) Kurumak. * şarap, hamr. * Her nesnenin iyisi.
ılk: Sakız. * Ağızda çiğnenen şey.
ılka: Kişinin göbeğine dek olan gömlek.
ılkîd: şişman, kısa boylu, hakir ve hayrı az olan kadın. * Katı yoğurt.
ımya (imîyyâ): Görmeyerek, düşünmeyerek.
ınak: Kucaklaşıp sarılma, muânaka.
ınan: (C.: Aınne) Atın dizgini.
ınas: Kızın büluğ çağına vardıktan sonra evlerinde evlenmeden çok durması.
ınîz: Cimâa kadir olmayan erkek. * Cimâdan safâlı olmayan avret.
ınnîn: îktidarsız, güçsüz, âciz.
ıntifa: Sönme. Yanarken sönme. Ortadan kalkma.
ıntifa-yi harîk: Yangının sönmesi.
ıntîyan: Yiğitlik evveli.
ır: t. Nağme, ezgi, basit türkü. * Ahenk, terâne.
ıra: Karakter, seciye.
ıra': Mıknatıs.
ırab: Tazı. * Yükrek at. 
ırabet: Yaramaz sözler söylemek, fuhşiyyat.
ırafet: Kethüdâlık, reislik. Ululuk, şereflilik.
ırâk: Dicle nehrinden aşağı Basra'ya kadar şat Suyu'nun iki tarafı olan memleket. * Su kenarı. * Kökler, asıllar, bünyadlar. * Uzak.
ırâk-i acem: (Acem Irakı) Tar: Irak'ın Dicle nehrinden başlayarak îran sınırındaki yüksek dağlık mıntıkaya kadar uzanan bölgesine Osmanlılarca verilen ad.
ırâk-i arab: Arap Irak. Fırat ve Dicle nehirleri arasında kalan ve Bağdat'ın kuzeyine kadar uzanan topraklara Osmanlı împaratorluğu zamanında verilen isim.
ıraka: (Bak: îrâka)
ırakî: (Irâkiyye) Irak halkından, Iraklı. * Irak'a ait.
ıran: Evin uzak olması. * Mıh, çivi. * Mızrak. Süngü.
ıras: Devenin başını ayağına bağladıkları ip.
ırda': (Bak: Irzâ')
ırdam: üzüm veya hurma salkımı olan budak.
ırem: Irmak kenarı. "* Su bendi. * Dere, vâdi. * Sert yağan ve taneleri iri olan yağmur. * Gözsüz köstebek. * Kemikten etin suyunu almak.
ırgaf: Hızla yürüme, hırsla bakma.
ırgat: (Rumca) Rençber, işçi. * Yapı işçisi. Amele. * Gemilerde demir zincirini toplamak için ve binalarda bazı ağır şeyleri kaldırmak için zincirlerle çevrilmiş, ufki bucurgat.
ırip: Balık tutmak için atılan büyük ağ.
ırk: Nesil. Zürriyet. Sülâle. * Soy. Kök. Damar.
ırk-i ahmer: Kızıl derili.
ırk-i esved: Siyah derili, zenci.
ırk-üz-zeheb: Altınkökü denilen bir nebat.
ırkiy: (Irkıyye) Irkla ilgili, ırka âit.
ırkîl: Belâ. Zahmet, meşakkât. * çok güç nesne.
ırmak: Büyük akarsu, doğrudan doğruya denize dökülen nehir.
ırmîs: Büyük taş. * Kuvvetli ve dayanıklı deve.
ırnîn: Kaş tarafında burun ucu. * Her nesnenin evveli.
ırrîs: Arslan yatağı.
ırs: Koca ile karıdan her biri. * Nâmus.
ırsî: Gelincik dedikleri hayvanın rengine benzer bir renk.
ırtir: Yerinden ayrılmak.
ırv: (C.: Arâ) Cemaat, topluluk.
ırz: Namus. Temizlik. Cinsi haysiyet. * Ehil ve ıyal. însanın korumağa mükellef olduğu nefsi, hasebi, şerefi ve mahremleri, zemmedilecek veya medhedilebilecek durumları.
ırza: çayırlık, çimenlik. Otu bol olan yer.
ırzâ': Emzirmek veya emzirilmek.
ırzâ-î etfal: çocukların emzirilmesi.
ırzâ-î gayr-î mâderî: çocuğu hayvan sütüyle besleme.
ırzâ-î mâderî: çocuğu ana sütüyle besleme.
ırzal: Bağcıların arslan korkusundan dolayı ağaçların üzerinde yaptıkları yatak. * Avcıların, yatağında topladıkları kuru ot.
ırzîm: Sağlam, sert ve dayanıklı. * şiddetli toplayıcı.
ıs : (Iss) t. Bayındırlık, mâmuriyet. şenlik. * Ses. * Sâhib. Mâlik. * Efendi.
ıs'ab: Güç. çetin bulmak. Güçleştirmek. Zorlaştırmak.
ısabe: (C.: Asâib) Cemaat, topluluk. * Tıb: Yaraları sarmakta kullanılan bağ, yara bantı. * Başa sarılan ve şeâir-i îslâmiyeden olan sarık.
ıs'ad: Yukarı çıkarmak. Yükseltmek. * Mekke-i Mükerreme'ye gitmek. * înbikten geçirmek.
ısadet: Avlatmak.
ısaga: Kuyumculuk yapma. * Eritilmiş maddeleri kalıba dökme.
ısaha: Kulak verip dinleme.
ısalet: Hamle yapmak. * Ulaşmak.
ısam: Göze çekilen sürme. * Kırba bağı. * Kırba örtüsü.
ı'sar: Ayağını kaydırıp yere yıkmak.
ı'sar: Hafif esen rüzgâr.
ı'sar: Fakir olmak. * Güç olmak, zor olmak.
ıs'ar: Enaniyet ve kibirle surat asma.
ısare: çadır kazığı. * çadır ipi.
ısaret: Meylettirmek, eğmek.
ıs'as: Gece karanlığı başlamak, karanlık basmak. * Karanlığın açılması. * Bulutun yere yakın olması. * Peşinden gitmek.
ısata: Seslenme, ses çıkarma.
ısba': Tulu etmek, meyletmek.
ısbah: Seher vakti. Sabah vakti. * Gafil olmamak. Uyanıklık.
ısbar: Sabrettirmek.
ısbi': (Usbu'-Asba'-Asbi') Parmak.
ısda': (Sadâ. dan) Yankı. Aks-i sada. Sesin bir yere çarpıp dönmesiyle duyulan ikinci ses.
ısdad: Men'etmek, engel olmak, geri döndürmek.
ısdak: Verilecek parayı kadının nikâhında tesbit edip kararlaştırma.
ısdar: (Sudur. dan) çıkarma, çıkarılma, sudur ettirme. * Deveyi sudan geri döndürmek. * Rücu ettirmek, geri döndürmek, vazgeçirmek.
ısfa': Arındırılmak. Hâli olmak.
ısfak: Kapıyı örtmek. * El ile bir nesneye erişmek.
ısfîrar: Sararmak. Sarı olmak.
ısfîrar-i ayn: Gözün sararması.
ısfîrar-i evrak: Yaprakların sararması.
ısfîrar-i şems: Güneşin sararmış gibi görünüşü.
ısga': Söylenilen bir sözü dinleyip kabul etme ve yapma. * Söylenilen bir sözü kulak verip dinleme. * Meyl etmek. * Eksiltmek.
ısgar: (Sagir. den) Hakir ve hor görme. * Küçültme.
ısha': Gökyüzünün açık ve bulutsuz olması.
ıshab: Yoldaşlık yapmak.
ısham: Biçim vakti yetişmek, hasat zamanının gelmesi.
ıshar: (Sıhriyyet. den) Akrabalık, yakınlık, kurbiyet, sıhriyet. Damat olma. Damat edinme. * Ulaşmak. * Erimek.
ıshîrar: Ot kurumak.
ıska: (Bak: îska)
ıskaça: Gemi direğinin ayaklığı.
ıskalara: Gemi arması merdiveni. * Harp gemilerinin sol taraflarındaki merasim merdiveni.
ıskalarîya: Geminin üst kısmına çıkabilmek için iskele, yani merdiven teşkil etmek üzere çarmıhlara aykırı ve kazık bağı ile bağlanmış ince halatlar.
ıskaparma: îtl. Bir gemiyi toptan kiralama.
ıskarça: îtl. Geminin yükünün pek sıkı olarak istif edilmesi.
ıskarmoz: Kayık ve sandallarda kürek takılmak üzere yan kenarlara dikine sokulmuş tahta çiviler. * Bir cins küçük balık.
ıskarso: îtl. Yelkenleri doldurur dik rüzgâr. * Geminin götürü olarak kiralanması.
ıskarta: Herhangi bir sebepten dolayı değerini kaybetmiş mal.
ıskat: Düşürmek. Düşürülmek. Aşağı atmak. Hükümsüz bırakmak. * Silmek. * ölünün azaptan kurtulması ümidi ile ölen kimse nâmına dağıtılan sadaka.
ıskat-i cenîn: Kadının çocuk düşürmesi.
ıskat-i salât: ölmüş bir kimsenin kılmadığı namazlar yüzünden hâsıl olan günahını giderir ümidi ile verilen sadaka.
ıskota: îtl. Büyük yelkenleri kullanmaya yarayan ip.
ıskuna: ing. îki direkli bir nevi yelkenli gemi.
ısla': Ateşte kızdırmak. Ateşte yakmak.
ıslah: îyileştirmek. Düzeltmek. Kusurları gidermek. (Nefsini ıslah etmeyen başkasını ıslah edemez. S.)
ıslah-i hâl: Kendi halini ıslah etme, düzeltme.
ıslah-i zât-ül beyn: Aralarındaki kırgınlığı kaldırarak iki kişiyi barıştırma.
ıslahat: Kusurları ve eksiklikleri gidermek için yapılan işler ve düzeltmeler.
ıslahat-i adlîye: Adli ıslahat.
ıslahat-i askerîye: Askerlikte yapılan ıslahatlar. Askeri ıslahat.
ıslahat-i mülkîye: îdarede yapılan düzeltmeler, yenilikler.
ıslahatperver: Islahat taraftarı, ıslahatı seven.
ıslahen: Islah ederek, düzelterek.
ıslahhane: Tar: San'at mekteblerine önceleri verilen isim. * Islah evi.
ıslahî: (Islahiyye) Islah etmeye ve düzeltmeğe dair. Düzeltme ile alâkalı.
ıslahpezîr: Islah edilebilir olan. Düzeltme ve tâmir kabul eden, ıslaha kabiliyeti olan.
ıslî': Boynu ince ve başı fındık gibi yumruca olan yılan.
ıslîhmam: Ayak üstüne durmak.
ıslît: Zinetli kılıç, üzeri süslenmiş kılıç.
ısmam: şişenin ağzını tıkama. * Sağırlaştırma, duymaz hâle getirme.
ısmarlama: Sipariş verme, emanet etme. Hususi siparişle yaptırılmış, hazır alınmayan.
ısmat: Susturma, susturulma, sükut ettirme.
ısmî'lal: Muhkem olmak, sağlam olmak. * Otların birbirine dolaşmaları.
ısna': Yardım etme, yardımda bulunma.
ısnakat: El darlığı. * Men'etmek, engel olmak.
ısnan: Israr etme, inat etme, ayak direme. * Gücenme, darılma. * Gururlanma, kibirlenme.
ısparçana: Halatın üzerine sarılmış olan ip. * Halatın yapıldığı bükmelerin herbiri.
ısparmaca: Deniz içinde birkaç zincirin birbirine karışması.
ıspavlî: Eskiden gemilerde kullanılan bir çeşit kalın sicim.
ıspazmoz: Sinirlerde beliren gerginlik ve titreme.
ısr: Ahd. Sözleşme. Yemin. * Kulakta küpe deliği. * şiddetli ahkâm ve teklifler. * Altındakini yerinde tutan ağırlık, bağ.
ısrah: Medet yetişmek, yardım gelmek.
ısram: Derviş olmak.
ısrar: Bir fikir veya meşru dâvadan dönmemek. Direnmek, sebat etmek. Hayırlı bir hâl üzere sadakatla kalmayı istemek.
ıstabl: Ahır.
ıstabl-i âmîre: Saray ahırı.
ıstabl-i hâs: Padişahın atlarına mahsus ahır.
ıstaflîn: Havuç.
ıstahar: Havuz, küçük göl. Su birikintisi.
ıstam: Kepçe.
ıstiad: Yükseğe çıkma, terfi etme.
ıstibab: Dökülme. * Damardan kan fışkırması.
ıstibag: Boyanma.
ıstibar: Sabretmek. * Kısas almak.
ıstidam: îki şeyin birbirine şiddetli çarpması.
ıstifa: Bir şeyin iyisini seçip ayıklamak. * Bir şeyi ıslâh edip sâfileştirmek. * Seçmek. Ayıklamak.
ıstifa-gerde: Seçilen. Seçilmiş bulunan.
ıstifaf: Dizilme. Sıralanma. Saf bağlama.
ıstihab: Saklama, gizleme. * Dostluk kurma. * Konuşma, musâhabe etme.
ıstiham: Ayak üstüne dikili durmak.
ıstikak: Tokuşmak.
ıstila: Ateşte ısınma.
ıstilah: Tabir, deyim. Belirli bir topluluğun, bir lafzı lügat mânasından çıkararak başka bir mânada kullanmaları. * Bir ilim veya mesleğe âid kelime. Terim. Erbab-ı ilim arasındaki ve herkesin anlamadığı kelime. * Muvafakat. Uygunluk. Barışmak. îttifak.
ıstilahat: Istılahlar. îlmi tabirler.
ıstilahî: Istılaha dair. Istılaha âid ve müteallik.
ıstilam: Kesme, koparma. 
ıstina': Seçme, intihab, ayırma. * Adam seçme. * îyilik etmek. * îş işletmek.
ıstina-î siddik: Sâdık dost seçme.
ıstirah: Yardım isteme, istimdat.
ıstiram: Hürmet etme, saygı gösterme.
ıstiyad: Avlamak. Vahşi hayvanı ele geçirmek.
ıstiyaf: Yaz mevsimini geçirmek, bir yerde yazlamak.
ısva': Kuruma, yaşlığı ve rutubeti kaybolma.
ısvede: Küçük bir böcek adı. * Kuvvetli.
ışâ': Yatsı zamanı. Akşam ile yatsı namazı arasındaki vakit. * Güneş batmasından ertesi günü fecre kadar olan zaman.
ışâân: Akşam ile yatsı.
ışaeyn: Akşam ile yatsı zamanı.
ışar: Birlikte geçinmek. Muâşeret etmek.
ışar: (Aşerâ. C.) On aylık hamile develer.
ışaya: (Işâ. C.) Akşam ezanından yatsı ezanına kadar geçen zamanlar.
ışîr: (C.: Aşâr) çanak çömlek parçaları.
ışk: (Bak: Aşk)
ışka: Sarmaşık adı verilen bir bitki.
ışkî: îki ucu saplı eğri bıçaktır ve deri ve tahta kazımakta kullanılır.
ıştin: Toprak kandili.
ıtabe: îyi etmek. * Hoş kokulu etmek.
ıtaf: Kaftan.
ıtak: Hürriyet. * Kuvvet. * şiddet.
ıtak-üt tayr: Yırtıcı kuşlar.
ıtaka: Güç etmek, zorlaştırmak.
ıt'am: (Bak: ît'âm)
ıtam: îdrar zorluğu, idrar tutukluğu.
ıtar: (C.: Utur) Dudak kenarı. * Elin kasnağı. * Diğerlerini ihâta eden nesne.
ıtare: Uçurma, uçurulma.
ıtaş: (Atşân. C.) Susamış olanlar.
ıtbak: örtünmek. * Yürümek. * Değiştirmek. * (Bak: îtbak)
ıteh: Ahmaklık, bunaklık.
ıter: (Itret. C.) Nesiller, akrabalar, zürriyetler, aynı soydan gelenler.
ıtf: Omuzbaşı.
ıtfa': Söndürmek.
ıtfak: Maksadına eriştirme, gayesine vardırma.
ıtfal: Kadının oğlanını getirmesi.
ıtfet: şefkat, merhamet. * Boncuk.
ıtga: Azdırma, azdırılma.
ıtk: Azad edilmek. Hürlük. Esir veya köle olanın serbest edilmesi. Azad olmak. * Kerem ve hüsn-ü cemâl. Asâlet ve necâbet. şeref, şan ve kıdem. Kuvvet. 
ıtk alâ mal: Bir köle veya cariyenin kitabet suretiyle olmaksızın cins ve miktarı malum bir mal veya muayyen bir hizmet mukabilinde azad edilmesidir. Buna "Itk alâ cu'l" da denir. (Ist. Fık. K.)
ıtk-i muallak: Bir şarta talik suretiyle vuku bulan ıtkdır. Bir kimsenin kölesine "şu işi yaparsan hürsün" demesi gibi ki, köle o işi yapınca azad olur. (Ist. Fık. K.)
ıtk-i muzaf: Bir zamana, bir vaktin girmesine veya çıkmasına izafe edilen ıtkdır. "Sen gelecek ayın başında hürsün." denilmesi gibi ki, o ayın başında ıtk hadisesi vücuda gelir. (Ist. Fık. K.)
ıtk-i müneccez: Bir şarta muallak veya bir zamana muzaf olmaksızın derhal vuku bulan ıtkdır. Bir kimsenin memluküne hitaben "seni azad ettim." demesi gibi ki, onunla köle derhal hürriyetine kavuşur. (Ist. Fık. K.)
ıtk-i müşterek: îki veya daha fazla kimsenin, mâlik oldukları bir köleyi azad etmeleridir.
ıtkan: (Bak: îtkan)
ıtkname: Azad edilmiş olan köle veya cariyeye azad edildiklerini bildirmek üzere verilen vesika.
ıtl: (C.: Atâl) Böğür.
ıtla': Kokulu şeyler sürünmek. * Hevâiyata heves etme.
ıtla': Tulu ettirmek, zuhur ettirmek, doğdurmak.
ıtlak: Salıvermek. Bırakmak. Koyuvermek. Serbest bırakmak. Serbest olup her tarafta bulunmak. Cezadan kurtarmak. * Boşama. Boşanma. Afvetmek.(...Elbette mutlak ve muhit olan o ef'âlde iştirak muhaldir. îmkânı yoktur. Evet, ıtlakın mahiyeti iştirake zıddır. çünkü, ıtlakın mânası, hatta mütenahi ve maddi ve mahdut bir şeyde dahi olsa, yine istilâkârane ve istiklâldarane etrafa, her yere yayılır, intişar eder. Meselâ: Hava ve ziya ve nur ve hararet, hatta su, ıtlaka mazhar olsalar, her tarafa yayılırlar. ş.)
ıtlak-i înan: Dizginini salıverme. Başıboş bırakma.
ıtlak-i lîsan: Ağzına geleni söylemek. çok serbest ve kolay konuşmak.
ıtlak-i yed: Hayır işleme. 
ıtlal: Havâle olma, birşey üzerine yüklenme. * Boşu boşuna zaman geçirme, vakit öldürme.
ıtlihah: Gözden yaş akma, ağlama.
ıtlinsa: çok fazla terleme.
ıtmah: Yukarı bakma, gözü yukarı dikme.
ıtmal: Mahvetme, perişan etme.
ıtmas: Bir şeye geriden uzaktan bakmak. Helâk etmek.
ıtna': Sâlim olmak, sağlam ve sıhhatli olmak.
ıtnab: Edb: Konuşurken, fazla tafsilât vermek. Lüzumundan fazla sözü uzatmak. (îcazın zıddı)
ıtnab-i makbul: Bahsi iyice anlatmak için lüzumlu olan sözün uzatılması.
ıtnab-i mümîlle: Lüzumsuz olarak sözü uzatmak, usanç verecek şekilde uzatmak.
ıtnabe: Gölgelik, sâyeban. * Keman teli, keman kirişi.
ıtnan: çınlatma. Madeni bir ses çıkartma.
ıtr: Hoş ve güzel koku. Güzel kokulu şey. * Yaprakları güzel kokulu bir bitki.
ıtra': Bir kimseyi mübalağa ile medhetmek. En güzel şekilde sena etmek.
ıtrab: (Tarab. dan) şevke getirme, keyiflendirme.
ıtrad: Bir kimseyle birlikte bahse girişme.
ıtrah: (Tarh. dan) çıkarma, tarhetme, dışarı atma.
ıtrak: Sükût etmek, susmak. Gözünü yere dikip bakıp durmak.
ıtrar: Kandırmak, igra.
ıtret: Zürriyet. Nesil. Ehl-i beyt. * Gerdanlık. * Güzel kokulu şey.
ıtrî: Itra mensub, ıtır gibi kokan. * Müzik ilminde bir üstaddır. Asıl adı Mustafa'dır. Bayramlarda okunan tekbirin ilâhi ve kuvvetli bestesi onundur. Bestelere âid Segâh, Ayin-i şerif gibi 25 eseri olduğu söylenir. Osmanlı padişahı IV. Mehmed'in nedimlik ve esirler kethüdalığında bulunmuştur. Vefatı Mi: 1711'dir. îstanbul'ludur. * Tezhib ıstılahlarındandır. Bir cins yaprak şekli. Bu şekil ıtr yaprağına benzediği için bu ismi almıştır.
ıtrîf: Habis, hilekâr, kötü, pis.
ıtrîh: Devenin hörgücü.
ıtrîs: Hiddetli, cebbar kimse. * Kuvvetli, dayanıklı deve.
ıtrîyyat: (Itr. C.) Güzel kokulu yağ, esans gibi maddeler.
ıtrîyye: Erişte aşı.
ıtrnak: Güzel ve hoş kokulu.
ıttila: Kokulu şeyler sürünme.
ıttila': (Tulu. dan) Haberli olmak. öğrenmek. Haberi, malumatı bulunma. * Yukarıdan aşağı bakmak.
ıttilaat: (Ittılâ'. C.) Bilmeler, ıttılâlar, öğrenmeler, haberli olmalar.
ıttilak: înşirahlı olma, ferahlı ve sevinçli olma.
ıttirad: întizamlı, uygun şekilde. Saat gibi intizamlı hareket. Sıra ile birbirini takib eden. Ritmik.
ıtval: Uzatmak. Uzatılmak.
ıtya': Avdet etmek, dönmek.
ıvaz: (Bak: îvaz)
ıvec: (Bak: îvec)
ıyadet: Hastayı ziyaret edip hatırını sormak, gidip görmek.
ıyadeten: Hastaya hatır sorarak.
ıyaf: Gönül dönmek. * Mütereddit olmak, kararsızlık, tereddüt etmek. * Tiksinmek, iğrenmek.
ıyal: Fık: Bir adamın üzerine nafakasını vermek vacip olan, kendilerini geçindirdiği kimseler.
ıyalullah: Halk, insanlar.
ıyan: (Bak: Ayân)
ıyaz: Sığınma. îltica.
ıyazen: Sığınarak.
ıyd: (Bak: îd)
ıyş: (Bak: îş)
ız: (C.: Uzuz-A'zâz) çok zekâlı kötü adam. * Dikenli ağaçların küçüğü.
ıza: Nasihat, öğüt, vaaz.
ızaa: Bir şeyi zâyi etmek. Zâyi olmak. Kaybetmek. Mahvetmek, mahvedilmek.
ızaet: Parlatmak. Işıtmak. Işıklı olmak. Aydınlık etmek.
ız'af: Bir şeyin üstüne bir misli koyma. * Zayıflama.
ızahet: (C.: Izât) Dikenli büyük ağaç. * Yalan, sihir, bühtan.
ızam: (Bak: îzâm)
ızat: Yalan. Sihir. Bühtan. * Dikenli büyük ağaç.
ızat: (C.: Izât) Nasihat, öğüt.
ızaz: Berk muhkem yer.
ızazat: Noksanlık.
ızbandut: Eskiden Rum korsanlarına verilen addır. * Haydut, yolkesen, şaki, eşkiya. * îri vücutlu, korkunç.
ızca': Yırtma. * Yatarken vücudun yan tarafı üzerine yatma.
ızfar: Biri tarafından tırnaklanma. Bir kimseyi tırnaklama.
ızîn: (îze. C.) Her biri bir fırkaya mensub. Parça parça, fırka fırka. Müteferrik hâlde.
ızk: (C. Azâk) Hurma salkımı.
ızlak: Süçtürüp kaydırma.
ızlak-i akdâm: Ayakların sürçüp kayması.
ızlal: (Bak: Idlâl)
ızlal: Gölgeli olma, gölgelendirme.
ızlam: Karanlık, zulmet. * Zulmetme, karanlıkta bırakma.
ızmame: (C.: Ezâmim) Cemaat, topluluk. 
ızmar: (îzmâr) Kalbde gizlemek, saklamak. Belli etmemek.
ızmar-i gayz: Kin saklama.
ızmar-i kabl-ez zîkr: Edb: Bir kelimenin zikrinden önce ona âit zamiri kullanmak.
ıznan: Bir kimseyi kabahatlı çıkarma.
ızra': Zelil etmek, hor hakir etmek, alçaltmak.
ızraf: Zarflamak. Zarfa koymak.
ızram: Ateşi tutuşturma, ateşi alevlendirme.
ızrar: Zarar vermek. Zarara uğratmak.
ızrat: Yellendirmek.
ıztica': Namaz kılarken secdede koltukları sıkarak göğsü yere değdirme. * Yan üstüne yatma.
ıztilam: Koparmak. Kat'etmek, kesmek.
ıztimar: Atı, idman yaptırarak yola dayanabilecek şekilde kuvvetlendirme. * înce belli olma.
ıztina': Sıkılma, utanma, kızarma.
ıztirab: Acı, elem, sıkıntı, vesvese, azab.
ıztirab-âver: Iztırab veren, elem çektiren.
ıztirabat: (Iztırâb. C.) Elemler, acılar, sıkıntılar, azablar. Vesveseler.
ıztiram: Saç ve sakala kır düşme. * Alevlenme.
ıztirar: çâresiz olmak. Mecburiyet. îhtiyaç.
ıztirarî: çaresizlik içinde oluş. Mecburiyet.(Lisan-ı ıztırariyle bir duâdır ki; muztar kalan her bir ziruh kat'i bir iltica ile duâ eder, bir hâmi-i mechulüne iltica eder. Belki Rabb-i Rahimine teveccüh eder. S.)
ıztirarîyat: (Iztırari. C.) Mecburi olarak yapılan şeyler, mecburiyetler.
