ç: Osmanlı alfabesinin yedinci harfi olup, ebced hesabında "cim" harfi gibi üç sayısının karşılıdır.
çaba: Cehd. Gayret, herhangi bir işi yapmak için harcanan güç.
çabük: f. çabuk, seri, aceleli, hızlı, tez, hafif.
çabük-hirâmân: f. Sür'atli yürüyen. çabuk yürüyen.
çabük-rev: f. çabukça giden.
çaçaron: îtl. çok konuşan, çenesi düşük, geveze.
çaçele: f. Postal, ayakkabı, çarık, pabuç.
çader-î kuhlî: Sema, gök. * Karanlık gece.
çağ: Zaman, vakit, esnâ, hengâm, mevsim. * Yaş. * Boy, kamet, tenâsüb, lüzumu derece semizlik.* Devir, tarih çağları. (îlkçağ, Ortaçağ, Yeniçağ, Yakınçağ.)
çağatay: Cengiz Han'ın oğlu çağatay Han'ın ismine nisbetle Mâvera-ün Nehr taraflarında oturan Doğu Türklerine ve edebi lisan olarak kullandıkları Doğu Türkçesine verilen isimdir.
çağdaş §ƒ•šƒ: (Bak: Asri)
çağdişi: Askerliğe alınma çağı dışında. * çağın fikirlerine felsefesine uymayan. Bu mânada bazı kimselerin kelimeyi hakaret olarak kullanmaları dar görüşlülüğün ve cehaletin neticesidir. çünkü çağın insanlık için zararlı öyle fikirleri ve felsefeleri vardır ki, gelecek devirler bunu anladıkları zaman şimdi bunu benimseyenlerin zavallılıkları da anlaşılmış olacaktır. Körükörüne çağın her düşüncesini benimsemek, müslümana yakışmaz. (Bak: Asri)
çağla: (çağala) Badem, erik, kayısı gibi yemişlerin yenebilen ham meyvesi.
çağlar §ƒ•™ƒœ: Kayalara veya setlere çarparak, yerden köpürerek düşen su. şelâle, çağlayan.
çağrişim: Psk: Bir idrakla kazanılan bir fikrin başka bir idrak (algı) ile kazanılan fikir arasında bağıntı kurulması, birinin diğerini hatıra getirmesidir. Bu bağıntı zaman ve mekânda yakınlık, benzerlik ve zıdlık sebebiyle kurulur. Sevap deyince günahın; abdest deyince namazın; Cennet deyince Cehennem'in de aklı gelmesi gibi...
çağz: f. Kurbağa. * Korku, havf. * Kapandığı halde hâlâ içinde cerahat bulunan yara. * Ah ü fizar. înilti.
çâh §ƒœ: (çeh) f. Kuyu. çukur.
çâh-i bün §ƒœ‚„›: Kuyu dibi.
çâh-i yusuf: Hz. Yusufun (A.S.) kardeşleri tarafından atılmış olduğu kuyu.
çâh-i zemzem: Zemzem kuyusu.
çak §ƒ—: f. îyi, güzel, sıhhatli, şişman.
çak §ƒ˜: f. Yarık, çatlak, yırtmaç. * Kılıç, bıçak gibi şeylerin sesleri. * Sabah vakti beyazlığı. * Küçük pencere. * Hazır. Amâde.
çakacak: f. Silahlı çatışmadan çıkan ses.
çakaloz: çakıltaşı atan bir nevi küçük top.
çakçak: Parça parça, yırtık pırtık. * Kılıç ve emsâli şeylerin sesleri.
çâker §ƒ˜œ: f. Kul, köle.
çâkerâne: f. Kölecesine, köle gibi.
çâkerî: f. Abd'e, köleye ait. * Kölelik. Kulluk, abdlik, esirlik, cariyelik.
çakmakli: Ağızdan dolan ve tetik yerinde bir cins çakmakla ateş alan eski tüfek çeşitlerinden biri.
çakşir: înce kumaştan yapılan uzun bir çeşit şalvar. * Kuşların ayağındaki tüy.
çakuç: f. çekiç.
çal: îsimlere önden eklenip, onun daima hareket edip oynamakta olduğuna işaret ve delâlet eder. Meselâ: çal-at : Durduğu yerde de hareket eden at. * Bir şeyi şiddetle kapmaya delâlet eder. Meselâ: çal-yaka: Yakasından kapmak, şiddetle yakalamak.
çal-at: Hareketli, yerinde duramayıp şahlanan at.
çala: îsimlerden önce kullanılarak, devam ve şiddetli ve pervasız kullanılmasını bildirir. Meselâ: çalakalem: çabuk ve gelişigüzel ve ilmi olmayan yazı yazmak.
çalab §ƒ™ƒ„: t. îlâh. Mâbud. Cenâb-ı Hak, Rab.
çalak §ƒ™ƒ˜: f. Yerinde durmayan, çabuk, oynak. Dâima çalışan. Her bir hareketi çabuk olan. * Akıl ve ferâseti açık.
çalakî: f. çeviklik, süratlilik, tezlik.
çalbus: f. Dalkavuk, yaltakçı.
çalçene §ƒ§ƒ›œ: t. Durmayıp konuşan, geveze.
çalgi §ƒ™•ž: Müzik âleti. Müzik, çalgı. (îslâm âlimleri insanda maddi, hayvâni hisler ve hevesler uyandıran müziğin haram olduğunu bildirmişlerdir.)
çalim: Tavır, eda. * Kılıcın keskin tarafı, ağzı.
çâlîk: f. çelik çomak oyunu.
çâlîş: f. Savaşta düşmana karşı gurur ve naz ile yürüme. * Mukabil, karşı durma. * Savaş, muharebe, harp, ceng, mücadele. * Birleşme.
çam: f. Eğrilme, bükülme. * Salınma.
çâme: f. şiir ve gazel. Manzume.
çâme-gy: f. şair.
çamularî: Himalaya dağlarına bağlı bir dağ silsilesi.
çane: f. çene.
çap: f. Basma, baskı, tab.
çapar: Postacı.
çapkun: Seri ve yorulmaz neviden iyi bir at cinsi.
çaplus: f. Dalkavuk, yaltakçı.
çapl: f. Yağma, saldırı.
çaplcu: Düşman toprağına atla hücum edip yağma eden. Akıncı, yağmacı.
çar §ƒœ: (Slavca) Eski Rus îmaparatorlarının ünvanları. * Bulgar kralı.
çâr §ƒœ: f. Dört. Cihâr.
çar naçar §ƒœ‚›ƒ§ƒœ: f. îster istemez, mecburiyetle.
çar u yek §ƒœ‚ÿ˜: Dörtte bir.
çâr-bâlîş(t): f. Evvelce padişahların ve makamca büyük olanların üzerlerine oturdukları dört katlı şilte. * Dört unsur.
çâr-cîhet §ƒœ‚‡œ…: Dört cihet. Cihat-ı erbaa.
çâr-çeşm: Dört göz.
çâr-çîz §ƒœ‚§ÿ: Dört şey.
çar-deh: f. Ondört.
çar-ebru: Dört kaş. * Bıyığı yeni gelmiş delikanlı.
çar-erkân-i cuvanî: Padişahın özel hizmetlerinde bulunan ve Enderun'un azamlarından olan dört kişi hakkında kullanılan bir tabirdir.
çar-gâh: f. Dört taraf ki, bunlar; şark, garb, şimal, cenub'dur. * Dünya, küre-i arz, cihan. * Türk musikisinde bir makam adıdır.
çar-guşe: f. Dört köşe. Dört taraf. Dört yön.
çar-şeb: f. Cilbab, ferace, çarşaf.
çar-şenbîh: f. Haftanın dördüncü günü. çarşamba günü.
çar-tak: f. çardak. * Dört köşe çadır.
çar-yar: Dört dost. (Hz. Ebûbekir, Hz. ömer, Hz. Osman ve Hz. Ali (R.A.) lerin nâmları.) Dört Halife, Hulefâ-i Erbaa veya Ashab-ı Güzin diye de ihtiramla anılırlar.
çar-yarî: f. çar-yâra ait. Sünnilik.
çar-yek: f. çeyrek, dörtte bir. * Saatin dörtte biri, onbeş dakika. * Mecidiye denilen gümüş sikkenin dörtte biri ki, beş kuruşluk bir gümüş sikkedir.
çar-zeban: f. Geveze, çenesi düşük, lüzumsuz olarak konuşan.
çâre §ƒœœ: f. Neticeye varmak üzere maniaları kaldırmak için tutulması icabeden çıkar yol. Kurtuluş yolu. Tedbir, yardım, yol. * Hile. * Bir def'a. * Ayrılık.
çâre-cu: f. çâre arıyan.
çare-î halâs §ƒœœý¯¯ó‚‰™ƒ: Kurtuluş çaresi.
çâre-sâz: f. çâre bulan.
çarh §œ‰: çark, tekerlek. * Felek, gök, sema. * Ok yayı. * Elbisede yaka. * Tef.* Devreden, dönen. * çakır doğan. * Talih.
çarh-i ahdar: Gök kubbe.
çarha §œ‰œ: f. Ordunun ilerisinde bulunan askerlerin yaptıkları tâlim. * çıkrık gibi dönen yuvarlakça bir cins dolap.
çariyar §ƒœ‚ÿƒœ: (Bak: çaryâr)
çarîçe §ƒœÿ§œ: (Slavca) Rus împaratoriçesinin nâmı.
çark §ƒœ‰: f. (çarh-çerh) Dönen pervaneli tekerlek. * Vapur, değirmen ve dolap çarkı. * Bir makinenin dönen tekerleği, çok zaman bu tekerlek makineyi çalıştırır. Her çeşit tekerlekli makine. * Dönerek işleyen âlet. * Koz: Birbiri içinde dönen feleklerden mürekkeb kâinat, felek, eflâk. * Baht. Talih. şans.
çark-i felek §ƒœ‰‚–™˜: Bir makine veya dolaba benzetilen gökyüzü. * Mc: Tâlih, baht. * Yakıldığı zaman dönerek ateşler püskürten bir çeşit donanma fişeği. * Bir nevi sarmaşıklı nebat çiçeği.
çarmih §ƒœšÿ‰: f. (çar: Dört; Mıh: çivi) Salib. Suçluyu haça germek için kurulmuş, haç şeklinde darağacı. * Geminin direkleri başından aşağıya inen kalın ipler.
çarpa: f. Eşek, deve, koyun v.s. gibi dört ayaklı hayvanlar.
çarsu: f. Dört taraf. Dört tarafı olan şey. * çarşı, pazar.
çarşaf §ƒœƒ–: Yatağın üstüne serilen veya yorgana kaplanan bez örtü. * Kadınların kullandığı baştan örtülen, pelerinli eteklikli sokak elbisesi. Kadınların örtünmesi farzdır. Bu maksatla çarşaf ucuz, pratik, hafif olması ve zengin fakir herkesin kolayca sağlıyabilmesi bakımından yaygın olarak kulanılagelmiştir. çeşitli renklerde olabilir. çarşaf kadar ucuz ve pratik îslâma uygun başka bir giyecek yapılmadığı için, çarşaf giyenleri kınamak çok haksızlıktır. çarşaf zengin ve fakir ayrımını kaldırır. îç giyimi örttüğü için ailelerin birbirine özenerek israfa düşmelerini, gösterişi, çekememezlikleri ve bundan doğan huzursuzlukları önler. Ferâce, car, cilbab denen örtüler de, bu tarz örtü çeşitlerindendir. (Bak: Tesettür)
çarta(re): f. Dünya, âlem, küre-i arz. * Dört unsur. * Dört teli olan kemençe.
çârub: f. Süpürge.
çârub-zen: f. Süpürücü.
çaruğ: f. çarık.
çarüm: f. Dördüncü.
çaş: f. Tahıl yığını, hububat.
çaşît: Casus.
çaşnî: çeşni, lezzet, tad. Yemeğin tadına bakmak için ağza alınan miktar, tadımlık.
çaşt: f. Kuşluk yemeği. * Kuşluk vakti.
çavele: f. Güzel renkli bir cins gül. * Eğri büğrü, yamuk.
çavuş: Vaktiyle divanlarda hükümdarların hizmetinde bulunan yaver veya muhzır gibi subaylara denilirdi. Tanzimattan evvelki Osmanlı saray teşkilatında çavuşlar, padişahın yaverleri ve çavuşbaşı mabeyn müşiri idi. * Onbaşıdan üstte ve assubaydan alttaki derecede olan asker. * îşçilerin başları, şefleri.
çe §œ: f. Küçültme edatı olap bu mânâ ile Farsça isimlere eklenir.
çe §œ: (Bak: çi)
çeç: f. Hububat elenen kalbur. * Harman savurmakta kullanılan yaba.
çeçek: f. Gül. çiçek. * Gönül. * çiçek hastalığı. * Vücutda çıkan ben.
çeh §‰: f. Kılıç, bıçak ve hançer gibi âletlerin kını, kılıfı.
çeh §œ: f. Kuyu, çukur.
çehan: f. Damlıyan, damlayıcı.
çehâr: f. Dört, erbaa.
çehâr-deh: f. Ondört.
çehâr-gâne: f. Dört unsur.
çehâr-pâ: f. Dört ayaklı hayvan.
çeharüm: f. Dördüncü.
çehre §œœœ: f. Vech, yüz, surat. * Mc: Surat asmak, dargınlık. * Görünüş, şekil, zahir.
çehre-nümud: f.Yüzünü gösteren, yüz gösterici.
çehre-perdaz: f. Ressam.
çek §˜: çekoslovakya, Bohemya ahalisinden olan ve çek'ce konuşan kavim ki, Osmanlı metinlerinde "çeh" diye geçer.
çekan: f. Damlamış, damlıyan.
çekî: Odun gibi ağır cisimleri tartmada kullanılan 250 kiloluk ağırlık ölçüsü.
çekîde: f. Gürz ve topuz gibi eski zamanlarda kullanılan savaş âletleri. * Damlamış.
çekîmser: t. Taraf tutmayan.
çekre: f. Küçük su damlası. Su serpintisi.
çele-çepe §™œ‚§¨œ: f. Sağa sola.
çelebî §™„ÿ: Efendi, kibar kimse. * Mevlâna postnişinine verilen ünvan. * çelebi, Sultan Mehmed devrine kadar padişah oğullarına verilen ünvan idi. * Mevlânâ soyundan gelenlerle, mevlevilerin büyüklerine verilen ünvan.
çelenk: f. Eskiden kadınların süs için başlarına taktıkları mücevher veya madenlerden yapılmış sorguç. Halka şeklinde çiçek veya yapraklı dal demeti. (Cenazelere çelenk göndermek îslâm âdeti değildir, israftır.)
çelîpa: f. Haç, put, sanem. * Eğik ve kıvrık çizgi.
çem: f. Naz ve eda ile salınarak yürüme. * Ziynetli, süslü, düzgün. * Cürüm, kabahat, suç. * Taam, yemek. * Mâna. * Kazanılmış, toplanılmış.
çember §›„œ: (Bak: çenber)
çemen: Yeşil ve kısa otlarla kaplı yer, çimen. Ağaç ve çiçekleri olan yeşillik, çayır. * Pastırmaya konulan bir çeşit ot.
çemenîstan: f. Bahçe, çimenlik.
çemenzar §š›‚ƒœ: f. Yeşillik, çayır.
çenber §›„œ: f. Daire, def ve kalbur gibi şeylerin tahtadan olan dairesi. * Fıçı ve tekerlek gibi şeylere takviye edip, dağılmalarını önlemek için etrafını çevirecek tarzda geçirilen demir veya tahta halka. * Başa ve boyna bağlanan yemeni. * Esirlik, bağlılık, kölelik. * Geo: Bir düzlemde bulunan sabit noktadan aynı uzaklıktaki noktaların meydana getirdiği geometrik şekil.
çend §›š: f. Kaç tâne? Ne kadar? * Birkaç. üç-beş gibi adet. * Herhangi bir şeyin yüzde biri.
çendan §›šƒ›: f. Gerçi, her ne kadar. O kadar. Pek o kadar.
çendî: f. Bir müddet, biraz.
çendîn §›šÿ›: f. Kaç, kadar, ne kadar, bu kadar.
çeneb: f. Sünnet.
çeng: f. Pençe. * El. * çalgı âletlerinden bir saz çeşidi. * Eğri büğrü.
çengar: f. Yengeç. * Bakır pasından yapılan yeşil boya.
çengel: f. Pençe. * Bir şey asmağa yarayan alet. * Orman, ağaçlık yer.
çengî: Zil ve kaşık vurarak oynayan dansöz ve rakkase ki, ekseriyetle çingene kızlarındandır.
çep §¨: f. Sol, yanlış, falso.
çep şüden: f. Solak olmak. * Mc: Doğruluktan yüz çevirmek.
çep ü rast: Sağ ve sol.
çep-endaz: f. Hileci,hilekâr, hile yapan kişi.
çepel: Kirli, bulaşık, karışık, çamurlu.
çeper: Cidar, duvar.
çera §œƒ: f. Niçin, niye böyle? * Mer'a. Otlak.
çera-zar: f. Otlak, çayır.
çerag §œƒ•: f. Işık. kandil. Lâmba. Mum. * Kutlu, mutlu. * Otlak. Mer'a. * Otlama. * Tekaüd. * Talebe.
çerag-çeşm: f. Evlat, çocuk, veled, insan yavrusu.
çeragan: f. Etrafı aydınlatma, şenlik. Kandil donanması, çırağan.
çerakîse: (çerkes. C.) çerkesler. Kafkasyada yerli bir kabilenin adı.
çeram: f. Otlak.
çerb: f. Besili, semiz, yağlı. * Muvafık, münasib, uygun. * Temayüz, imtiyaz. Diğerlerinden fazla ve üstün olma.
çerb-ahur: f. îçinde yemi bol olan ahır. * Bolluk içinde yaşıyan kimse.
çerb-dest: f. Eli işe yatkın. Sür'atli, eli çabuk.
çerb-pehlu: f. Besili, semiz, gövdeli, yağlı.
çerbî: f. Tatlılık, yumuşaklık.
çeres: f. Zindan, hapishane. * Zulüm, işkence. * Mer'a, otlak. * üzüm teknesi.
çerh §œ‰: f. çark. Dolap. * Felek. Talih. * Dingil üzerine dönen. * Gök. * Def. * Zenberek. * Mancınık. * Elbise yakası. * Ok yayı. * çakır gözlü doğan kuşu.
çerhîden: f. Kendi etrafında dönmek.
çerkes: Kafkas kavimlerinden biri. * Bu kavme mensub olan kimse.
çerm: f. Hayvan ve insan derisi. Post.
çespan: Lâyık, uygun, münasib, muvafık, yakışır.
çespîde: f. Lâyık, uygun münasib, muvafık, yakışır.
çeş: f. "Deneyen, sınayan, tadına bakan" mânâsına gelerek kelimelere eklenir.
çeşan: f. Topuz, gürz.
çeşende: f. Tadıcı, tadan, tadına bakan.
çeşîde ˆÿšœ: f. Tadmış. Tadılmış olan.
çeşîden ˆÿš›: f. Lezzetine bakmak. Tadmak.
çeşm ˆš: f. Göz. Ayn. Dide.
çeşm-aşîna: f. Göz aşinalığı olan, tanıdık.
çeşm-avîz: f. Yüz örtüsü, peçe.
çeşm-dar: f. Bekliyen, gözliyen.
çeşm-derîde: f. Sıkılmaz, utanmaz, arsız.
çeşm-î âhu: Ceylân gözü.
çeşm-î bed §šó‚„š: Kem göz.
çeşm-î dîl §šó‚šÿ™: Basiret. Kalb gözü.
çeşm-î gazub: Kızgın bakış.
çeşm-î gîryân: Ağlayan göz.
çeşm-î hoş-nîgâh: Güzel bakışlı göz.
çeşm-î îstîkbâl-bînî: Gelecek zamanı, istikbâli gören göz. Kuvve-i kudsiye ve ferâset ve basiretle ileriyi bilen nazar.
çeşm-î mest §šó‚šž…: Sarhoş göz, mest olmuş göz.
çeşm-zahm: Nazar değme.
çeşman: (çeşm. C.) çeşmler, gözler.
çeşn: (çeşen) f. Bayram, id. * Düğün. * Ziyafet, şölen.
çete §…œ: Bölük, birlik, takım. Bir reisin idaresi altında bulunan birlik. * Asker bölüğü, müfreze. * çapulcu ve akıncı takımı.
çetîn §…ÿ›: Sert. * înatçı, dik başlı. * Zor, güç.
çetr: f. Gece. * Gölgelik, çadır, şemsiye.
çetr-î anberîn: Karanlık gece.
çetr-î nur: Güneş, şems.
çetu: f. Perde, örtü.
çetuk: f. Serçe kuşu.
çevgan: f. Cirit oyunlarında atlıların birbirlerine attıkları değnek. * Baston, ucu eğri değnek.
çevîk ‡ÿ˜˜: t. Tez hareketli. Oynak. çabuk hareket edebilen.
çevîk çalak §ÿ˜‚§ƒ™ƒ˜: Tez, hareketli, çalışan. Yerinde durmayıp hareket eden.
çeyrek §ƒÿœ˜: f. Dörtte bir (Bak: çâr-yek)
çifitlik §–ÿ…™—: Yahudilik, Yahudi cinsiyet ve mezhebi. * Münâfıklık.
çiğir §•ÿœ: t. Yeni açılan patika yolu. * Ayak izi ile karlı yerde açılan yol. * Başkalarının da uyabileceği yeni bir tarz ve yol. * çığın açtığı iz, yol.(... Hayat-ı içtimaiye-i beşeriyede bir çığır açan, eğer kâinattaki kanun-u fıtrata muvafık hareket etmezse hayırlı işlerde ve terakkide muvaffak olamaz. Bütün hareketi şer ve tahrib hesabına geçer...L.)
çimaci: Vapurda ve iskelede çımayı atıp tutmak vazifesiyle görevli tayfa.
çî §œ: (çe) f. Ne? Nasıl? (Soru edatı) * Taaccüb ve hayret yerinde de kullanılır.
çî-gune: f. Nasıl, ne çeşit, ne türlü.
çîde: f. Devşirilmiş, toplanmış.
çîhar §œƒœ: f. Dört. (Bak: çâr)
çîhîl: f. Kırk (sayı). * Mc: çok, ziyade, fazla.
çîl §œ™: (çihil-çehl) f. Kırk. * Mc: çok.
çîle §™œ: f. Eziyet. Sıkıntı. * îplik. * Yay kirişi. * Tas: Dervişlerin kapalı bir yere çekilerek ibadetle geçirdikleri kırk gün.
çîlehâne-î uzlet §™œ‚‰ƒ›œý‚”™…: çile çekilen yer. Yalnız başına ve çile içinde ibadet yapılan yer.
çîlekeş: çile çekmiş. çile dolduran, dert çeken.
çîlle: Farsça (40) rakamını gösteren (çihille) kelimesinin telaffuzunda aldığı şekildir. Daha çok (çile) şeklinde söylenir. (Bak: çile)
çîm: f. Rutubetten hasıl olan yosun.* Kesilmiş çimenli yerler.
çîn §ÿ›: f. Büklüm. * çatıklık. Buruşukluk. Kıvrım.
çîn §ÿ›: f. "Derleyen, toplayan" mânâlarına gelir ve birleşik kelimeler yapılır.
çîn-î cebîn: Alın buruşuğu. Alın kırışığı.
çîn-î ebru: Kaş çatıklığı.
çîn-î maçîn §ÿ›‚šƒ§ÿ›: çin ve çin'in güney kısmı.
çîne: f. Kuş yemi.
çînende: f. Devşiren, toplayan, toplayıcı.
çîpîl: Gözleri ağrılı ve kirpikleri dökülmüş kimse. * çepel.
çîrag: f. Fitil, kandil, mum, lâmba. * çırak. * Talebe, öğrenci, şakird. * Tekaüd, emekli, emekliye ayrılmış olan kişi.
çîre: f. Mâhir, maharetli, becerikli. * Bahadır, kahraman, yiğit, cesur.
çîre §œœ: f. Niçin? çerâ?
çîre-dest: f. Becerikli, eli işe yatkın olan.
çîregî: f. Bahadırlık, kahramanlık, yiğitlik. * Ustalık. Mâhirlik.
çîrk: Kir, pas, pislik, murdarlık, necaset. * Yarada olan irin ve kan.
çîrk-âb: f. Pis su.
çîrkâf §œ˜ƒ–: f. çirkef. Pis su. Pis. * Terbiyesiz. Edebsiz.
çîrkîn §œ˜ÿ›: f. Güzel olmıyan. * çok kirli. * Kanlı, irinli çıban veya yara.
çîsan §œ‚žƒ›: f. Ne gibi? Nasıl?
çîstan: f. Bilmece.
çîz §ÿ: f. şey. Nesne.
çolpa: f. Bir ayağı sakat olan. * Yürürken ilk defa sol ayağını atan. * Mc: Beceriksiz. Eli yakışıksız.
çopra: Balık kılçığı. * Sık çalılık veya sazlık. * Uzunca boylu olan tatlı su balığı.
çömez: Medresede talebeye ve müderrise hizmet ederek ilim öğrenen kimse. Talebe yamağı.
çub: f. Ağaç değnek, sopa. * çöp.
çuban: f. çoban, sığırtmaç.
çube: f. Oklava.
çubek: f. Değnek, sopa. Davul tokmağı.
çug: f. Su arkı. * Boyunduruk.
çuhadar: Ayak hizmetinde bulunan çuha elbiseli yahut çuhadan olan perdenin haricinde emre hazır bulunan hademe.
çun §›: f. (Tâlil edatı) Ne zaman ki, çünkü, şu sebepten ki, gibi, şâyet, zirâ, nasıl, niçin, çerâ.. den beri mânalarına gelir.
çun ü çîra: f. Nasıl ve niçin.
çunan §›ƒ›: f. öyle böyle.
çunîn: f. Böyle.
çuval-duz: çuval dikmeye yarayan iğne.
çuvaldiz: çuval ve ona benzer çul vs. dikmeye mahsus büyük iğne.
çü §: f. (Teşbih ve tâlil edatı) Gibi. * Dikkat. * Ahenk.
çün §›: f. Gibi. * Zira, çünki, madem ki. * Nasıl, nice.
çünan: f. Böyle. Bu şekilde. Bunun gibi.
çünbek: f. Atlama, sıçrama.
çünkî §›˜œ: f. Zira, şundan dolayı ki, şuna binaen ki, şu sebebden ki.
çüst: f. çevik, çabuk hareketli. Seri-ül-hareke. * Dar, sıkı. * Muntazam, mükemmel, düzgün. Yakışıklı.
çüstî: f. Atiklik, çeviklik, çabukluk.