da' š”: Arabçada "bırak" mânasına emirdir. Meselâ:
da' š”: Def'etmek, kovmak. Terketmek.
dâ' šƒ£: (C: Edvâ) Maraz, hastalık. * Meşakkat, zahmet.
da' mâ keder: Keder veren şeyi bırak.
dâ-ül-efrenc: Frengi hastalığı.
dâ-ül-kalb: Tıb: Kalb hastalığı, yürek çarpması.
dâ-üs-silâ šƒ£‚ƒ™™œ: Sıla hasreti. Vatan hasreti. Kavuşma hasreti.
daa: Telef etmek, ziyan etmek.
daac: Gözün çok siyah ve büyük olması.
daak: Davarın ayağıyla kazılmış yer.
daar (daâre): Fısk. * Kapmak. * Yaramazlık.
da'at: Horluk, zelillik.
dab: f. şan ve şeref, haysiyet.
dabar (dibâr): (C: Debabir) Cemaat, topluluk.
dabb ‘„: (C.: Dıbâb-Edubb) Keler, kertenkele. * Yaraya merhem sürmek. * Akmak. * Süt sağmak. * Yere yapışmak. * Dudakta olan bir hastalık (çatlayıp kan akar). * Hurma çiçeği.
dabbe ‘„ : (C.: Dıbâb) Dişi kertenkele. * Kapıya koyulan yassı enli demir.
dâbbe šƒ„œ: Yürüyen mahluk. Debelenen.
dâbbe-süvâr: f. Hayvana binen, binici.
dâbbet-ül arz šƒ„ ‚™ƒœý‘: Hadis-i şerifle âhir zamanda olacağı haber verilen ve âhir zaman alâmetlerinden olan bir nevi mahluk. (Cenâb-ı Hakk'a itâat etmeyenleri içlerinden kemireceği ve yiyeceği bildirilen dehşetli bir mahluk tâifesi.)(Kur'ânda, gayet mücmel bir işaret ve lisân-ı hâlinden kısacık bir ifâde, bir tekellüm var. Tafsili ise; ben şimdilik, başka mes'eleler gibi kat'i bir kanaatla bilemiyorum. Yalnız bu kadar diyebilirim: $ Nasıl ki Kavm-i Fir'avne "çekirge âfâtı ve bit belâsı" ve Kâbe tahribine çalışan Kavm-i Ebrehe'ye "Ebâbil kuşları" musallat olmuşlar. öyle de: Süfyan'ın ve deccalların fitneleriyle bilerek, severek isyan ve tuğyana ve "Ye'cüc ve Me'cüc"ün anarşistliği ile fesada ve canavarlığa giden ve dinsizliğe, küfür ve küfrana düşen insanların akıllarını başlarına getirmek hikmetiyle arzdan bir hayvan çıkıp musallat olacak, zir ü zeber edecek. Allahu a'lem, o dâbbe bir nev'dir. çünki gayet büyük birtek şahıs olsa, her yerde herkese yetişmez. Demek dehşetli bir tâife-i hayvaniye olacak. Belki $ âyetinin işaretiyle, o hayvan, dâbbet-ül arz denilen ağaç kurtlarıdır ki; insanların kemiklerini ağaç gibi kemirecek, insanın cisminde dişinden tırnağına kadar yerleşecek. Mü'minler iman bereketiyle ve sefâhet ve su-i istimâlâttan tecennübleriyle kurtulmasına işâreten, âyet, iman hususunda o hayvanı konuşturmuş. ş.)
da'bel: Kurbağa yumurtası. * Güçlü, kuvvetli deve.
dabentî: Güçlü, kuvvetli kimse.
dabgam: Arslan, esed.
dabh: Atların koşu esnasındaki nefeslerinin sesleridir ki, sahil denilen kişnemek değil, yemi ve sahibini gördüğü zaman yaptığı gibi hamhame denilen sesi de değil; hızlı nefes sesi olan bir harıltı ve hohlamadır. Denilmiştir ki: Dabh, bir at ve bir de köpek koşarken olur. (E.T.)
dabik: Bir yerin adı.
dabî: Kül, ramâd.
dabî': Yere yapışan, yere yapışıcı.
dabîb: Akmak. Seyelân etmek.
dabîe: Kişinin çoluk çocuğu.
dabîr šƒ„œ: Arka, kök, nihâyet. Son, âhir. * Bir nişandan geçen ok.
dabîre: Askerin bozulması.
dâbîret-ül însan: însanın ökçe siniri.
dâbîret-üt tuyur: Kuşların, ayakları arasındaki parmak.
dabk: Kendisiyle kuş avlanan bir nesne.
dabn: Dar nesne.
dabr: Cemaat. * Yaban cevizi. * Sıçramak.
dabrak: şişman ve etli olmak.
dabs: Ahlâkı kötü ve korkak olmak. * Anlaması, idrâki az olmak.
dabs: Mesrur ve mütekebbir olmak. Sevinçli ve kibirli olma hâli.
dabs: (C.: Ezbâs) El ile tutmak.
dabsem: Arslan, esed.
dabt: Hıfzetmek. * Cem'etmek, toplamak.
dabuka: Pis. Necis.
dabure: Yer yüzünde gezen hayvanât.
dabv: Pişirmek. * Tağyir etmek, değiştirmek.
dac: çağırmak.
dac' $ (ducu'): Yan tarafını yere koyup yatmak.
da'ca': Gözü çok siyah ve büyük olan kadın. (müz: Edac)
dacc: Hacıların hizmetkârı ve devecileri. * Hacılar ile birlikte giden, fakat, hac maksudu olmayan bezirgân.
dacce: Bir kere çağırmak ve inlemek.
da'cele: Gitmekte ve gelmekte tereddütlü olmak.
dacem: Eğrilik.
dacî': îşlerinde kısaltan. * Yatak arkadaşı.
dacîa: çok fazla bulut.
dacîc: çağırış. * Sesi yükseltmek.
dacîn: (C.: Devâcin) Evi öğrenmiş olan davar.
dacîr ‘‡œ: Gamkin ve gönlü dar kimse. * Bağırgan dişi deve. * Kederlenmek, hüzünlenmek muztarib olmak.
dacnan: Tehame vilâyetinde bir dağ.
dacr(e): Darlık, kalbin sıkıntılı olması.
dacuc: çağıran. * înleyen. * Sağarken incinen ve inleyen dişi deve.
da'd ‘¤š: Husumet, düşmanlık.
dad ‘: Osmanlı alfabesinin onyedinci harfidir. * Ebced hesabında sekizyüz sayısına karşı gelir.
dad ‘š: Doldurmak.
dad šš: Oyun, lehv.
dâd šƒš: f. Adâlet. Hak, doğruluk. * însaf. * Vergi, ihsan, atiyye. * ömür. * Sızlanma. (Adâletle dâd arasında fark vardır; adâlet, binefsihi adâlet edip zulmetmemektir. Dâd ise, başkasının zulmünü def ve izâle eylemektir. L.R.)
dâd u sîted: Alış veriş.
dâd-âver: f. Doğru, adaletli.
dâd-bahş: f. Hakkı yerine getiren, adaletli.
dâd-ger: f. Doğru, insaflı.
dâd-i hak šƒšˆ—: Hak vergisi, Cenab-ı Hakk'ın lütf u ihsanı.
dâd-i hak râ kabîlîyyet şart nîst: Cenab-ı Hakk'ın lütf u ihsanında kabiliyyet şart değildir.
dâd-res: f. Yardımcı, yardıma yetişen.
da'da ‘”‘ƒ”: Aklı ve fikri olmayan kişi. * Her nesnenin zayıfı.
da'da' š”š”: "Güzel dur" mânasına gelir ve düşecek ve dayanacak yerde söylenir.
dada šƒšƒ: f. Halayık. çocuk bakıcı. Dadı.
da'daa: Koyunu ve keçiyi çıkarıp sürmek. * Sallamak. * Bir kimseye "güzel dur" demek. * Miktarı çok olsun diye depretip çevirmek ve doldurmak.
da'daa: Yakmak. Yıkmak. * Hor ve zelil etmek. * Perâkende etmek.
dadan: Kesmez kılıç. * Fakir, muhtaç kişi.
dadar: f. Allah (C.C.) * Adaletli, âdil, doğru olan hükümdar.
dadaş: Delikanlı, babayiğit kimse. * Erkek kardeş.
dâde šƒš£: f. Verilmiş, vergi.
dâden: f. Vermek.
dâdender: f. Erkek üvey kardeş.
dâder: f. Karındaş, kardeş, birâder.
dâder-ender: f. üvey kardeş.
dâdgâh šƒš˜ƒœ: Adliye. Hak yeri, adâlet yeri.
dadh: Yemen baklası.
dâdhah šƒš‰ƒœ: f. Adalet isteyen.
dâdîstan: f. Bir işte ortak olma. * Bir işe razı olma.
dâdrad: f. Allah (C.C.), Cenab-ı Hak.
daele (duule): Zayıf ve ince olmak. * Hor ve zayıf olmak.
daf': Necis, pis.
dafadî: Kurbağa.
da'fak: Bol ve geniş olan şey. Vâsi.
dafate: Ayağa giydikleri bir cins pabuç. * Kişinin aklı ve reyi zayıf olmak. * Bir oyun çeşidi.
dafef: çoluk çocuğun fazla oluşu. * şiddet. * Darlık. * Hâcet. * Acele etmek.
dafen: Kısa boylu, ahmak adam. * îri gövdeli ahmak kimse.
dafended: şişman, ahmak adam.
daff: Dar, zıyk.
daffat: Devesini kiraya veren deveci.
daffata: Metâ ve kumaş götüren deve. * çokluk, cemaat.
daffe: Yan, taraf.
dafî' šƒ–”: Def'eden, menedici. Ortadan engeli kaldıran. * Cenâb-ı Hak. (C.C.)
dafîa šƒ–”œ: Def eden, muhafaza eden.
dafîk šƒ–—: Atılarak dökülen. Su ve emsali gibi akarak dökülen.
dafît: Ahmak.
dafn: Ayakla tekme vurmak ve atmak.
dafr: Saçı ve ona benzer şeyleri enlice örmek ve dokumak. * Vakarla yürümek. * Def'etmek, kovmak.
dafuf: Sütü çok olan davar.
dafv: Tamam olmak. * Malın çok olması.
dâg šƒ•: f. Yanık yarası. * însan veya hayvan vücuduna kızgın demirle vurulan damga.
dâg-i dîl: Gönül yarası.
dag-zen: f. Damga vuran, nişan koyan. * Kalb kıran, gönül kıran.
dagal: f. Hile. * Geçmez akçe, kalp para. * Hileci, hile yapan, dolandırıcı. * çerçöp.
dagal-bâz: f. Hileci.
dagas: çok yemekten dolayı midenin dolması.
dagb: Harislik, hırslı oluş. * Ovmak.
dagbus: (C.: Dagabis) Küçük hıyar. * Sirkeyle ve zeytin yağıyla yenen bir ot.
dagdaga: Dişi olmayan kadın. * Kurdun et yemesi. * Yemeği iki çene arasında geve geve yemek.
dağdağa š•š•œ: Gürültü. Iztırab. Boş yere telâş ve zorluklar. * Tereddüt etmek, karar verememek. * Gıcıklamak.
dağdar šƒ•šƒœ: f. Pek acıklı, üzüntülü. * Gönlü yaralı. * Kızgın demirle nişan vurulu. Damgalı. (Milletimde ihtilâf u tefrika endişesi Kûşe-i kabrimde hattâ bi-karar eyler beni, îttihadken savlet-i a'dâyı def'a çâremiz, ittihad etmezse millet, dağdar eyler beni.) Yavuz Sultan Selim Hân.
dağdar-i teessüf šƒ•šƒœ‚…¤ž–: çok acı olup, teessüf edilen.
dagf: Almak.
dagfasa: Semizlik, şişmanlık, besililik, etlilik. * Bol geniş nesne.
dagisa: (C: Devâgıs) Diz üstünde hareket eden yuvarlakça kemik. * Sâfi su.
dağistan: f. Dağlık yer. * Kafkasya'nın kuzeydoğusunda ve Hazer Denizi'nin batı kıyılarında bulunan bir bölgedir ki, eskiden buraya Albanya denirdi.
dağit: Emin. * Nâzır, bakan. * şiddet veren. * üzüm toplamada kullanılan âlet.
dagi(yye): Azgın, başkaldıran, isyan eden, âsi, anarşist.
dagî ’ƒ•ÿ: (Bak: Tâgi)
dagîb: Tavşan sesi.
dagîga: Sıvı hamur.
dagît: Yanında bir kuyu daha olduğundan suyu çekilip kokan kuyu.
dagm: Isırmak.
dagma': Yüzünün rengi siyaha yakın olan dişi koyun.
dagmîre: Karıştırmak, halt.
dagn: Meyletmek, yönelmek. * Kin tutmak.
dagr: şiddetle def'etmek. * Bir yere girmek.
dagre: Bir şeyi kapıp almak.
dags: (C.: Adgas) Rüyâ karışıklığı. * Karışık olmak.
dagş: Hücum etmek.
dagt ‘•’: Zahmet. Meşakkat. * Bir şeyi bir yere zorla sıkıştırmak. Sıkışmak.
dagul: f. Dolandırıcı, hileci, hile yapan.
dagv: Kedi veya tilki çağırmak.
dağvarî šƒ•ƒœÿ: f. Dağ gibi, dağ cesametinde. Dağ büyüklüğünde. Dağa benzer surette.
dagve: (C.: Degavât-Degayât) Huyu yaramaz olmak, hulku çirkin olmak.
dagz: Yutmak. * Defetmek. * îğrenmek. * Cimâ etmek.
dah: f. Hizmetçi, uşak, cariye. * On (10). Aşer. * Korkak. Alçak, aşağılık, âdi kimse.
daha': Kaba kuşluk vakti.
dahal: Aldatmak, mekretmek.
dahâmet: îrilik, kocamanlık, kabalık, vücutça büyük olmaklık. * Tıb: Hipertrophie.
dahâmet-î kebed: Tıb: Karaciğer büyümesi.
dahamîs: Bahadır, kahraman. * Karayağız, iri yapılı adam.
dahas: Kaypancak nesne.
dahas: Davarın tırnağında olan bir verem.
dahaya: (Dahiyye. C.) Kurbanlık hayvanlar.
dahb: Bir şeyi ateşte kızdırıp pişirmek.
dahc: Gizlemek, örtmek.
dahd: Kahretmek.
dahdah: Kısa boylu adam.
dahdah: Küçük adımlı kimse.
dahdah: (C.: Dahazıh) Arzu, istek.
dahdaha: Yorulmak, yorultmak. * Yavaşlamak. * Muti etmek, emre itaat ettirmek. * Hor etmek.
dahdaha: Suyun dökülüp saçılması. * Serabın uzaktan su gibi görünüp parlaması.
dahdar: Beyaz bez.
dahh: Yer altında bir şey gizlemek.
dahh: Bevlin uzaması.
dahhak ‘ˆƒ˜: çok gülen. çok gülücü. * îran'da eski tarihte yaşamış çok zâlim bir hükümdarın adı.
dahhas: (C.: Dehâhis) Toprak içinde kaybolup bulunmayan küçük bir böcek.
dahik ‘ƒˆ˜: Gülen, gülücü.
dahike: (C.: Davâhık) Gülme ânında çıkan dört dişin birisi.
dahis: Tırnak yakınında olan bir verem hastalığı.
dahiye: Nâhiye.
dahî šƒœÿ: Eşine ender rastlanır, hârikulâde zekâ, fatanet ve hikmet sâhibi.
dahîke: (C.: Davâhik) Azı dişlerinden her biri.
dahîl š‰ÿ™: Yabancı, sığınan, sığınmış. Muhacir. * Birisinin içyüzü, niyet ve mezhebi. Dâhil ve içerde. Birisinin bütün gizli ve sırlı işlerine vâkıf olan dost ve hemdemi. * Evvelâ alâkasız olup sonradan bir cemaate dâhil olan. * Edb: Başka bir dilden olup, sonradan diğer bir dile geçen kelime. * Tıb: Vücud âzalarında birbirine girmiş ve sokulmuş olan mafsallar.
dahîl š‰™: (Bak: Dahl-Dehal) Girmek, karışmak. Dokunmak. Taarruz etmek, müdâhale eylemek.
dahîl šƒœ™: Hayrette kalan kimse.
dâhîl šƒ‰™: îçeri. îç. îçinde. îçeri girmiş.
dahîle: (C.: Devâhil) Bir şeyin içi, içyüzü.
dahîlek š‰ÿ™˜: Yalvarırım, sana sığınırım, sana güvenirim (meâlinde.)
dahîlen: îçten, içerden, dâhilden.
dahîlîye naziri: îçişleri Bakanı.
dahîm: f. Nasib ve rızık.
dahîm: (Dâhim) f. Taç.
dahîm: (Dahâmet. den) Yoğun ve fazla koyu olan. Kalın olan.
dahîne: (C.Devâhin) Duman çıkan baca.
dahîr: (C.: Dehâyir) Toplanılmış veya gömülmüş mal.
dahîr: Dere, vâdi. * Dağ başı.
dahîs šˆž: Müfsid, arayı bozan. * Koyun yüzerken deri ile etin arasına elini sokan. * Bir meşhur atın adı.
dahîs šƒ‰ž: Hayvanların tırnak diplerindeki et parçası. Dolama hastalığı.
dahîs š‰ÿž: Kokmuş, kemiksiz et. * Semiz nesne. * çok adet, fazla miktar.
dâhîye šƒœÿœ: Hârikulâde zekâ ve fetanet sahibi. * âfet, belâ, musibet. Kazâ. Emr-i azim. Büyük iş ve hâdise.
dâhîye-î dehyâ šƒœÿœý‚šœÿƒ: çok büyük belâ, musibet.
dâhîye-î edeb šƒœÿœý¯¯ó‚¤š„: Edebiyatta dâhi olan, eşine az rastlanan büyük edib.
dâhîye-î harb šƒœÿœý¯¯ó‚ˆœ„: çok becerikli büyük kumandan.
dâhîye-î hîlkat šƒœÿœý‚‰™—…: Yaradılıştan dâhi olan. Hârika.
dahîyye ‘ˆÿœ: Kurbanlık hayvan.
dahk: Tere yağı. * Bal. * Kar. * Ağzı yarılmış olan çiçek tomurcuğu.
dahk: Irak, uzak, baid. * Atmak.
dahl š‰™: Karışma, girme. * Nüfuz, te'sir. * Vâridat. * îrâd. îtiraz, ta'riz. * Ayıp, töhmet.
dahl ‘ˆ™: Az miktar su.
dahl ‘œ™: Bir nesne az olmak.
dahl (duhl) šˆ™: (C.: Dihâl-Edhâl-Dahlân) Pencere. * çukur yer.
dahm: îri, büyük, kocaman, cüsseli, kalın.
dahm: şiddetle def'etmek. * Cemaatın kuvvetli olması.
dahme: f. Mezar, kabir. türbe. * Donanma geceleri atılan hava fişeği.
dahmes: Sirke tulumu. * Her nesnenin karası.
dahn: Fesâd. * Bulanıklık.
dahna: Boz renkli.
dahr š‰œ: Alçalma. Küçülme. Hor ve hakir olma.
dahr: Kaplumbağa. * Dağbaşı.
dahr (duhur): Sürmek. * Irak etmek, uzaklaştırmak. * Horluk.
dahrece šˆœƒ‡‚šˆœ‡œ: (Dıhrâc) Yuvarlamak.
dahs: Sözünü fesâhatle açık bir şekilde söylemek.
dahs: Koyunun derisiyle eti arasına yüzmek için elini sokmak. * Fesad, ifsâd.
dahs: ön dişler ile ısırmak.
dahs: Ayağıyla tepinmek.
dahten: f. Bilmek.
dahuk: Geniş yol.
dahul: Geyik tuzağı. * Canavar tuzağı.
dahül: f. Bostan korkuluğu.
dahv: Atmak, ramy.
dahv: Zâhir olmak, görünmek.
dahve: îlk kuşluk vakti. Güneşin ufukta ilk yükselip yayılmaya başladığı an.
dahy šˆÿ: (Dahv) Yayıp döşemek. * Deve kuşu yumurtası. (Bak: Udhiy) (968 hicri tarihinde vefat eden Ahter-i Kebir lugatının Müellifi, Kur'an-ı Kerimdeki bu kelimeden dünyanın bir elips şeklinde, deve kuşu yumurtası biçiminde yuvarlak olduğuna âdeta inanmış. Bu gün bilinen bu hakikatı bundan üç asır evvel ifşa etmiştir.) (H. Basri çantay)
dahya': Rûşen, parlak ve nurlu nesne.
dahya': (C.: Duhâ) Hayız görmez kadın. * Ağaç ismi.
dahye: Kuşluk vaktinde kesilen koyun.
daî šƒ”ÿ: Dua eden, duacı. * Sebep. * Davet eden. Muktazi. (Meselâ: Yemek yemek, iştihadan gelen bir lezzet, bir iştiyaktır. Onu yemeğe sevk eder. Buna dai denir.) Resul-ü Ekrem'in (A.S.M.) bir ismi de daidir. * çağıran. Müezzin.
dâîb šƒ¡„: âdet ve usulünde devam eden. (Bak: De'b)
dâîbeyn: âdet ve usulünde devam eden iki şey.
daîl ‘ƒ¡™: îçen. şârib. * Mahvolan. * Zaif.
daîl ‘¡ÿ™: Arık, zayıf, küçük hacimli.
daîm šƒ¡š: Devam eden. (Daimi, daima, daimen şeklinde de söylenir.)
daîma šƒ¡šƒ: (Devam. dan) Her vakit, bir düziye, daimi suretde.
daîmî šƒ¡šž: (Devam. dan) Sürekli, devamlı.
daîn šƒ¡›: (Dâyin) ödünç veren, borca veren. * Alacaklı. îkraz eden.
daîn: Asıl. * Mâden. * Doğruluk.
daîn: (C.: Daân) Yünlü olan koyun.
daîr šƒ¡œ: Devreden. Dolaşan. Dönen. Bir şeyin etrafını kuşatan. * Belli bir şey hakkında olan. Alâkalı, müteallik.
daîre šƒ¡œœ: Resmi hükümet makamlarından her biri. * Yazıhane. * Büyük bir idare adamının makamı. * Ev veya apartman katı. * Bir manevi te'sirin hükmü geçtiği mahal. * Sınır içi. * Büro, büyük ev, konak. * çember, düz yuvarlak şekil. * Mat: Merkezden aynı uzaklıktaki noktaların çevirdiği düzlük parçası. * Hezimet ve musibet. Beliye-i muhita. * Dönüp dolaşıp meydana gelen hâdise ve inkılâb.
daîre-î âfâk šƒ¡œœý¯¯ó‚¥–ƒ—: Ufuklar dairesi. çok geniş ve büyük dâire, kâinat.
daîre-î ehadîyet šƒ¡œœý¯¯ó‚¤ˆšÿ…: Allah'ın ehadiyetle tecelli ettiği dâire. (Bak: Ehadiyet)
daîre-î esbab šƒ¡œœý¯¯ó‚¤ž„ƒ„: Sebepler dâiresi. Sebep ve kanunların bulunduğu yer olan maddi âlem.
daîre-î esmâ: Cenab-ı Hakk'ın isimlerinin sahası ve dairesi.
daîre-î îmkân šƒ¡œœý‚š˜ƒ›: Kâinat. îmkân âlemi. Mükevvenat. Mümkün olan, şartların müsait olduğu âlem. (Daire-i mümkinat da aynı mânada kullanılır.)
daîre-î mümkînat šƒ¡œœý¯¯ó‚šš˜›ƒ…: (Bak: Daire-i imkân)
daîre-î resmîye šƒ¡œœý¯¯ó‚œžšÿœ: Hükûmet dairesi, resmi daire.
daîre-î vücub šƒ¡œœý‚‡„: Tebeddül ve tagayyür etmeyen ve mümkinat âleminden olmayan âlemler. Esmâ ve Sıfât-ı îlâhiyye gibi. (Bak: Vücub âlemi)
daîre-î vücud šƒ¡œœý¯¯ó‚‡š: Vücud ve varlık dairesi ve sahası.
daîrevî šƒ¡œœ‚ÿ: Daire şeklinde. Daire gibi.
daîrezen: Mehter takımında def çalan.
daîyan: (Dâi. C.) Dua edenler, duacılar.
dâîye šƒ”ÿœ: însanı bir şeye candan bağlamağa sürükleyen iç duygusu. * Mücib ve sebep. * Bâis olan husus, vakit ve zamanın bir hâleti. * Arzu, hırs. * Dava. * Bahane.
dâîye-î tefevvuk: üstünlük iddiası.
daîyy: şu kimseye derler ki, bir kişi ona "oğlumdur" demiş olsun.
da'k: Ovmak. * Bir şeyi yumuşatmak.
dak'a: Toprak.
daka': Varmak. Ulaşmak. * Buluşmak.
daka': Fakirlik.
dakaîk š—ƒ¡—: (Dakayık) (Dakik. C.) încelikler. Anlaşılması çok dikkat isteyen incelikler. çok ince. Anlaşılması dikkat isteyen keyfiyetler.
dakaîk-aşîna š—ƒ¡—‚¥›ƒ: f. îlmi incelikleri bilen, anlaşılması ve tefhimi müşkül, yüksek ve ince ilmi mes'elelere vâkıf olan.
dakaîk-i fennîye š—ƒ¡—‚–›ÿœ: f. îlmi incelikler. Fennin ince ve güç anlaşılan noktaları.
dakaîk-î umur š—ƒ¡—‚ƒšœ: f. üzerinde gayet dikkatle durulması lâzım gelen işlerin ince ve mühim noktaları.
dakal: Hurmanın iyi olmayan cinsi. * Gemi oku. * Boya.
dakdak: (C.: Dakâdık) Kısa boylu ve katı yürüyen kişi.
dakdaka: Davarın tırnağının taşa dokunup ses çıkarması.
dakdake: Tez tez yürümek, hızlı yürümek.
da'ke: Deve sürüsü.
da'kese: Mecusiler oyunundan bir oyun. ("destibend" de derler.)
dakîk š—ÿ—: (Ekseri mânevi mânalar için) Pek ince. Nâzik. Ufak.
dakîka š—ÿ—œ: (C.: Dakaik) Zaman mikyası olarak bir saatin bölündüğü altmış parçadan beheri. Altmış saniyelik zaman. * înce fikir, mülâhaza, nükte. * Daire dereceleriyle başka ölçülerde her derecenin bölündüğü parçalar ki bunlar da saniyelere ayrılırlar.
dakîka-bîn: f. încelikleri bilen, ince noktaları gören.
dakîka-şînas: înce işleri ve nükteleri anlayan, bir işin incelikleriyle uğraşabilen.
dakîs: Bir kimsenin aksırdığında ağzından saçılan tükrük.
dakk š—: Vurmak. * çekmek. çok yemekten dolayı vücudun ağırlaşması. * Kapı çalma.
dakk-ül bâb š—‚ƒ™„ƒ„: Kapı çalmak.
dakm: Kırmak, kesr.
dakr: Vurmak, darb.
dakva(n): Sütü çok içtiğinden dolayı bedeni ağırlaşan kuzu.
da'l ‘¤™: îçmek, şirb.
dal šƒ™: Ağacın ilk verdiği kol. * Kur'ân hattiyle yazılan () harfinin okunuşu (Ebcedi değeri dörttür.) Noktasız olduğundan "dâl-i mühmele" de denir.
dal šƒ™: Semiz avrat. şişman kadın.
dal ‘ƒ™: "Yaban sediri" denen bir ot.
dal' ‘™”: Meyl. Eğrilik. Kuvvet. * Ağır yük götürmek.
dalaa: Kuvvet. * Eğrilik. * şiddet.
dalal ‘™ƒ™: Sapıklık. * Sapmak. Doğrudan, imân ve îslâmiyyet yolundan sapmak.
dalalet ‘™ƒ™ : îman ve îslâmiyetten ayrılmak. Azmak. Hak ve hakikatten, îslâmiyet yolundan sapmak. Allah'a isyankâr olmak. * şaşkınlık.(... Nevâfil kısmında, emr-i istihbabi ile yine ehl-i iman mükelleftir. Fakat, terkinde azab ve ikab yoktur. Fiilinde ve ittibaında azim sevaplar var; ve tağyir ve tebdili, bid'a ve dalâlettir ve büyük hatadır...... Sünnete ittiba etmiyen, tenbellik eder ise, hasaret-i azime; ehemmiyetsiz görür ise, cinayet-i azime; tekzibini işmam eden tenkid ise, dalâlet-i azimedir. L.)
dalaletpîşe ‘™ƒ™ ‚¨ÿœ: Sapıklığı tâkibeden. Sapıklığa giden. îslâmiyetten başka yol tâkib eden.
daldal(e): Taşlı sert yer.
dalgakiran: t. Bir limandaki tekneleri dalgaların te'sirinden muhafaza etmek için denizde yapılan set.
dalgiç: t. Mercan, inci ve saire avlamak veya denizin dibine düşmüş olan şeyleri çıkarmak için denizin dibine dalmaya alışık adam.
dali': Kavi, kuvvetli. * Muhkem, sağlam, sert. * Eğri.
dalîf: (C.: Düllef) Nişandan öteye düşen ok. * Ağır yük getirip adımlarını birbirine yakın atan adam.
dalîl: Sert, sağlam, muhkem yer. * Yolu azmış kişi.
dalîye: (C.: Devâli) Hayvanla döndürülüp su çekilen dolap. (Suyun döndürdüğü dolaba "nâurâ" derler.)
dalkavuk: t. Eline maddi menfaatler, para vesaire geçirmek için yaltakçılık ve soytarılık edip kendi vakar ve haysiyetini muhafaza etmeyen adam.
dal(l) ‘ƒ™: Kur'ân ve imân yolundan sapan. Dalâlete giden, azan. * Azdırıcı, sapkın. * şaşkın.
dall ‘ƒ™: Azan. Azıcı, azdırıcı. Dalalette olan.
dall šƒ™: Delil olan, delâlet eden. Yol gösterici. * Bildiren.
dâll-î bî-l fehvâ: (Dâllibilfehvâ) Fık: Söylenen sözün veya ifâdelerin hülâsasından çıkan mânaya göre delil ve işaret olmak.
dâll-î bî-l îbare šƒ™‚„ƒ™”„ƒœœ: (Dâllibilibâre) Fık: Bir ifade veya sözden muayyen bir mânanın ve hükmün anlaşılması. Meselâ: "Zekât, müslümanların fakirlerine verilir, hiçbir zengine verilmez" ibaresi zekâtın yalnız müslüman fakirlere verileceğine delâlet-i mutabıkıyye ile delâletidir. Zengin olan belli şahıslara da verilemeyeceğine delâlet-i tazammuniye ile delâlet eder. Zekât hususunda, zenginler ile fakirler arasında fark bulunduğuna da delâlet-i iltizamiye ile delâlet eder. (Ist. Fık. K.)
dâll-î bî-l îktîza šƒ™‚„ƒ™ƒ—…‘ƒ: (Dâllibiliktiza) îktizası ile delâlet eden. * Ist: şer'an muhtacun ileyh olan bir lâzime delâlet eden lâfızdır. Başka bir tâbir ile; vaz'olunduğu mânadan mukaddem isbatına şer'an lüzum ve ihtiyaç mevcud olan bir medlule delâlet eden ibaredir. Meselâ: Bir kimse bir şahsa hitaben: "Evini şu kadar liraya benim nâmıma medrese yap" deyip o şahıs da evini medrese yapsa, o ev o kadar lira mukabilinde o kimse nâmına medrese yapılmış olur. çünkü bu söz ile: "Evini şu kadar liraya bana sat" sonra "onu benim nâmıma medrese yap" denilmiş olur. "Evini medrese yap" emri bir muktezidir. Evin satılması da muktezâdır. Bu muktezâ olmadıkça öyle bir mânanın emri hükümsüz kalır. Artık öyle bir emrin sıhhatı için evvelce bu muktezânın vücuduna lüzum ve ihtiyaç vardır. Binâenaleyh, o emir bu muktezaya bi-l iktiza delâlet etmektedir.
dall-î bî-l îşare šƒ™‚„ƒ‚ƒ™ƒƒœœ: (Dâllibilişâre) Sözdeki mânanın işâretine göre delil olmak.üç nevi delâletten biri ile sevkedildiği mânanın gayrisine yâni; söylenince maksud-u asli olmayan bir mânaya delâlet eden lâfızdır. Meselâ: "Cenab-ı Hak bey'i helâl, ribâyı haram kılmıştır." ibâresi, bey', yani alış-veriş ile ribâ (fâiz) arasında fark bulunduğunu beyan için sevk olunmuştur. Bundan asıl murad budur. O hâlde bu ibâre meşru alışverişle faiz arasında fark bulunduğuna "delâlet-i mutabıkıyye" ile delâlet ettiği gibi, bey'in helâl, fâizin haram olduğuna da yine "delâlet-i mutabıkıyye" ile "bi-l işâre" delâlet etmiş olur. Yine bunun gibi bir malın abde verilmesini veya verilmemesini isteyen bir kimseye karşı "Bu malı hiç bir şahsa vermem" sözü bu malın abde verilmeyeceğine "delalet-i tazammuniye ile" "bi-l işare" delâlet eder.)"Evlâdın nafakaları mevludün leh üzerinedir" ibâresi de çocukların neseblerinin, babalarından sâbit olacağına delâlet-i iltizâmiye ile bil-işâre delâlet eder. çünkü, babanın mevlüdün leh olması, nesebin kendisinden sübutunu müstelzimdir." (îst. Fık. K.)
dalle: Evini bilmeyip başka yere giden davar.
dallîn ‘ƒ™ÿ›: (Dâllûn) Sapkınlar. Müslümanlıktan ayrılanlar. Kur'an hakikatlerinden ayrılıp sapanlar.
dallîyet šƒ™™ÿ…: Delil oluş. îsbata vâsıta olmak.
dâm šƒš: f. Tuzak. ağ, hile.
dam' šš”: (C.: Dümu-Edmu) Helâk olmak. * Göz yaşı.
dâm-i ankebut: f. örümcek ağı. örümcek tuzağı.
dâm-i belâ: Bela tuzağı.
dama: Deniz, bahr.
damacana: Su veya başka sıvıları taşımaya mahsus dar ağızlı, şişkin gövdeli çoğu hasırla sarılı veya sepetli büyük şişe.
damar šƒšƒœ: t. îstidad. Huy, tabiat, inat. * însan bedeninde kanın dolaştığı yollar, şiryan. * Irk. * Toprağın içindeki maden filizleri ve su tabakası. * Damar veya köke benzeyip bir cismin her tarafına uzanan yollar. * Mermer ve ona benzer dalgalı şeylerdeki çizgiler.
damd: Yaranın üstüne bez bağlamak, merhem sürmek.
damecmec: Katı, şedid. * Uzun boylu bahil kimse.
damed: Hışım etmek, öfkelenmek, hiddetlenmek, kızmak.
dâmen šƒš›: f. Etek. Kenar. Taraf. Zeyl. Elbise veya dağ eteği.
damen-bus: f. Etek öpen.
damen-gîr: f. Eteğe yapışan, etek tutan. * Dâvacı, hasım, şikâyetçi.
dâmen-î muallâ šƒš›ó‚š”™ƒõ: Yüksek şerefli dâmen, muallâ etek. * Mc: Yüksek namus sâhibi.
damen-keş: f. Feragat eden, eteğini çeken.
damene: f. Dağ eteği, dağın çevresi.
damenî: f. Eteklik. * Kadın başörtüsü.
damga ’ƒš•œ: Bir şeyin üzerine işaret veya alâmet koymak. * îşaret vurulan âlet. Mühür.
damga-î vahdet ’ƒš•œ£‚ˆš…: f. Birlik damgası. Cenab-ı Hakkın birliğini gösteren delil.
damhar: Mütekebbir, kibirli, terbiyesiz kimse.
damiz: Hayvan üretmeye mahsus dam. Hayvan yetiştirilecek ahır.
damîa: Yavaş olarak ve damla damla kan sızdıran yara.
damîc: Karanlık.
damîğa šƒš•œ: Dimağa işlemiş olan baş yarığı. (Bak: Amme)
damîk: (C.: Devâmik) Belâ, musibet, dâhiye. Meşakkat, zahmet.
damîme: (C.: Damâyim) Sonradan yapıştırılmış şey.
damîn ‘ƒš›: Kefil olan, tazminat veren. ödeyen.
damîne: Köyde olan hurma.
damîr: (C.: Damâr) Kalb. * Niyyet.
damîr: Zayıf, ince.
damîse šƒšžœ: örten, setreden. Defneden.
damîye: Tıb: Kanı akan yara.
damm: Yapıştırmak. * Düşürmek.
dammad: Hastalara efsun okuyan kimse.
dampîng: ing. Bir pazarı elde etmek veya bir malı elden çıkartabilmek için benzerlerinden çok düşük fiyatla satma.
damz: Susmak, sükut etmek.
damzer: (C.: Damazir) Sütü az olan deve. * Sağlam ve sert yer. * şişman kadın.
dan šƒ›: Arabca, Farsça veya bazı Türkçe kelimelerin sonuna takılarak, âlet ismi veya sıfat yapılır. Meselâ: Ateş-dan $ : Mangal. Cüz-dan $ : Cüz kabı, çanta.
dan šƒ›: f. Tane.
dânâ šƒ›ƒ: f. Bilgili, bilen, malûmatlı, âlim.
dânâ-î bî-müdanî šƒ›ƒ£‚„ÿššƒ›ÿ: Eşsiz âlim. Zamanında emsali olmayan âlim.
dânâ-î yunan šƒ›ƒ£ó‚ÿ›ƒ›: Eflatun.
dânâyî: f. âlimlik, bilicilik.
dane šƒ›œ: f. Tohum, çekirdek. * Kurşun, gülle, tâne.
dane šƒ›: (Diyn. den) "îtaat etti. îtaatli oldu, boyun eğdi, aziz oldu" mânasında fiil.
danende: f. Bilgin, bilen, Haberli.
dang: f. Bir dirhemin altıda biri.
danik: (C.: Devânik) Bir dirhemin altıda biri ve iki kırât ağırlığı. (Her kırat beş arpa ağırlığıdır.) * Zayıf düşkün davar.
daniştay: (Bak: şurâ-yı devlet)
danî': Hor, zelil.
danîk: Bir dirhemin dörtte biri. * Mangır.
danîk: Nezle.
danîsten: f. Bilmek.
dânîş: f. Bilgi, ilim. Biliş.
dânîş-gede: üniversite.
dânîş-ger: f. Alim, bilgin.
danîşî: Alim, bilgin, bilgili.
danîşmend: (C.: Dânişmendân) f. Bilgili, ilimli. * Tanzimattan evvel, kadıların yanında stajyer olarak çalışan kimseler için kullanılan bir tâbirdi.
danîye šƒ›ÿœ: Yakında olan.
dank: (Dunuk) Darlık, dıyk.
danka' ‘›˜ƒ£: Dar, sıkıntı. Zararlı, zarara sebeb olan.
dantela šƒ›…œ‚™ƒ: Fr. Tentene. Her nevi iplikle örülen, bir kumaşın kenarına işlenen türlü biçimde ince örgü, dantel.
danu': Evlâdı çok olmak.
danv: Oğul ve kız, veled.
dâr šƒœ: Yer, mekân, konak.
dâr šƒœ: f. Sâhib, mâlik, tutan (mânasındadır.) Meselâ: Bayrakdâr $ : Bayrak tutan.
dar' ‘œ”: (C.: Durâ-Duru) Davar emziği.
dar' šœ£: Men'etmek, engel olmak. * Ansızın haberli olmak. * Eğrilik.
dâr ü gîr: Kavga, savaş, muharebe, harp, ceng.
dar-baz: f. Canbaz.
dâr-i beka šƒœ„—ƒ£: f. âhiret. Bâki olan yer. (Mâdem dünyada hayat var, elbette insanlardan hayatın sırrını anlayanlar ve hayatını su-i istimâl etmeyenler, Dâr-ı Beka'da ve Cennet-i Bâkiye'de hayat-ı bâkiyeye mazhar olacaklardır. L.)
dâr-i cînan šƒœ‚‡›ƒ›: f. Cennet yurtları. Cennetler.
dâr-i dünya šƒœ‚š›ÿƒ: f. Bu dünya memleketi. Dünya. (Dâr-ı fenâ da denir.)
dâr-i emân: Müslümanların zimmetini kabul eden veya müslümanlarla sulh halinde olan, gayr-i müslim bir ahalinin memleketi.
dâr-i fenâ šƒœó‚–›ƒ: Dünya. Bu dünya.
dâr-i îmtîhan šƒœó‚¦š…ˆƒ›: îmtihan yeri. * Dünya. * Dar-ı mihnet, meydân-ı ibtilâ gibi tâbirler de aynı mânada kullanılır. (Bak: îmtihan)(Din bir imtihandır. Teklif-i îlâhi bir tecrübedir. Tâ, ervâh-ı âliye ile ervâh-ı sâfile, müsabaka meydanında, birbirinden ayrılsın. Nasılki: Bir mâdene ateş veriliyor tâ, elmasla kömür, altınla toprak birbirinden ayrılsın. öyle de, bu dâr-ı imtihanda olan teklifat-ı îlâhiyye bir ibtilâdır ve bir müsabakaya sevktir ki; istidad-ı beşer madeninde olan cevâhir-i âliye ile mevadd-ı süfliyye, birbirinden tefrik edilsin. Mâdem Kur'an, bu dâr-ı imtihanda; bir tecrübe suretinde, bir müsabaka meydanında, beşerin tekemmülü için nazil olmuştur. Elbette şu dünyevi ve herkese görünecek umur-u gaybiye-i istikbâliyeye yalnız işaret edecek ve hüccetini isbat edecek derecede akla kapı açacak. Eğer sarahaten zikretse; sırr-ı teklif bozulur. S.)
dâr-i rîdde šƒœ‚œšœ: Aslında Müslim iken sonradan irtidâd eden veya bir zaman îslâmiyeti kabul etmiş iken sonradan mürted olan şahısların hâkim bulundukları yer.(Darürridde, yani: Mürtedlerden müteşekkil bir taifenin istilâ ederek hakimiyetleri altına aldıkları yerler, bazı ahkâm itibariyle dar-ı harbden ayrılır. Meselâ: Dar-ı harb ahalisiyle musalâha akdi caiz olduğu hâlde, darürridde ahalisiyle caiz olmaz. çünkü riddetin devamına cevaz verilemez. şu kadar var ki, bunlar bir müddet düşünmek için mütareke talebinde bulundukları takdirde bakılır. Eğer müslümanların hakkında hayırlı görülürse bu mütarekeye muvafakat edilir. Ve eğer harb edilmesi daha muvafık görülürse bu mütarekeye muvafakat edilmez.Mütâreke kabul edildiği takdirde mukabilinde bir bedel, bir haraç alınamaz. Zirâ bu hâlde mütareke, bir akd-ı zimmete müşabih olur. Halbuki mürtedler, zimmete kabul edilemezler. Bu mütarekenin öyle iki-üç günlük, geçici bir zaman için olması icab etmez. Buna lüzumuna göre bir mühlet tayin edilir. (Ist. Fık. K.)
dâr-i şura-yi askerî: 1296 yılında lağvolunan bu yüksek askeri meclis 1253 yılının muharrem ayında kurulmuştu. 1259 tarihinde çıkarılan kanun ile vazifesi tesbit edildi. Askeri ve mülki ricâlden onbir daimi, altı tane ise geçici azası bulunan bu mecliste bir reis ve bir de müftü yer alıyordu.
dâr-i teklîf šƒœ‚…˜™ÿ–: Dünya. Allah'ın teklif ve emirleri ile vazifeli olduğumuz yer olan dünya. (şu dâr-ı dünyâ meydân-ı imtihandır. Ve dâr-ı tekliftir. Hizmet yeridir. Lezzet ve ücret ve mükâfat yeri değildir. S.)
dâr-i zîmmet šƒœ‚‹š…: Müslümanların, ahid ve emânını ve himayesini kabul etmiş oldukları; gayr-i müslimlere mahsus yerler.
dâr-ul belvâ: Dünya, imtihan yeri. Belâ ve musibet âlemi.
dâr-ül amân: Sığınılacak, korunulacak yer.
dâr-ül cîhad šƒœ‚ƒ™‡œƒš: îslâm sınırlarının haricindeki ülkeler.
dâr-ül harb šƒœ‚ƒ™ˆœ„: (Bak: Dârülharb)
dâr-ül hîcre: Hicret edilen yer. Medine şehri.
dâr-ül hîkmet šƒœ‚ƒ™ˆ˜š : Hikmet yeri. Hikmetlerin hükmettiği, hikmet beşiği dünya. * Osmanlı devrinde şeyh-ül îslâmlık makamının bir ismi.
dâr-ül hîlâfe šƒœ‚ƒ™‰™ƒ– : Hilâfet Merkezi. Halifenin bulunduğu yer. (Osmanlılar devrinde îstanbul idi ve bir ismi de Dersaâdet idi)
dâr-ül huld šƒœ‚ƒ™‰™š: Baki olan yer. Cennetin bir bahçesi. Cennet.
dâr-ül îkab šƒœ‚ƒ™”—ƒ„: Cehennem. çok azab çekilen yer.
dâr-ül îslâm šƒœ‚ƒ™ƒž™ƒš: (Bak: Dârülislâm)
dâr-ül karar šƒœ‚ƒ™—œƒœ: Kararlı surette kalınan, kıyametten sonraki yer. Cennet. Dâr-ül Beka.
dar-ül kütüb šƒœ‚ƒ™˜…„: f. Kütübhâne, kitab evi.
dâr-ül maarîf šƒœ‚ƒ™š”ƒœ–: Sultan Mecid zamanında Valide Sultan'ın îstanbul'da Sultan Mahmud türbesi civarında yaptırmış olduğu mekteb.
dâr-ül mesaî šƒœ‚ƒ™šžƒ”ž: çalışma yeri. Mesai yeri. Atölye.
dâr-ül mülk šƒœ‚ƒ™š™˜: Başkent, baş şehir.
dâr-ül ulm šƒœ‚ƒ™”™š: îlimler yurdu. Medrese. Ders görülen yer.
dar-ül-aceze: Düşkünler, acizler evi. Yoksullar yurdu.
dar-ül-fünun šƒœ‚ƒ™–››: üniversite. (1 Ağustos 1933'de îstanbul Dâr-ul Fünunu yerine üniversite kurulmuştur.)
dâr-ün nedve šƒœ‚ƒ™›šœ: Müslümanlıktan evvel, Kureyş kabilesinin münakaşalar için toplandığı bir yerin adı olup, Kusey ibn-i Kilâb tarafından kurulmuştur. (Sonradan Hz. Muhammed'e (A.S.M.) karşı bulunanların toplanmalarından dolayı fesat ve münafıkların toplandıkları yer mânâsına kullanılmaya başlanmıştır.)
dâr-üs saâde: Saâdet yeri, saray.
dâr-üs saltana(t): Saltanat yeri. îstanbul.
dar-üs selam šƒœ‚ƒ™ž™ƒš: Cennetin ikinci katı. * Cennet. Selâmet yeri.
dâr-üs selâm šƒœ‚ƒ™ž™ƒš: Cennet. Selâmet ve eminlik yeri. * Bağdatın eski ismi.
dâr-üs sihha: Hastahâne.
dâr-üş şîfâ: şifa yurdu, sağlık yurdu. * Tımarhâne.
dar-üş-şafaka: îstanbul'da yetim ve öksüzler için kurulmuş olan yatılı lise.
dar'a' šœ”ƒ£: Başı siyah, gövdesi beyaz olan davar. (Müz: Edrâ.)
dara šƒœƒ: f. Eski Fars hükümdarlarından dokuzuncusu Keykubat'ın bir ismi. * Hükümdar. * Cenab-ı Hakk'ın bir ismi.
dara' ‘œƒ£: Düz yer. * Birbirine girmiş olan sık bitmiş ağaçlar.
dara' ‘œ”: Zayıf. Zelil, hakir. * Muti, itâat eden, boyun eğen.
daraa: Tevazu etmek, alçak gönüllü olmak. * Emre uymak, muti olmak. * Zayıf ve zelil olmak.
darab: Koyu beyaz bal.
daraban: Vurma, vuruş. çarpış, çarpıntı, çarpma.
daraban-i kalb: Kalb çarpıntısı, kalbin vuruşu.
darabât ‘œ„ƒ…: (Darbe. C.) Vuruşlar. çarpmalar. Vurmalar.
darabât-i anîfe: şiddetli vuruşlar.
darabîne: Kapı bekçileri.
darafe: çokluk, kesret.
darağaci šƒœ‚ƒ•ƒ‡ÿ: t. îdama mahkûm olanların asıldıkları sehpa.
daragim: (Dırgam. C.) Arslanlar, esedler, dırgamlar.
daraka: (C.: Derk- Edrâk-Dırâk) Deriden yapılmış olan kalkan. * Gırtlağın hançereyi meydana getiren kıkırdaklarından kalkan şeklinde olanı.
darame: Ucu ateşli kuru ot ve odun.
darare: Gözsüzlük.
daras: Ekşi yemekten dolayı dişin kamaşması.
darat: f. Debdebe, tantana, şan, gösteriş, çalım.
daravet: Adet, alışıklık, alışkanlık.
darayî: f. Sahib, mâlik olma. * Hüküm sürme, hâkimiyet kurma. * Bir nevi kumaş.
darb šœ„: (C.: Dürub) Kapı, bâb. * Büyük, geniş sokak. * Dâr-ı îslâmla dâr-ı harp arasında olan sınır ve hudut.
darb ‘œ„: (C.: Durub-Edrub) Vurmak, vuruş, çarpmak. * Beyan etmek. * Seyretmek. * Nev, cins. * Benzer, nazir. * Eti hafif olan.
darb-i hîyâm: çadır kurma.
darb-i mesel ‘œ„‚š†™: Misâl olarak söylenen meşhur söz. Bir hâdiseye binaen söylenen hikmetli söz. Ata sözü.
darb-i sîkke: Para basma.
darb-i unk: Boyun vurma.
darb-zen: f. Mâdeni levhalar üzerine kabartma olarak nakışlar işleyen. * Kale döven.
darbam: f. Direk, kiriş.
darbe ‘œ„œ: (C.: Darabât) Vuruş, vurma, çarpma. * Musibet, belâ, âfet, felâket.
darbeha: Başını aşağı eğmek. * Muti olmak, itaat etmek, söz dinlemek.
darbele: Bir yürüme çeşidi. * Davul çalmak.
darben: Döğerek, vurarak. * çarparak.
darbhane ‘œ„‚‰ƒ›œ: Para basılan yer.
darbîz: Rutubetli tarla, sulak yer.
darbum: Bizanslılar zamanında Eskişehir'in ismi.
darc: Yarmak, şakk.
dare: f. Vazife, görev, ödev.
darende: f. Saklayan, tutan. * Ulaştıran, vâsıl eden, kavuşturan, getiren.
dareyn šƒœÿ›: Her iki dünya. îki yurd. îki yer.
darh: Def'etmek, kovmak. Reddetmek. * Yer kazmak.
darit: Yellenen, yellenici.
darî šƒœÿ: Ot ve yem satan kişi. * Evinden çıkmayan kimse.
darî' ‘œÿ”: Hurma dikeni. Acı ve dikenli bir ağaç.
darî' šœÿ”: Adımı geniş olan kişi.
darîb: (Darb. dan) Sütünü sağan kimseye vuran dişi deve. * Ağaçlı yer. * Karanlık gece. * Vurucu, vuran. Darbeden, çarpan. Döven.
darîbe: Tabiat. * Kılıçla vurulmuş. * Eğrilmiş yün.
darîc: Katı, şedid, şiddetli.
darîce: Ay ve güneş ağılı. (Farsçada "hâle" denir.)
darîh ‘œÿˆ: Kabir. Mezar.
darîm ‘œš: Aç. * Tavşancıl yavrusu.
darîm ‘œÿš: Yanmış nesne. * Dövülmemiş harman. * Odun ufağı.
darîn: Bir yerin adı.
darîr ‘œÿœ: (C.: Edirrâ) Kör, a'mâ. * Nefis. * Cismin bakiyyesi. * îri vücutlu fakir kişi.
darîs: (Dürus. dan) Yıkılmış, mahvolmuş.
darîs ‘œž: çetin huylu kimse.
darîş: Siyaha boyanmış kara deri.
darîyye: f. Divan şairlerinin, dünyevi makamca büyük olanların yaptırdıkları köşk ve konaklara dair yazdıkları manzume.
darm ‘œš: şiddetli açlık. Oburluk. * Ateşin yakması.
darr šœ: Süt, leben. * Nüzul. * Hayır ve amel çokluğu.
darr ‘œ: Zarar, ziyan.
darr ‘ƒœ: Zararlı, zararı olan.
darra ‘œ¥£: şiddet, mihnet. Belâ. Naks. Ziyan. Sıkıntı. Kötürümlük.
darrab: Akça kesici, dârp edici, para basan.
darre: Bir miktar süt.
dars: Dişiyle tutup ısırmak.
dart: Yellenmek. * Tez olmak.
daru: f. îlâç, deva, tiryak.
daru-berd: f. Debdebe, ihtişam.
daru-hane: f. îlâç satılan yer, eczahane.
darül harb šƒœ‚ƒ™ˆœ„: (Dâr-ül harb) Harp yeri. Müslümanlarla gayr-i müslimler arasında sulh akdedilmemiş memleket. Kâfirlerin ve onların gayr-i islâmi hükümlerinin hâkim olduğu yer. (Bak: şeair.)
darül hîkmetîl îslamîye: (Dâr-ül Hikmet-il îslâmiye) Bu teşkilât, son devirlerde gerek imparatorluk ve gerekse îslâm Aleminde ortaya çıkan bir takım dini mes'elelerin halli ve îslâma yapılan hücumların îslâm ahkâmına göre cevaplandırılması için 12 Ağustos 1334 (25 Ağustos 1918) tarihinde 5. Mehmed Reşat ve şeyhülislâm Musa Kâzım Efendi'nin zamanda kurulmuştur.Ayrıca halkın her türlü dini ihtiyaçlarını, ilmi bir metodla yerine getirmek için her türlü neşriyat ve beyannameleri ele almakta ve halkımızı dahili ve harici tehlikelere karşı tenvir etmekteydi. Ecnebilerin sordukları suallere, komisyonlarda görüşülmek suretiyle resmen cevap verildiği gibi; müracaat eden her müslümana da gerekli cevap veriliyordu.Osmanlı împaratorluğu'nun karışık ve Avrupa hayranlığının devlet müesseselerinin her kademesinde revaçta olduğu bir zamada, ahlâk ve imanı elde tutmak, bu teşkilâtın en başta gelen vazifelerinden biri idi.Matbuatta îslâma yapılan hücumlara ve îslâmı, hurafeler dini gibi göstermeğe çalışan yazarlara gerekli cevaplar veriliyor ve cezalandırılmaları için de Dahiliye Nezareti'ne resmen müracaat ediliyordu.Bu teşkilâta tâyin olunan azalar azil, tâyin, istifâ ve vefatlarla 28 kadardır. Aslında, dokuz aza, bir reisten teşekkül ediyordu. Bu zâtların tâyinleri gelişi güzel olmadığı gibi, bu teşkilâtın içinde mevcut bulunan üç komisyondan birine (fıkıh, kelâm ve ahlâk) girebilecek ilmi kariyere (meslek) sahip olmaları icab ediyordu.Bu müesseseye "îslâm Akademisi" veya "Yüksek îslâm şurası" da diyebiliriz. Kuruluşu ile son derece faydalı ve o nisbette hizmetleri olmuş bir teşkilâttır. Fakat kuruluş tarihi olan 1918'den 1922'ye kadar devam etmekle, ancak dört senelik bir faaliyeti olmuştur.
darül îslam šƒœ‚ƒ™ƒž™ƒš: (Dâr-ül îslâm) îslâmiyet merkezi. Müslümanların hâkim olduğu yer.
darvîncîlîk: 19. yy.da yaşamış îngiliz düşünürü Darwin'in kurduğu bir nazariye, görüş. "Evrim teorisi: Tekâmül nazariyesi" adıyla da anılan bu görüşe göre; insan dâhil bütün canlıların başlangıçta tek hücreli canlı olarak meydana geldiklerini, sonra tesadüfen nesilden nesile farklılaşıp başkalaştığını, bu tesadüfi değişikliklerden çevre şartlarına uygun olanlara sahip canlıların yaşadığını, diğerlerinin yok olduğunu, böylece canlıların gittikçe mükemmelleşerek bugünkü şekle girdiğini, insanın da maymun soyundan geldiğini iddia eder. Bu iddianın ortaya atıldığı zamanlarda canlı hücrenin kimyasal ve genetik yapısı bilinmiyordu. Hücre, canlının basit bir yapı taşı zannediliyordu. Bugün elektromikroskoplar sayesinde canlının kimyasal ve genetik yapısıyla ilgili büyük ve önemli keşifler yapıldı. Canlıların sahip oldukları vasıfların hücre çekirdeğinde yer alan ve genlerin yapısını meydana getiren DNA denilen protein moleküllerinde nasıl muhafaza edildiği ve bunların nasıl babadan oğula geçtiği açıklanmıştır. Gerek genlerin, gerek hücrenin yapısında yer alan çeşitli protein molekülleri 20 çeşit amino asit adı verilen daha küçük parçacıkların çeşitli şekilde birleşmesinden meydana gelmiştir. Amino asitlerin meydana gelişi bir yana DNA moleküllerinin ve diğer protein moleküllerinin herbirinin tesadüfen meydana gelip gelemiyeceği matematik olarak hesaplanmıştır. Bir hücredeki tek bir molekülün meydana geliş ihtimali 1 sayısının önüne 240 tane sıfır koyarak elde edilen sayı kadar molekül meydana gelse bunlardan yalnız biri işe yarıyan bir molekül olabilirdi. Tesadüfen bu kadar çok sayıda kimyasal birleşim olabilmesi için kâinatın ömrünün trilyonlarca defa daha fazla zamanın geçmesi gerekir. Daha doğrusu imkânsızdır. Canlı hücrenin bütün moleküllerinin bu şekilde tesadüfen bir araya gelip hücreyi meydana getirmelerini hayal etmek bile imkân dahilinde değildir.Tesadüfen bir hücrenin meydana gelişini açıklamak imkânsız olunca yer yüzündeki bunca canlının tesadüfen meydana geldiğini iddia etmek ise ilim ve akıl dışı bir vehimden başka birşey değildir. îlim adamlarının laboratuvarda yaptıkları çalışmalar sonunda bir canlının değişip başka bir canlı haline gelemiyeceği de ispatlanmıştır. Sirke sineği üzerinde yapılan deneyler sonunda sinekten daha mükemmel bir canlı meydana gelmemiş, aksine kesik kanatlı, hastalıklı, sakat bir yavru sinek doğmuştur. Canlılar "mütasyon" denilen bir kazaya uğradıkları zaman ancak sakat bir yavru meydana geliyor. Kazaya uğrıyan bir araba, jet uçağına dönüşmez, sadece kazalı bir araba meydana gelir. Tek hücreyi yaratan da insanı yaratan da birdir. O da atomdan yıldızlara kadar her varlığın yaratıcısı olan Allah'tır.
darzem: Sütü az deve. * çok ısırıcı olan yılan.
darzeme: çok ısırmak.
da's š”†: Titremek. * Zayıf olmak, zayıflamak.
da's š”ž: Cimâ etmek. * Süngü ile vurmak. * Az olan nesne ve eser.
dâs šƒž: f. Orak. * Tuzak. * Sedef otu.
dâs-i zerrîn: Altın orak. * Mc: Yeni ay.
da'sa: Güneşten çok ısınan yumuşak, çukur yer.
da'sa: Yumuşak yer.
dasar: (Dâstâr) f. Tellal, simsar.
dasdasa: Depretmek, tahrik.
dase: f. Orak.
da'sere: Yıkmak.
dâsîtân šƒž…ƒ›: (Dâstân) f. Destan, sergüzeşt. Geçmiş hâdiseleri anlatan nesir veya nazım halinde yazı. * şöhret.
dâsîtâne-î aşk šƒžƒ›œý‚”—: Aşk hikâyesi ve destanı.
daş: îsimlerin sonlarına eklenerek eşlik, refakat ve ortaklık bildirir. Meselâ: Arka-daş $ : Refik.
da'şere: Yıkmak.
daşte: f. Köhne, harab olmuş, eskimiş, yıpranmış. * Mâlik olmuş.
daşten: f. Tutmak, elde etmek, mâlik olmak, zimmetine geçirmek. * Zabtetmek, gasbetmek, almak. * Görüp gözetlemek. * Eskimek, yıpranmak, harab olmak, köhneleşmek.
dav' ‘”: Hoş kokular kokmak. Depretmek.
dav': şule, ziya, ışık.
dav' š”: Kaymağı alınmış sığır sütünden yapılmış ekşi yoğurt ve ayran.
da'vâ š”ƒ: Takib edilen fikir, iddia. * Bir kimsenin hakkını aramak üzere mahkemeye müracaat etmesi. * Hakkı olanın iddia etmesi. Kendini haklı görüp veya zannedip üstün fikirlilik iddia etmek. * Mes'ele. * înat. Ayak diremek. * Cenab-ı Hak'tan hayır ve rahmet dilemek. * Bir kimseyi bir şeye sevketmek. * Birisinin hâkimin huzurunda başka birisinden hak istemesi.
dava vekîlî š”ƒ‚˜ÿ™ž: Baro teşkilatının olmadığı yerlerde kanuni izin ile vekil sıfatı kazanan ve dava takibine salâhiyeti olan kişi.
da'vâ-yi halk š”ƒÿ‚‰™—: Yaratmak iddiasında bulunmak, halk etmeyi, yaratmayı dâva etmek. (Kâinatta hiçbir kimse da'vâ-yı halk ve iddia-yı icad edemez. Halk eden ancak Cenab-ı Hak'tır.)(Arzı ve bütün nücum ve şümusu tesbih taneleri gibi kaldıracak ve çevirecek kuvvetli bir ele mâlik olmıyan kimse, kâinatta dâva-yı halk ve iddia-yı icad edemez. Zira her şey, her şeyle bağlıdır. H.)
da'vâ-yi nübüvvet: Peygamberlik dava etmek. Peygamber olduğunu ilân etmek.
davaci š”ƒ‡ž: t. Dava açan.
davahî ‘ƒˆÿ: Memleket köşeleri.
davahî-s seb': Yedi kat gök.
da'vat š”ƒ…: (Duâ. C.) Duâlar, niyazlar, çağırışlar. (Bak: Ed'iye)
davat ‘ƒ : Devenin başında olan verem.
davban: Güçlü, büyük deve.
davc: (C.: Edvâc) îki şeyin birbirine eğilip ulaşması.
davda': Meş'ale. * însan sesleri.
dâver: Cenab-ı Hakk'ın (C.C.) bir ismidir. * âdil, insaflı ve doğru olan hükümdar, vezir veya hâkim.
dâverâne: f. Doğruluk ve adaleti seven bir büyüğe yakışacak tarzda. * Hâkim ve vezirle alâkalı olan.
dâverî: f. Hâkimlik, hükümdarlık. * Mahkeme ve dâvâ. * Kötü ile iyiyi birbirinden ayırt etme. * Kavga, mücadele.
da'vet š”…: çağırma. Ziyafet. Duâ. * Bir fikri kabul ettirmek için deliller söylemek.
davîta: Havuzun dibinde olan balçık. * çöküklük. * Suyu çok olduğundan elde durmayan sıvı hamur.
davîye: Otsuz çöl.
davkaa: şişman ve ahmak olan kimse.
davlumbaz: çarkları yandan olan vapurlarda çarkların döndükleri yerleri örtmek için vapurun iki tarafında bulunan iki büyük yarım daire.
davmeran: Fesleğen denilen iyi kokulu çiçek.
davr: Ziyan etmek, zarara girmek.
davta: Fakir.* Gövdeli, cesim.
dâvud (a.s.): Kur'an-ı Kerim'de ismi geçer ve Beni îsrail Peygamberlerindendir. Hz. Süleyman'ın (A.S.) babasıdır. Hem Peygamber, hem Sultandı. îbranice Zebur kitabı kendisine nâzil olmuştur. Sesi çok güzeldi. M.ö. 1010 da vefat ettiği nakledilir. (Bak: Yuşa)(Telyin-i hadid, en büyük bir ni'met-i îlâhiyyedir ki; büyük bir peygamberinin fazlını, onunla gösteriyor. Evet, telyin-i hadid, yâni demiri hamur gibi yumuşatmak ve nühâsı eritmek ve mâdenleri bulmak, çıkarmak; bütün maddi sanâyi-i beşeriyyenin aslı ve anasıdır ve esası ve mâdenidir. îşte şu âyet işaret ediyor ki: "Büyük bir Resule, büyük bir Halife-i Zemine, büyük bir mucize suretinde, büyük bir ni'met olarak; telyin-i hadiddir ve demiri hamur gibi yumuşatmak ve tel gibi inceltmek ve bakırı eritmekle ekser sanâyi-i umumiyeye medar olmaktır." Mâdem bir Resule; hem halife, yâni hem mânevi hem maddi bir hâkime, lisanına hikmet ve eline san'at vermiş. Lisanındaki hikmete sarihan teşvik eder. Elbette elindeki san'ata dahi tergib işareti var. Cenâb-ı Hak, şu âyetin lisan-ı işaretiyle mânen diyor:"Ey beni-âdem! Evâmir-i teklifiyeme itâat eden bir abdimin lisanına ve kalbine öyle bir hikmet verdim ki; herşey'i kemâl-i vuzuh ile fasledip hakikatını gösteriyor ve eline de öyle bir san'at verdim ki; elinde balmumu gibi demiri her şekle çevirir. Halifelik ve pâdişahlığına mühim kuvvet elde eder. Mâdem bu mümkündür, veriliyor. Hem ehemmiyetlidir. Hem hayat-ı içtimâiyenizde ona çok muhtaçsınız. Siz de evâmir-i tekviniyeme itâat etseniz o hikmet ve o san'at, size de verilebilir. Mürur-u zamanla yetişir ve yanaşabilirsiniz." îşte beşerin san'at cihetinde en ileri gitmesi ve maddi kuvvet cihetinde en mühim iktidar elde etmesi; telyin-i hadid iledir ve izâbe-i nühas iledir. âyette nühas "kıtr" ile tâbir edilmiş. şu âyetler, umum nev-i beşerin nazarını şu hakikate çeviriyor ve şu hakikatın ne kadar ehemmiyetli olduğunu takdir etmeyen eski zaman insanlarına ve şimdiki tenbellerine şiddetle ihtar ediyor... S.)
davudî: Hz. Davud'un (A.S.) sesini andıran kalın gür ses.
davve: Ses, sadâ.
davvî: Yurt tutmak.
davy: Arıklık. * Zayıflık.
davz: Zulmetmek, zulüm yapmak. * çiğnemek.
daye šƒÿœ: çocuk hizmetçisi. çocuğa süt veren. Dadı. Mürebbi.
dayet: Yan, taraf, cenb.
dayf: (C.: Ezyâf-Zuyuf-Zayfân) Misafir. * Meyletmek, yönelmek.
dayfen (dayfân): Misafiriyle gelen kişi.
daygam: Arslan, esed. * Isırmak.
dayi šƒÿž: Tunus ve Cezayir'in, Osmanlı idaresinde bulunduğu sıralarda buraları Osmanlılara tâbi olarak idare eden kimselere verilen ünvan. * Annenin erkek kardeşi.
dayîb: îtaat eden, vakarlı ve ciddi kişi.
dayîban: Gece ile gündüz.
dayîc: Kovayla kuyudan su çekip havuza boşaltan kimse.
dayîn šƒÿ›: Borç veren. Alacaklı. ödünç para veren. (Bak: Dâin).
dayîne: (C.: Davâyin) Dişi koyun.
dayîs: (C.: Dâsse) Hırsız.
daym ‘ÿš: Zulüm. Sıkıntı. îhtiyaç.
dayyik: Pek dar.
da'z: Cimâ etmek.
da'z: Noksanlaştırmak.
da'z: Def'etmek, kovmak. * Nikâh etmek.
deaîm: (Dıâme. C.) Destekler, payandalar, direkler.
deavî š”ƒÿ: (Davâ. C.) Dâvalar, mes'eleler.
de'b š¤„: Bir işde devam ve iltizamla emek çekip çalışmak. * Adet, usul, tarz, kaide. * şân. * Emir. * Kâr. * Tardeylemek.
deb' š„”: Yumuşak yer. * Kuvvetle basmak.
deb' š„¢: Vurmak, darb.
de'b-î edeb š¤„‚ƒš„: Edebi usul, kaide. Edeb kaidesi. Edebiyat âdeti, şekli, tarzı.
debabîc: (Dibâc. C.) Dallı, çiçekli ipek kumaşlar.
debabîs: (Debbus. C.) Topuzlar.
debabud: îki ırgaçla dokunan bir bez cinsi.
debar: Mahvolmak. Helâk olmak.
debat: (C. Debâ) Uçmayan çekirge.
debb: Hareket etmek. * Ağır ağır yürümek.
debbabe: Kale duvarlarını oymaya yarayan bir savaş aleti. Tank.
debbağ: Derileri sepileyip meşin, sahtiyan, kösele vesaire yapan.
debbe: (C.: Debbât) Matara dedikleri su kabı. * Yağ. Bal ve macun koyacak kaplar.
debbus: (C.: Debâbis) Topuz.
debdab: f. şan, şöhret. Azamet, haşmet, cesamet.
debdebe š„š„œ: Gürültü, patırtı. Gösteri için yapılan gürültü. Tantana. Haşmet.
deber: Savaşırken askerin bozulması, bozguna uğraması.
debeş: Evin esası.
debh: Belini büküp eğildiğinde, başını öne doğru fazlaca eğmek.
debîb: Yürümek. * Harekete geçmek.
debîr: f. Müsteşar. * Kâtib, yazıcı.
debîstan: f. Mekteb, okul.
debkel: Bir araya toplanmış mal. * Derisi kalın, çirkin kimse.
debl: Küçük eşek. * Toplamak, cem'etmek. * Islah etmek.
debr: (C.: Dübur) Oğul kız topluluğu. * Bal arısı.
debre: (C.: Deberât-Dibâr-Edbür) Savaşırken askerin bozulması. * Bir evlek yer. * Vaktinden sonra gelmek.
debretmek š„œ…š˜: t. (Tepretmek) Kımıldatmak, harekete getirmek, oynatmak.
debs (dîbâs) š„ž: Dibekde buğday döğmek.
debsa': çok fazla kırmızı olduğundan, siyah gibi görünen şey.
debş: çekirgenin ot yemesi.
debub: Semizlik ve şişmanlığından dolayı yürüyemeyen deve.
debur: Batı rüzgârı. * Fırak, ayrılık. * Halef etmek.
debus: f. Topuz.
decac: (C.: Dücüc) Tavuk. * Horoz, tavuk ve piliç cinsi.
decace: (Dücâce, dicâce) Tavuk.
decc: Tavuğu çağırmak.
deccal š‡ƒ™: Hakkı bâtıl, bâtılı hak olarak gösteren. (Deccal'ın Cennet dediği Cehennem gibi, Cehennem dediği de Cennet gibi olacağı rivâyet edilir. Sahih hadislerin ihbarı ve din büyüklerinin izah ve kabulleri ile, âhirzamanda gelecek ve Risâlet-i Ahmediyeyi inkâr edip îslâmiyeti tahribe çalışacak ve dünyayı fesâda verecek çok şerli ve küfr-ü mutlak yolunda olan dehşetli bir şahıstır. Bir hadis rivâyetinde üç deccal, diğerinde yirmiyedi deccal geleceği Peygamberimiz Aleyhissalâtü Vesselâm tarafından bildirilmiştir. âlem-i îslâmda muhtelif zamanlarda çıkmış olan dehşetli din düşmanlarının ve anarşiye hizmet edenlerin umumu da rivâvetleri tasdik etmektedir. Bu din yıkıcılığının âhirzamanda daha dehşetli olacağı bildirilmektedir. şu son asırda görülen ve dünyayı tehdit eden ve Cenab-ı Hakk'ı inkâra kadar cür'et edip medeniyet-i beşeriyeyi tahribe çalışan dehşetli cereyanlar bu gaybi ihbârın doğruluğunu tasdik etmektedir.) (Bak: Mehdi, Mesih, Mesih-üd-Deccal, Süfyan)(Deccal'ın şahs-ı surisi insan gibidir. Mağrur, fir'avunlaşmış, Allah'ı unutmuş olduğundan; suri, cebbârâne olan hâkimiyetine, uluhiyet namını vermiş bir şeytan-ı ahmaktır ve bir insan-ı dessastır. Fakat şahs-ı mânevisi olan dinsizlik cereyan-ı azimi, pek cesimdir. Rivayetlerde Deccal'a ait tavsifat-ı müdhişe ona işaret eder. Bir vakit Japonya'nın başkumandanının resmi, bir ayağı Bahr-i Muhit'te, diğer ayağı on günlük mesafedeki Port Artür Kal'asında tasvir edilmiş. O küçük Japon Kumandanının bu surette tasviriyle, ordusunun şahs-ı mânevisi gösterilmiş. M.)
decdece: Tavuğa "bilibili" diye seslenmek.
dececan: Ağırca, yab yab yürümek.
decen: çok yağmur.
decl š‡™: örtmek. * Devenin katranlanması. * Karıştırmak, yalan söylemek. Hakkı bâtıl; bâtılı hak diye göstermek. Anarşi çıkarmak. * Bâtılı hak gösteren. * Mübâlâgalı fâili; Deccaldır.
decn: Bol yağmur, rahmet. * Havanın bulutlu olması. * Bir yerde mukim olma. Bir yerde oturma.
decran: Neşeli, sevinçli, bahtiyar kimse.
decucat: Ayakları kısacık dişi deve.
decv: Nikâh. * çok karanlık, zulmet.
decye: (C.: Dücâ) Karanlık, zulmet.
de'da: Her ayın son günü. * şaban'ın son günü. * çok karanlık gece.
dedektîf šœ‚š˜…–: Fr. Hususi araştırma yapan, tâkib ve tarassudda bulunan polis.
deeb: âdet, usul, kaide, an'ane.
def' š–”: Ortadan kaldırmak, öteye itmek. * Mâni' olmak. Savmak. Savunmak. * Himaye etmek. * Fık: Bir dâvayı müdafaa için başka bir dâva açmak.
def-î cu' š–”ó‚‡”: Açlığı gidermek. Birşey yemek.
def-î hâcet š–”ó‚ˆƒ‡…: Abdest bozmak.
def-î şer š–”ó‚œ: Kötülüğü ve şerri def'etmek.(Bu günlerde, Kur'an-ı Hakim'in nazarında, imandan sonra en ziyade esas tutulan takva ve amel-i sâlih esaslarını düşündüm. Takva, menhiyattan ve günahlardan içtinab etmek ve amel-i salih emir dairesinde hareket ve hayrat kazanmaktır. Her zaman def'-i şer, celb-i nef'a racih olmakla beraber; bu tahribat ve sefahet ve cazibedar hevesat zamanında bu takva olan, def'-i mefasid ve terk-i kebair üss-ül esas olup, büyük bir rüçhaniyet kesbetmiş. K.L.)
def-î tabîî š–”ó‚’„ÿ”ž: Bünyede ve içte olan şeyi, fıtri ve normal şekilde dışarı atmak.
def': (Defâ'-Defâe) Sıcaklık.
def'a š–”œ: Bir kerre.
defa š–ƒ: Boynuz ve kanat uzunluğu. * Bir şeyin eğilip ikiye bükülmesi.
def'a-î ulâ: Birinci olarak, ilk defa.
defaat š–”ƒ…: Kerreler, def'alar. Müteaddid.
defadi': (Dıfda. C.) Kurbağalar.
defaîn š–ƒ¡›: (Define. C.) Defineler.
def'aten š–” ø: Hemen, birdenbire âni olarak. Beklenmedik anda. Bir def'ada.
def'ateyn: îki kere, iki defa.
defatîr: (Defter. C.) Defterler. Not yazmağa mahsus kâğıttan beyaz kitablar.
defatîr-î resmîyye: Resmi defterler.
defennî: Alaca renkli bir cins elbise.
defer: Koltuk kokusu gibi olan pis koku. * Yemeğe kurt düşmesi.
deff: Yan, cenb. * Kolay.
deffe: Yan, yüz. * Kitab cildinin iki tarafından herbiri.
def'î š–”ÿ: Hemen, bir anda.
defî' š–¡: Kızgın olan nesne.
defîf: Ağır ağır gitmek. * Kuşun, ayakları yerde iken kanatlarını salıp hareket ettirmesi.
defîn: (Defn. den) Medfun, defnedilmiş, toprağa konulmuş, gömülmüş, gömülü.
defîne š–ÿ›œ: Para veya altın gibi eskiden saklanmış şeylerin bulunduğu yer. * Kıymetli eşya. Kıymeti ve değeri yüksek olan şeyler veya kimse.
defk: Atmak. Dökmek.
deflasyon: Fr. Paranın piyasada azalmasıyla satın alma gücünün artması.
defn š–›: Gömmek, gömülmek. Cenazenin mezara gömülmesi.
defn-î emvat: ölülerin gömülmesi.
defn-î meyyît: ölünün gömülmesi.
defr: Kokmak.
defter š–…œ: (C.: Defâtir) (Yunanca iki kanatlı manasına gelen bir kelimeden alınmıştır). Not yazmağa, ders için veya ticari hesablara mahsus kağıttan beyaz kitab. Pusula. * Liste.
defter-î a'mâl š–…œ‚¥”šƒ™: însanların amellerinin iyilik veya, kötülüklerinin meleklerce kaydolunduğu manevi defter.( $ kelimesiyle ifade eder ki: Haşirde herkesin bütün a'mâli bir sahife içinde yazılı olarak neşrediliyor. şu mes'ele kendi kendine çok acib olduğundan akıl ona yol bulamaz. Fakat, surenin işaret ettiği gibi haşr-i bahâride başka noktaların naziresi olduğu gibi, şu neşr-i suhuf naziresi pek zâhirdir. çünki her meyvedar ağaç ve çiçekli bir otun da amelleri var. Fiilleri var, vazifeleri var. Esmâ-i îlâhiyeyi ne şekilde göstererek tesbihat etmiş ise ubudiyetleri var. îşte onun bütün bu amelleri tarih-i hayatlarıyla beraber umum çekirdeklerinde, tohumcuklarında yazılıp başka bir baharda, başka bir zeminde çıkar. Gösterdiği şekil ve suret lisanıyla gayet fasih bir surette analarının ve asıllarının a'mâlini zikrettiği gibi dal, budak, yaprak, çiçek ve meyveleriyle sahife-i a'mâlini neşreder. S.)
defterdar š–…œ‚šƒœ: Defter tutan. Devletin gelir ve masraflarını tutan vazifeli memur. Eskiden Maliye Nâzırı bu nam ile anılırdı. Bir vilayetin maliye işlerine bakan memur.
defterdarlik: Eskiden maliye bakanlığı. * şimdi vilâyetlerin mali işlerine bakan daire.
defva: Boyu uzun ağaç. Uzun boyunlu keçi.* Boynu uzun olan kadın.
dega: f. Hile, habislik, dolandırıcılık. * Hilekâr, dolandırıcı, habis. * Kalp para, bozuk akçe.
deh š‰: f. îyi hoş. Lâtif, güzel. * Tabur. * Saf.
deh šœ: f. On (10), aşer.
deh-sal: f. Gezegen, seyyare, yıldız.
deh-sale: f. On yaşında. On yıllık.
deh-yek: f. öşr, onda bir.
deha šˆÿ: Yaymak, döşemek.
deha šœ¥: çok akıllılık. Zekiliğin ve anlayışlılığın son derecesi. îleri görüşlülük, geniş ve çok güzel fikir sâhibi olmak.
deha-î fennî šœƒÿ‚–›ÿ: Fen ve dünyevi ilimlerde çok ileri görüşlülük ve harika zekâlı olmak.
deha-î kudsî šœƒ£ó‚—šžž: Dinin derin hakikatlarını anlamakta yüksek mahareti olan dehâ. Dini dehâ.
dehadar šœƒšƒœ: f. Uyanıklık, zeki ve çok akıllı oluş.
dehaet: Dahilik, dehâ sahibi olma. Zekilikte, anlayışlılıkta çok yüksek olma.
dehak: Kırmak, kesmek. * Acı çektirmek, azap etmek.
dehakîn: (Dihkan. C.) Köy ağaları. * Köylüler, çiftçiler.
dehal š‰™: Aldatmak, mekir ve hile etmek.
dehalet š‰ƒ™ : Sığınmak, aman dilemek, medet, yardım isteyiş.
dehalîz: (Dehliz. C.) Dehlizler, holler, koridorlar.
dehan šœƒ›: (Dıhen- Dahen) f. Ağız, Fem.
dehân-i teng: Ufak ağız. Dar ağız.
dehane: f. Küp, testi, fırın ve bunlara benzer şeylerin ağzı.
dehangüşa: f. Söyliyen, açılmış ağız, konuşan ağız.
dehar: f. Mağara, dağ mağarası. Kovuk. çatlak.
deharîr: Zamânın şiddetleri.
deharîs: Belâ. şiddet.
dehaz: f. Feryat, figan. Bağırıp çağırma. Yüksek sadâ ile medet isteme.
dehbel: Yemekte lokmanın büyük olması. * Bir kuş adı.
dehdak: Kesmek. Kat'.
dehdan (dehdehân): Develerin bir yere toplanması.
dehdehe: Yuvarlamak, döndürmek.
dehdehî: f. Hâlis altun.
dehen: f. Ağız.
dehen-şuy: Ağız temizleme, ağız yıkama.
dehhaşe šœƒœ: çok fazla derecede korkunç, dehşet verici.
dehîşt: f. îttifak, ittihad, birlik. * Bir tarzda hareket, aynı şekilde hareket.
dehkel: Zahmet, meşakkat. * şiddetli ve meşakkatli zaman.
dehkem: Yaşlı adam. îhtiyar adam.
dehl: Zamandan bir saat. * Azca nesne.
dehles: Kısa boylu kimse.
dehlîz šœ™ÿ: (C.: Dehâliz) Hol, koridor. Ev ile kapı arası.
dehlîz-î cînan šœ™ÿó‚‡›ƒ›: Revak-ı uhreviye mânasında mecazi bir deyimdir. (Bak: Revâk-ı uhreviye).
dehm: (C.: Dühum) Ansızdan gelmek. * çok fazla miktarda asker. * çok adet, kesret.
dehma šœšƒ£: Belâ. Zahmet * çömlek. * çok adet, kesret, sayı çokluğu. * Kadim, eski. * Halis kırmızı koyun. * Koyu kızıl.
dehmak: Kesmek, kat'.
dehme: Yumuşak yemek.
dehmece: îhtiyar kişinin ayağında köstek var gibi yab yab yürümesi.
dehmeka: Yumuşak ve güzel yemek. * Her nesnenin yumuşağı.
dehmus: Cömert kişi. Kerim kimse.
dehn šœ›: Değnekle vurmak. * Yağmurun, yeri ıslatması. * Bir şeyi yağlamak. * Bir kimseye münâfıkane muâmele etmek.
dehna šœ›ƒ£: Ova, sahrâ. çöl, geniş veya susuz ova. * Bir yer ismi.
dehnec: Zümrüt gibi bir kıymetli taş.
dehr šœœ: Zaman, çok uzun zaman, ebedi. * Bin yıllık zaman. * Dünya.
dehr suresî: Kur'ân-ı Kerim'in 76. suresi olup Sure-i însan, Ebrar, Emşac, Hel Etâ Suresi de denir.
dehr-î fânî: Fâni dünya, geçici dünya.
dehre: f. (Dahra) Testere gibi dişli ve eğri budama âleti. Bağ budamak için kullanılan testere gibi dişli olan bıçak.
dehrî šœœÿ: Dehr ve zamana dair ve müteallik.
dehrîye: Devre ait. Zamana dair ve müteallik. * âlemin ezeli ve ebediliğini iddia edip âhirete inanmıyan münkir ve imansız bir fırka.
dehrîyyun šœœÿ›: (Dehri. C.) Dehriye fırkasından olanlar.
dehs: (Dehâs) : îçine ayak batan yumuşak yer.
dehş š‰: f. Bulanıklık, karanlık. Zulümat. * Bir işe başlama.
dehş(e) šœ: Tenbel olmak.
dehşet šœ…: Korkup kaçılacak şey. ürkmek, şaşmak. Korku ve telâş içinde olmak.
dehşet-efşan: f. Korkunç, korku ve dehşet saçan, ürkütücü.
dehşet-engîz šœ…‚ƒ›ªÿ: f. çok dehşet verici. çok korkutucu.
dehun: f. Hatırlama, ezber okuma.
dehüm: f. Onuncu.
dehver: Cem'etmek, toplamak. * Lokmayı büyük yapmak.
dehy (dehâ): Kişinin fikir ve ferâsetinin isabetli ve doğru olması.
dehya šœÿƒ: Te'kid için "Dahiye" lâfzına sıfat yapılır. "Dâhiye-i dehya" gibi.
dejenere šœ‚©œ›œœ: Fr. Bozulma, soysuzlaşma.
dek š˜: t. Edat olup zaman ve mekân için kullanılır. "Hatta, tâ, kadar" mânalarına gelir. Meselâ: Akşama dek çalıştım.
dek š˜: f. Desise, hile, dolandırıcılık. * Sâil, dilenci. * Dilencilik. * Sağlam, metin, muhkem. * çatma, tokuşma.
dek-baz: f. Hileci, hilekâr, oyuncu, aldatıcı.
deka': (C.: Dükk-Dükük-Dekâvât) Hörgücü arkasına düşmüş dişi deve.* Kaygan yer.
dekaîk š—ƒ¡—: (Bak: Dakaik)
dekakîn: (Dükkân. C.) Dükkânlar.
dekametre: yun. On metrelik uzunluk birimi.
dekan: Lât. üniversitelerde bir fakültenin başkanı.
dekar: Lât. Bin metrekarelik ölçü birimi.
dekdak: (C.: Dekâdik) Kum yığını.
dekdeke š˜š˜œ: Yerin deprenmesi. * Sancıma. * Def etme, kovma.
dekele: Sıvı balçık. Kuvvetleriyle gururlanıp sultanın emrine uymayan kavim.
dekîk: Tam bir yıl.
dekk šò˜õ: (C.: Dekeke) Vurmak. * Dökmek. * Parça parça etmek. Delil.
dekke š˜œ: Ufalanmak. Pâre pâre olmak. * Vurmak, döğmek. * Seki, sofa.
dekken š˜ƒø: Hurdahaş olmak, yerle bir olma, ufalanmak, parça, parça olmak. 
dekor: Fr. Süs. Bir sahneyi mütenasib bir nizamla süslemek.
dekoratör: Fr. Dekor ve dekorasyon yapan sanatkâr.
dekovîl: Fr. Ray aralığı 60 cm. yahut daha az olan küçük demiryolu.
de'l: Aldatmak. * Ahdi bozmak, sözü tutmamak.
delab: (Dülâb) (C.: Degâlib) Bâzısı su ile ve bâsızı da hayvan ile döndürülen su çekmeğe mahsus çark.
delaîl š™ƒ¡™: (Delil. C.) Deliller. Bürhanlar. îsbât vasıtaları.(... Cay-ı hayrettir ki; Resul-ü Ekrem'in (A.S.M.) mübalağasız binler vecihte, binler çeşit insan, herbiri bir tek mu'cizesiyle veya bir delil-i nübüvvet ile veya bir kelâmı ile veya yüzünü görmesiyle ve hâkezâ... birer alâmeti ile iman getirdikleri hâlde, bütün bu binler ayrı ayrı insanları ve müdakkik ve mütefekkirleri imana getiren bütün o binler delâil-i Nübüvveti nakl-i sahih ile ve âsâr-ı kat'iyye ile şimdiki bedbaht bir kısım insanlara kâfi gelmiyor gibi dalâlete sapıyorlar. M.)
delaîl-î âfâkîye š™ƒ¡™ó‚¥–ƒ—ÿœ: Afaka âit deliller. Kâinattaki deliller.
delaîl-î aklîye š™ƒ¡™ó‚”—™ÿœ: Aklı ile bulunan deliller. Akla âid deliller.
delaîl-î enfüsîye š™ƒ¡™ó‚¤›–žÿœ: Kişinin kendi nefsinde olan deliller. Yani vücudun gerek maddi ve gerek (vicdan ve hisler gibi) mânevi yapısında olan ve imana ait hükümleri isbat eden delillerdir.
delaîl-î kalbîye š™ƒ¡™ó‚—™„ÿœ: Kalbe âid deliller. Kalb ile bilinen deliller.
delaîl-î naklîye š™ƒ¡™ó‚›—™ÿœ: Nakil yolu ile gelen deliller. (Bak: Delil-i nakli)
delaîl-î nübüvvet š™ƒ¡™ó‚›„õ…: Peygamberliğin hak olduğuna dair olan deliller.(Resul-i Ekrem Aleyhissalâtü Vesselâm iddiâ-yı Nübüvvet etmiş; Kur'an-ı Azimüşşan gibi bir fermanı göstermiş ve ehl-i tahkikin yanında bine kadar mu'cizat-ı bâhireyi göstermiştir. O mu'cizât, hey'et-i mecmuasiyle, dâvâ-yı nübüvvetin vukuu kadar vücudları kat'idir. Kur'an-ı Hakim'in çok yerlerinde en muannid kâfirlerden naklettiği sihir isnad etmeleri gösteriyor ki; o muannid kâfirler dahi mu'cizatın vücudlarını ve vukularını inkâr edemiyorlar. Yalnız, kendilerini aldatmak veya etba'larını kandırmak için, hâşâ sihir demişler.Evet, mu'cizat-ı Ahmediyenin (A.S.M.) yüz tevatür kuvvetinde bir kat'iyeti vardır. Mu'cize ise; Hâlik-ı Kâinat tarafından O'nun dâvasına bir tasdiktir; $ hükmüne geçer. Nasılki sen bir padişahın meclisinde ve daire-i nazarında desen ki: "Padişah beni filân işe me'mur etmiş." Senden o dâvaya bir delil istenilse; padişah "Evet" dese, nasıl seni tasdik eder. öyle de: âdetini ve vaziyetini senin iltimasınla değiştirirse; "Evet" sözünden daha kat'i, daha sağlam, senin dâvanı tasdik eder. öyle de, Resul-i Ekrem Aleyhissalâtü Vesselâm dâva etmiş ki: "Ben, şu kâinat Hâlik'ının meb'usuyum. Delilim de şudur ki: Müstemir âdetini, benim duâ ve iltimasımla değiştirecek. îşte, parmaklarıma bakınız; beş musluklu bir çeşme gibi akıttırıyor. Kamere bakınız; bir parmağımın işaretiyle iki parça ediyor. şu ağaca bakınız; beni tasdik için yanıma geliyor, şehadet ediyor. şu bir parça taama bakınız; iki - üç adama ancak kâfi geldiği halde; işte ikiyüz - üçyüz adamı tok ediyor." Ve hâkezâ... yüzer mu'cizatı böyle göstermiştir.şimdi, şu Zâtın delâil-i sıdkı ve berâhin-i nübüvveti yalnız mu'cizatına münhasır değildir. Belki, ehl-i dikkat için, hemen umum harekâtı ve ef'âli, ahvâl ve akvâli, ahlâk ve etvârı, siret ve sureti, sıdkını ve ciddiyetini isbat eder. Hattâ meşhur ulemâ-i Beni îsrâiliyeden Abdullah îbn-i Selâm gibi pek çok zatlar, yalnız o Zât-ı Ekrem Aleyhissalâtü Vesselâm'ın simasını görmekle: "şu simâda yalan yok! şu yüzde hile olamaz!" diyerek imana gelmişler.çendan muhakkikin-i ulema, delail-i nübüvveti ve mu'cizatı bin kadar demişler; fakat binler, belki yüzbinler delâil-i nübüvvet vardır. Ve yüzbinler yol ile yüzbinler muhtelif fikirli adamlar, o zâtın nübüvvetini tasdik etmişler. Yalnız Kur'an-ı Hakim'de kırk vech-i i'cazdan başka, nübüvvet-i Ahmediyenin (A.S.M.) bin bürhanını gösteriyor. M.)
delaîl-î zâhîrîye: Açık olarak zâhirde görünen deliller. Maddi deliller.
delak: Sansar.
delal: Cilve, naz, işve. însana güzel ve sevimli görünecek hâl, durum.
delalat š™ƒ™ƒ…: (Delâlet. C.) Delâletler, alâmet olmalar,yol göstermeler, kılavuzluklar.
delalet š™ƒ™ : Delil olmak. Yol göstermek. Kılavuzluk. Doğru yolu bulmakta insanlara yardım etmek. * îşaret.
delalet-î selâse š™ƒ™…ó‚†™ƒ†œ: üç çeşit delâlet. Bunlar da: Delâlet-i mutabıkıye, delâlet-i tazammuniye, delâlet-i iltizamiyedir.1- Delalet-i mutabıkıye: Bir kelâmın vaz'olunduğu, yani kasdedilen mânanın tamanına delâletidir. Meselâ: însan lâfzı, insanın tam mahiyeti olan, hayvan-ı natık, (yani, konuşan hayat sahibi varlık) mânasına delâleti gibi.2- Delalet-i tazammuniye: Bir lâfzın vaz'olunduğu mânanın bir cüz'üne delâletidir.3- Delalet-i iltizamiye: Bir lâfzın vaz'olunduğu mânanın lâzımına yani o mâna ile beraber bulunması zaruri olan diğer bir mânaya delâletidir. Mezkur delâlet-i selâseye ait şöyle bir misal dahi verilir."Zekât, müslümanların fakirlerine verilir, hiç bir zengine verilmez." îbaresi; zekâtın, yalnız Müslüman fakirlere verileceğine delâlet-i mutabıkıye ile; zengin olan Ahmet, Mehmet gibi belli şahıslara verilemiyeceğine delâlet-i tazammuniye ile; zekât hususunda zenginler ile fakirler arasında fark bulunduğuna da delâlet-i iltizamiye ile delâlet eder.
delalet-î zâtîye š™ƒ™ ‚‹ƒ…ÿœ: Kendi zatı ile, bizzat kendisini eserleri ile göstermek suretiyle olan delâlet, şahidlik.
de'lan: Ağır yük getirmiş hayvanın yab yab yürümesi.
delas š™ƒ: Yumuşak ve berrak şey.
del'as (del'ak): Büyük, kuvvetli deve.
deldel: (Deldâl) Deprenmek.
dele: (C.: Delâ) Kova.
delec: Gecenin evvelinden gitmek.
delef: Tekaddüm etmek, ileri geçmek. önde bulunmak.
delehmes: Arslan. * Bahâdır, kahraman. * çeri. * Kuvvetli kişi. * çok karanlık olan gece.
deles: Karanlık. * Yaz sonunda yapraklanır bir ot. * Bir şeyi gizlemek.
delh: Heder olmak, boşa ve faydasız olarak gitmek.
delî': âsan yol, kolay olan yol.
delîf: Yavaş yürümek.
delîk š™ÿ˜: Hurma ve yağdan yapılan bir yemek. * Oğmaç aşı. * Rüzgârın yerden savurup tozuttuğu toprak.
delîk š™ÿ˜: f. Gül tohumu.
delîl š™ÿ™: Kılavuz. Doğru yolu gösteren. Meçhûlü keşfetmekte ve malumun sıhhatını isbat etmekte vasıta ve âlet ittihaz olunan husus. * Beyyine. Bürhan.
delîl-î aklî š™ÿ™‚”—™ÿ: Akıl yolu ile bulunan delil. Nakil yolu ile olmadan, düşünülerek bulunan delil.
delîl-î arşî ve süllemî: Eski mantıkta Vahdaniyyet-i îlâhiyyeyi ve teselsülün muhaliyyetini isbat bahislerinde geçen delillerdendir.
delîl-î îhtîra' š™ÿ™‚ƒ‰…œƒ”: Cenab-ı Hakk'ın yeniden icad ederek yarattığı şeylerden meydana gelen, kendi zâtına mahsus delil. Buna misâl olarak birini zikredebiliriz:(Cenâb-ı Hak hususi eserlerine menşe ve kendisine lâyık kemâlâtına me'haz olmak üzere her ferde ve her nev'e has ve müstakil bir vücud vermiştir. Ezel cihetine sonsuz olarak uzanıp giden, hiçbir nev' yoktur. çünkü bütün enva'; imkândan vücub dâiresine çıkmamışlardır. Ve teselsülün de bâtıl olduğu meydandadır. Ve âlemde görünen şu tegayyür ve tebeddül ile bir kısım eşyanın hudusu, yani, yeni vücuda geldiği de göz ile görünüyor. Bir kısmının da hudusu zaruret-i akliye ile sabittir. Demek, hiçbir şeyin ezeliyyeti cihetine gidilemez.Ve keza, ilm-ül hayvanat ve ilm-ün nebatatta isbat edildiği gibi, envâın sayısı iki yüz bine bâliğdir. Bu nev'ler için birer âdem ve birer evvel baba lâzımdır. Bu evvel babaların ve âdemlerin dâire-i vücubda olmayıp ancak mümkinattan olduklarına nazaran behemehâl, vasıtasız, kudret-i îlâhiyyeden vücuda geldikleri zaruridir. çünkü, bu nev'lerin teselsülü, yani, sonsuz uzanıp gitmeleri bâtıldır. Ve bazı nev'lerin başka nev'lerden husule gelmeleri tevehhümü de bâtıldır. çünkü, iki nev'den doğan nev, alelekser ya akimdir veya nesli inkıtaa uğrar. Tenâsül ile bir silsilenin başı olamaz.Hülâsa: Beşeriyet ve sâir hayvanatın teşkil ettikleri silsilelerin mebdei en başta bir babada kesildiği gibi, en nihayeti de son bir oğulda kesilip bitecektir. î.î.)
delîl-î îmkânî š™ÿ™‚ƒš˜ƒ›ÿ: îmkâna âit olan delil. $âyeti ile işaret edilmiştir. Bu delilin hülâsası: "Kâinatın ihtiva ettiği zerrelerden her birisinin gerek zâtında, gerek sıfatında, gerek ahvâlinde ve gerek vücudunda gayr-i mütenahi imkânlar, ihtimâller, müşkülâtlar, yollar, kanunlar varken; birdenbire o zerre gayr-i mütenâhi yollardan muayyen bir yola süluk eder. Ve gayr-i mahdut hâllerden bir vaziyete girer. Ve gayr-i ma'dut sıfatlardan bir sıfatla vasıflanır. Ve doğru bir kanun üzerine mukadder bir maksada, harekete başlar ve vazife olarak uhdesine verilen herhangi bir hikmet ve bir maslahatı derhal intac eder ki, o hikmet ve o maslahatın husule gelmesi ancak o zerrenin o çeşit hareketiyle olabilir. Acaba o kadar yollar ve ihtimaller arasında o zerrenin mâcerası, lisan-ı hâliyle, Sani'in kasd ve hikmetine delâlet etmez mi?îşte her bir zerre, müstakillen kendi başıyla Sâni'in vücuduna delâlet ettiği gibi, küçük büyük herhangi bir teşekküle girerse veya herhangi bir mürekkebe cüz' olursa, girdiği ve cüz' olduğu o makamlarda kazandığı nisbete göre Sâni'ine olan delâletini muhafaza eder. î.î.)
delîl-î înayet š™ÿ™‚”›ƒÿ…: Allah'ın inâyetinin tecellisinden gelen ve kâinatta görülen hikmet ve maslahatlara uygun en mükemmel nizam ve tam esaslı san'at; ve kâinattaki eşyaların menfaat ve faydalarını bildiren âyetler, bu inâyet delilini gösteriyorlar.(Sâniin vücud ve vahdetine işaret eden delillerden biri de înayet delili'dir. Bu delil; kâinatı ve kâinatın eczasını ve envâını ihtilâlden, ihtilâftan, dağılmaktan kurtarıp bütün hususâtını intizam altına almakla kâinata hayat veren nizamdan ibarettir. Bütün maslahatların, hikmetlerin, faidelerin, menfaatlerin menşei, bu nizamdır. Menfaatlerden, maslahatlardan bahseden bütün Ayât-ı Kur'aniye, bu nizam üzerine yürüyor ve bu nizamın tecellisine mazhardır. Binaenaleyh, bütün mesalihin, fevaidin ve menafiin mercii olan ve kâinata hayat veren bir nizam; elbette ve elbette bir nâzımın vücuduna delâlet ettiği gibi, O nâzımın kasd ve hikmetine de delâlet etmekle, kör tesadüfün vehimlerini nefyeder.Ey insan! Eğer senin fikrin, nazarın şu yüksek nizamı bulmaktan âciz ise ve istikra-i tâm ile, yani umumi bir araştırma ile de o nizamı elde etmeye kadir değilsen, insanların telâhuk-u efkâr denilen fikirlerinin birleşmesinden doğan ve nev-i beşerin havassı (duyguları) hükmünde olan fünun ile kâinata bak ve sahifelerini oku ki, akılları hayrette bırakan o yüksek nizamı göresin.Evet, kâinatın herbir nev'ine dâir bir fen teşekkül etmiş veya etmektedir. Fen ise kavaid-i külliyeden ibarettir. Kaidenin külliyeti ise, nizamın yüksekliğine ve güzelliğine delâlet eder. Zira nizamı olmayanın külliyeti olamaz. Meselâ: Her âlimin başında beyaz bir imâme var. Külliyetle söylenilen şu hüküm, ulema nev'inde intizamın bulunmasına bakar. öyle ise, umumi bir teftiş neticesinde fünun-u kevniyeden herbirisi, kaidelerinin külliyeti ile kâinatta yüksek bir nizamın bulunmasına bir delildir. Ve herbir fen nurlu bir bürhan olup, mevcudatın silsilelerinde salkımlar gibi asılıp sallanan maslahat semerelerini ve ahvalin değişmesinde gizli olan faideleri göstermekle Sâniin kasd ve hikmetini ilân ediyorlar. Adeta vehim şeytanlarını tardetmek için herbir fen, birer necm-i sâkıbdır. Yani, bâtıl vehimleri delip yakan birer yıldızdırlar.Ey arkadaş! O nizamı bulmak için umum kâinatı araştırmaktansa, şu misale dikkat et, matlubun hasıl olur.Göz ile görünmeyen bir mikrob, bir hayvancık, küçüklüğüyle beraber pek ince ve garib bir makine-i îlâhiyeyi hâvidir. O makine mümkinattan olduğundan, vücud ve ademi, mütesavidir. îlletsiz vücuda gelmesi muhaldir. O makinenin bir illetten vücuda geldiği zaruridir. O illet ise, esbab-ı tabiiyye değildir. çünki, o makinedeki ince nizam, bir ilim ve şuurun eseridir. Esbab-ı tabiiyye ise; ilimsiz, şuursuz, câmid şeylerdir. Akılları hayrette bırakan o ince makinenin esbab-ı tabiiyeden neş'et ettiğini iddia eden adam, esbabın herbir zerresine Eflatun'un şuurunu, Calinos'un hikmetini i'ta etmekle beraber; o zerrat arasında bir muhaberenin de mevcut olmasını itikad etmelidir. Bu ise, öyle bir safsata ve öyle bir hurafedir ki, meşhur sofestaiyi bile utandırıyor. Maahaza, esbab-ı maddiyede esas ittihaz edilen kuvve-i câzibe ile kuvve-i dâfianın, inkısama kabiliyeti olmıyan bir cüz'de birlikte içtimaları iltizam edilmiştir. Halbuki bunlar birbirlerine zıt olduklarından, içtimaları câiz değildir. Fakat, câzibe ve dâfia kanunlarından maksat âdâtullah ile tâbir edilen kavanin-i îlâhiyye ise ve tabiatla tesmiye edilen şeriat-ı fıtriyye ise, câizdir. Lâkin kanunluktan tabiata, vücud-u zihniden vücud-u hariciye, umur-u itibariyyeden umur-u hakikiyyeye, âlet olmaktan müessir olmaya çıkmamak şartiyle makbuldür. Aksi takdirde câiz değildir.Ey arkadaş! Misâl olarak gösterdiğim o küçük hurdebini hayvancığın yani mikrobun büyük fabrikasındaki nizam ve intizamı aklın ile gördüğün takdirde başını kaldır, kâinata bak! Emin ol ki, kâinatın vuzuh ve zuhuru nisbetinde o yüksek nizamı, kâinatın sahifelerinde pek zâhir ve okunaklı bir şekilde görüp okuyacaksın.Ey arkadaş! Kâinatın sahifelerinde "Delil-ül-înaye" ile anılan nizama ait âyetleri okuyamadı isen sıfat-ı kelâmdan gelen Kur'an-ı Azimüşşan'ın âyetlerine bak ki, insanları tefekküre davet eden bütün âyetleri şu delil-ül-inaye'yi tavsiye ediyorlar. Ve ni'metleri ve faideleri sayan âyetler dahi, delil-ül inaye denilen o yüksek nizamın semerelerinden bahsediyorlar. Ezcümle: Bahsinde bulunduğumuz şu âyet $cümleleriyle o nizamın faidelerini ve nimetlerini koparıp insanlara veriyorlar. î.î.)
delîl-î înnî š™ÿ™‚ƒ›ÿ: (Bak: Bürhan-ı inni)
delîl-î naklî š™ÿ™‚›—™ÿ: Kur'an, Hadis-i şerif veya diğer mukaddes kitaplardaki verilen haberler ile olan delil.
delîl-î süllemî š™ÿ™ÿ‚ž™šÿ: (Bak: Delil-i arşi, Arş ve süllem)
delk š™˜: Oğuşturmak. El sürtmek. Oğmak.
delk: f. Eski ve yamalı elbise. Dervişlerin giydikleri eski aba. * Kılıcı kınından çıkarmak.
dell (dîlâl): Naz. * Hey'et. * Güzel ahlâk.
dellak: (Delk. den) Hamamlarda müşterileri keseleyip yıkayan kimse, tellâk.
dellal š™ƒ™: îlân edici. Yüksek sesle bildiren. * Müşterileri çeken. Davet eden. * Hakka davet eden.
dels š™ž: Karanlık, zulmet. * Bir şeyi saklamak, gizlemek. * Sonbaharda yapraklanan bir ot çeşiti.
delta: yun. Nehirlerin taşıdığı toprakların (alüvyonları) akarsuyun, denize veya göle döküldüğü yerde yığılmasıyla meydana gelen kısım.
deluk: Dişleri kırılmış ve kütelmiş olan yaşlı deve. * Kınından çıkması kolay olan kılıç.
delv š™: (Delve) Kova. Su koyulan ve kuyudan su çekilen bakraç. * Oniki burçtan birinin adı.
delz: Vurmak, darb.
dem šš: Kan.
dem šš: f. Nefes. Soluk. * Ağız. * Nazar. * An, vakit, saat. * Koku. * Kibir, gurur. * âli, yüksek. * Körük.
dem' šš”: Göz yaşı. Sürurdan veya keder sebebiyle ağlama neticesi gelen göz yaşı.
dem vurmak šš‚œšƒ—: t. Bir şeyden gelişigüzel bahsetmek.
dem-beste: f. Sesi soluğu kesilmiş, susmuş.
dem-güzar: f. Yaşayan, vakit geçiren.
dem-î cîvânî: Gençlik çağı.
dem-keş: f. Nefes çeken, soluk çeken. * Devamlı öten bir güvercin cinsi. * Kaval, ney gibi çalgıları devamlı üfürenler. * Bazı kuşların, kübbül gibi uzun uzun ötenleri. * şarap içen.
dem-keşîde: f. Kafadar, arkadaş.
dem-saz: f. Arkadaş, refik, hem-dem, dost. Sırdaş.
dem-sazî: f. Dostluk, arkadaşlık. Sırdaşlık.
dem'a šš”œ: Bir damla göz yaşı.
dema ššƒ: f. Her zaman. Vaktâki. * Soluk. Nefes. Hastalık sebebiyle tez tez solumak. * ürpermek. * Dem. An.
dem'a-rîz: f. Ağlıyan, gözyaşı döken.
demadem ššƒšš: f. Zaman zaman. An be an. Sık sık. Her vakit.
demagog: yun. Demagoji yapan kimse.
demagojî ššƒ•©ÿ: yun. Halkı kendi menfaati için okşama siyâseti. Halkın hoşuna gidecek sözlerle insanların sevgisini kazanarak kendi maksadını elde etmeğe çalışmak. Halk avcılığı. Cerbeze.
demak: Tipi (Kış gününde rüzgârın karı her tarafa savurmasıdır.)
demal: Ters. * Ekşimiş hurma.
demame: çirkinlik.
dem'an: îçi iyice dolmuş olan. Ağız ağıza dolu kap.
deman: f. Heyecanlı. Hiddetli, hiddete kapılmış. * Vakit, zaman. An. * Bağırıp çağırma, feryat, figân. * Heybetli, güçlü, kuvvetli, azametli, cesim. * Kükremiş.
deman(î): Ters, terslik.
demankeş: f. Zaman, müddet, vakit, an.
demar: f. Helâk, mahv, telef, ölüm, mevt.
demar-âver: f. întikam alan, müntakim. Helâk eden.
dembedem šš„šš: f. Bazan. Vakit vakit. Arasıra.
demc: Dühul etmek, girmek. * Mestur olmak, örtünmek.
demcele: (C.: Demâcil) şişman kadın. * Huyu, hilkati güzel, iyi kadın.
demdem: Yüce, yüksek yer.
demdeme ššššœ: f. Hiddetli söz. Avâz. Hoşa gitmeyen sesler. * Sinek vızıltısı. * öğütmek. Sürte sürte ezmek. * Azab vermek, eziyet etmek. * Hile. * Davul. * şöhret, nam, ün.
deme: f. Ateş körüğü.
demekmek: Katı, şedid. * çok kuvvetli kimse.
demendan: f. Cehennem. * Ateş, nar.
demende: f. Saldırıp kükreyen. * üfleyen.
demes: (C.: Dimâs) Yumuşak kumlu yer.
demeşk (dîmeşk): şam şehri. * Yürüğen kuvvetli, seri deve.
demevî ššÿ: Kana dâir, kana mensub ve müteallik. * Mc: Asabi, sinirli. Kanın çokluğu sebebi ile hâsıl olan mizaç.
demg šš•: Başı, dimağa erişinceye kadar yarmak. Dimağa vurmak. * Güneşin sıcaklığı dimağa tesir etmek.
demîm(e): çirkin ve kısa boylu kimse.
demk: Hız. Sür'at.
deml: Yeri terslemek. * Yara, cerh.
demles: Kaba, galiz nesne.
demma': Mütekebbir gönüllü, gururlu kimse.
demne: f. Fırın ve ocak bacası.
demode šššœ: Fr. Modası geçmiş, kimse kullanmaz hâle gelmiş olan.
demokrasî šœ‚š—œƒžÿ: yun. (Demos: Halk; Kratia: îdare, iktidar) Halk iktidarına dayanan hükümet şekli. Devlet iktidarını elinde bulunduranların, halkın çoğunluğunun iradesiyle seçildiği hükümet şeklidir. Tatbikatı üç şekildir:1- Vasıtasız hükümet şekli: Halk, devlet iktidar ve hâkimiyetini vasıtasız olarak kullanır. Kanunları kendisi yapar, suçluları kendisi muhakeme eder, idareyi kendisi yürütür. Bu usül ancak küçük cemiyetlerde tatbik imkânına sahiptir. 2- Yarı vasıtasız hükümet şekli: Halk re'yi ile temsilciler meclisi seçilir. Meclisin çıkardığı kanunların tatbik edilebilmesi için halkın re'yine baş vurulması (referandum) şarttır.3- Temsil hükümet şekli: Cumhuriyet. Halk seçim yolu ile hakimiyet ve iktidarı, belli bir zaman için seçtiği temsilciler meclisine devreder. îktidarı halk adına meclisler kullanır.Demokrasinin temsil şekli olan cumhuriyetin de üç ayrı tatbik şekli vardır. 1- Meclis hükümeti sistemi: Hükümet, meclis iradesiyle teşekkül eder. Eğer hükümet meclisin itimadını kaybederse meclis tarafından düşürülür. 2- Parlementer hükümet sistemi: Hükümetle, meclis, belli ölçüler içinde birbirine karşı müstakildir. 3- Başkanlık hükümeti sistemi: Hükümet başkanını halk seçer. Başkan, hükümet üyelerini kendisi tâyin eder ve kendisi azleder.Demokrasi, hukuk devletine ve millet ekseriyetinin hakimiyetine dayalı olup kişi veya azınlık hâkimiyetini reddeder.Demokrasinin temellerine aykırı olmayan herhangi bir inanış ve fikir sahibi olanlar, kendi inanış ve fikrini halka kabul ettirmek için zor kullanmak veya idareyi ele geçirmek için zorlama ve isyana teşebbüs veya açıkça teşvik etmemek şartıyla her türlü inanış ve fikri; neşir, tebliğ ve telkin etmek serbestliğini kabul eden devlet şeklidir.
demokrat šš—œƒ…: Demokrasi taraftarı.
demokratîk: Fr. Demokrasiye uygun.
demrag: çok kırmızı olan.
dems: örtmek. Defnetmek, gömmek.
demşînas: f. Hikmetli davranan, akıllı.
demuk: Sür'atli, seri, hızlı.
demy: Kan, dem.
den': Horluk, zelillik.
dena': Arkanın yumru olması, kamburluk.
denaet š›ƒ¡ : Alçaklık, çok fena hareket. Zillet, kötü mizac. * Asılsızlık, aslı olmamak.
denaet-kârâne: f. Alçakçasına, alçakça.
denanîr š›ƒ›ÿœ: (Dinar. C.) Dinarlar.
denaset: Kirlilik, paslılık, temiz olmayışlılık.
denaset-î ahlâk: Ahlâk kirliliği, ahlâksızlık.
denavet š›ƒ…: Yakın olmak, yakınlık.
denaya: (Bak: Deniyyât)
dendane: f. Diş tanesi. * çark vesaire dişi.
dendene: f. Mırıltı, homurdanma. Ağır ağır, dudak kıpırtısıyla, yavaş yavaş söylenen söz.
denef: îyileşmeyen hastalık.
denen: Bir kişinin belinin bükülüp eğri olması. * Kolları çok kısa olmak. * Hayvanların ayakları kısa ve göğüsleri yere yakın olması.
denes: (C.: Ednâs) Kir, pas, pislik, murdarlık, necaset.
deney: (Bak: Tecrübe)
deneycîlîk: (Ampirizm) Fels: însan zihninde mevcut her bilginin ve her düşüncenin kaynağı tecrübe (deney) olduğunu iddia eden felsefi görüş. Bu görüş, tecrübenin ehemmiyetini belirtirken aklın ve dinin rolünü inkâr ediyor. Tecrübe maddi dünyayı anlamak için gerekli ama, yeterli değildir. Tecrübe görüneni ve müşahhası bize verir. Akıl ise, mücerredi, umumiyi, kaide ve prensipleri verir. Din ise tecrübe ve akıl ile beraber bunların alanını aşan hakikatleri verir. Hakikat, tecrübe ve akılla sınırlı değildir. îslâm akla ve tecrübeye yer verir fakat bunların sınırları içinde hapsolmaz. Müslüman geniş görüşlüdür, dar görüşlü teorilere bağlı düşünmez.
deng: f. Hayran, şaşkın, şaşmış olan, ahmak, ebleh, bön, sersem. * îki katı maddenin tokuşmasından hasıl olan ses. * Pergel noktası.
denî š›ÿ: (C.: Deniyyât) Soysuz, alçak, ahlâksız. * Dünyaya âit, fâni ve geçici. * Yakın, karib.
denî' š›”: Hor, zelil.
denîe: Eksik, noksan, nakise.
denîs: Kirli, paslı.
denîyyat š›ÿƒ…: (Denâya) (Deni. C.) Ahlâksızlıklar, aşağılık şeyler.
denîyye: Kaftan düğmesi, elbise düğmesi.
denn: (C.: Denân) Küp.
depresyon š¨œžÿ›: Fr. Maddi veya manevi çöküntü. îç sıkıntısı.
der-akab šœ‚”—„: f. Hemen, derhâl, çabuk, arkasından, akabinde.
der-amed: f. Gelir.
der-an: f. Derhâl, o anda, hemen.
der-ban: f. Kapıcı, kapıya bakan.
der-bar: f. Ev kapısı.
der-beder: f. Serseri, kapı kapı dolaşan. * Dağınık, perişan.
der-bend šœ„›š: f. Dağda ve tepede zahmetlerle geçilen yer, dar geçit, boğaz. Hudut. Kale. * Anahtarsız kapı.
der-bendçî: Kale veya hudut muhafızı.
der-best(e): f. Kapalı kapı. * Kapanmış susmuş.
der-hast: f. Arzu, taleb, istek, dilek. * Dilekçe, istida.
der-hatir šœ‚‰’œ: Hatırda.
der-kâr šœ˜ƒœ: f. Mâlum, âşikâre olan. * îçinde olan. îçte bulunan.
der-kemîn: f. Pusu bekleyen, pusuda olan.
der-kenar šœ‚˜›ƒœ: Kenarda bulunan, hâşiye. Bir sahifenin kenarına çıkarılan yazı.
der-nîyam: f. Kınına sokulmuş, kınında, kılıfta.
der-saadet šœ‚ž”ƒš…: f. Saadet kapısı. îstanbul'un eski ismi.
der-tesbîh šœ‚…ž„ÿˆ: Tesbihde, duâda, zikirde.
dera: f. çan, çıngırak.
derahîm šœƒœš: (Dirhem. C.) Dirhemler. Okkanın dörtyüzde birleri. * Akçeler, paralar.
derahîs: şiddetler.
derare: Deyyus. Karısının kötü hâllerini görmemezlikten gelen kişi.
derarî šœƒœÿ: f. (Dürri. C.) Parlak yıldızlar. * Renkli şeyler.
deraz: f. Uzun, tavil.
derb šœ„: (Dürb) Bir şeyi âdet edinmek. * Dadanmak, alışmak. * Haslet, cür'et. * Tecrübe etmek. * Denemek.
derbar-i saadet-karar: îstanbul. (Osmanlılar devrinde îstanbul hilâfet merkezi olduğu için saadet kapısı diye tavsif edilirdi.)
derc šœ‡: îçine almak. Katmak. * Kitaba koymak. * Nakışlı kâğıt üzerine yazılan yazı. * Hattatın yazılmış kâğıt tomarı.
dercan šœ‡ƒ›: f. Can içinde.
dercan etmek šœ‡ƒ›‚ƒÿ…š˜: Can içine almak, hayatını ona vermek.
derçîn resmî: Kesilen hayvanlardan alınan bir cins vergi.
derd šœš: f. Tasa, keder, kaygı. * Hastalık, illet.
derd-aşîna: f. Dert görmüş, mihnet görmüş kişi.
derd-dest: Elde. Elde etmek, yakalamak, tutmak. Ahz. * Yapılmakta ve rüyet edilmekte olan.
derd-î dîl šœšó‚šÿ™: Gönül tasası, gönül gamı.
derd-î maîşet šœšó‚š”ÿ…: Geçinmek derdi ve zorluğu. Maişet derdi.
derd-î ser šœšó‚žœ: Sıkıntı, baş derdi, başağrısı.
derda: f. Yazık! Vah vah!
derdab: Sadâ, ses.
derdak: (C.: Derâdik) Küçük çocuklar. * Her şeyin küçüğü.
derdar: Servi ağacından bir sınıf.
derdebîs: Belâ. * Zahmet. * Boncuk. * Yaşlı kişi.
derdmend šœšš›š: f. Tasalı, kaygılı, dertli.
derdnak: f. Dertli, kederli, kaygılı, tasalı.
derdur: Su çevriği, girdab. * Derin çukur yer.
derebeyî: Ortaçağda kendi arazisi içindeki insanlara istedikleri gibi hükmeden, devamlı olarak birbirleriyle savaşan geniş toprak sahiplerinden her biri. * Mc: Asi, zorba.
derecat šœ‡ƒ…: (Derece. C.) Dereceler, basamaklar, kademeler, yükseklikler, mertebeler.
derecat-i kurbîye: Yakınlık dereceleri. Allah'a manevi yakınlık mertebeleri.
derecat-i şemsîye šœ‡ƒ…‚šžÿœ: Eski Kozmoğrafyaya göre; güneşi döndüğü farzedilen dâirenin on iki burca tekabül eden kısımları.
derece šœ‡œ: (C.: Derecât) Yukarıya çıkacak basamak. * Dairenin bölündüğü dilim. 360 kısmın beheri ki, açıları ölçmeye yarar. * Termometrenin bölündüğü kısımların beheri. Mertebe, paye. * Miktar, rütbe.
derece-î hararet šœ‡œý¯¯ó‚ˆœƒœ…: Isı derecesi.
derece-î süllem: Merdiven basamağı.
derece-î şuhud šœ‡œý¯¯ó‚œš: îmanı ve mânevi hakikatları, mânevi terakki yoluyla görmek seviyesinde olan iman mertebesi.
dered: Ağızda diş olmamak.
derek: Urgan ucuna eklenip, kovanın kulpuna bağlanan ip parçası (urgan suya değmesin diye) * Kiriş uçlarında olan halka (yayın başlarına geçirirler.)
dereka: (C.: Deruk) Sığır derisinden yapılan kalkan.
derekât šœ˜ƒ…: Aşağılık dereceleri. En aşağı mertebeler.
dereke šœ˜œ: Aşağı inen basamak. Aşağı mertebe. * Sıfırın altındaki derece. Düşüklük.
dereke-î mîrkat šœ˜œý¯¯ó‚šœ—ƒ…: Merdivenin en alt basamağı.
derekî: Gerileme.
derem: f. Akçe, para.
derem: Baldır etli olduğundan dolayı topuğun görünmeyip belirsiz olması ve sâir kemiklerin etlilikten belirmeyip örtülmesi. * Ağızdan dişlerin dökülüp yerini et bürüyüp belirsiz olması. * Davarın yavaş yürüyüp adımlarını birbirine yakın atması.
derem-güzîn: f. Sarraf.
derem-sera: f. Para basılan yer.
dereman: Kişinin adımlarının birbirine yakın olması. (O kimseye "dârim" derler).
deren: Kir, vesah.
derende: f. Yırtan, yırtıcı.
derer: Kasdetmek.
deres: Nişanın belirsiz olması. * Kaftanın eskimesi. * Evin köhne olması.
dergâh šœ‚ªƒœ: (Der-geh) f. Cenab-ı Hakk'a ibadet edilen yer. * Büyük bir huzura girilecek kapı. Kapı. Padişahların kapısı. * şeyhlerin tekkesi.
dergâh-i âlî šœªƒœó‚”ƒ™ž: Padişah kapısı. Yüksek dergâh.
dergâh-i muallâ šœªƒœó‚š”™ƒõ: Büyük kapı. * Mc: Saray.
dergîş: f. îzdiham, çok kalabalık. * Bir zerdali cinsi.
derh: Men etmek, engel olmak.
derhal šœˆƒ™: f. şimdi, hemen, bu anda, vakit kaybetmeden.
derhem: f. Karışık, karmakarışık. * Muztarib, sıkıntılı, ıztırab çeken. * încinme.
derhîşte: f. Cömertlik, sehavet.
derhor: f. Lâyık, münasib, uygun, yakışır, derhuş, sezâ, şâyeste. (Derhurd da denir.)
derhuş: f. Derhor, lâyık, münasip, muvafık, uygun, yakışır, şayeste.
derî: f. Farsçanın sahihi, fasih olanı. (Kapı demek olan "der" ismi Farsça olduğu halde Arapça sayılarak müennesi "deriyye" yapılmıştır.) * Havası hoş ve lâtif. Yeşilliği bol olan dağ eteği.
derîçe: f. Küçük kapı, oyma kapı. Pencere.
derîde: f. Yırtık, yırtılmış.
derîr: Yürügen davar.
derîs: (C.: Dirsân) Eski kaftan, eski elbise.
derîyye: Avcıların gizlenip av gözledikleri yer.
derk šœ˜: En aşağı kat, her şeyin dibi. Aşağı inen basamak. * Anlamak.
derk-î dekaîk šœ˜ó‚š—ƒ¡—: înce ve dakik şeyleri iyice kavrama, anlama.
derkaa: Kaçmak, firar.
derketmek šœ˜‚ƒÿ…š˜: Bir şeyin en esasını, dibini öğrenmek, iyice anlamak.
derma': Topuğu belli olmayan, şişman kadın. * Tavşan. * Kırmızı yapraklı bir acı ot.
derman: f. îlâç, tiryak. * çare-i necat, kurtuluş sebebi. * Tâkat, güç, kuvvet.
dermande: (c.: Dermândegân) f. âciz, beceriksiz, biçare, zavallı.
dermek: çok beyaz olan un. * Beyaz ekmek.
dermeyan šœ‚šÿƒ›: (Der-miyân) f. Ortada olan şey, arada.
dermeyan etmek šœ‚šÿƒ›‚ƒÿ…š˜: Anlatmak, söylemek, iddia ve defi'de bulunmak. Beyân. îleri sürmek.
dernek: Eğlence için yapılan toplanma. * Düğün. * Cemiyetler kanununa göre kurulmuş cemiyet.
derpey šœ¨ÿ: f. Hemen, ardı sıra.
derpîş šœ¨ÿ: f. önde olan, göz önünde bulunan.
derr šœ: îyi iş. îyilik. Mahz-ı hayır. * Zat, kimse. Hod. Nefs. Bir kimsenin zâtı. * Yüzün tazeliğinin, teravetinin hastalıktan dolayı gitmesinden sonra, iyi olup düzelmesi.
derrace: Eskiden kullanılan bir çeşit harb âletidir ki, üstü sığır derisi ile örtülü olup, tekerlekleri içinde dönerdi. * Bisiklet.
derrak: (Derk. den) çok dikkatli olan, çabuk anlayan, anlayışlı, müdrik.
derrar: Yün eğerdikleri iğ.
ders šœž: Tenbih, tâlimat, vazife. Bir şeyi öğrenmek için muallim veya o işi iyi bilen birisinden azar azar alınan vazife. * Akıl.
ders-han: f. Ders okuyan, talebe, öğrenci.
ders-î amm šœž‚”ƒš: Bir medreseyi bitirdikten sonra, tâbi tutulan imtihan sonunda medrese talebelerine ders vermek salâhiyetini kazanan. * Asistan. * Herkese ders vermeğe salâhiyetli âlim.
ders-î îbret šœžó‚”„œ…: îbret dersi. Göz ve fikir açacak hâdise.
dersec: Mercimek.
dershane šœž‰ƒ›œ: f. Sınıf, ders verilen yer, ders yeri.
dert-mend: Dertli.
deruc: Hızlı esen rüzgâr, fırtına.
deruhde šœ”œšœ: f. üstüne almak. Kendini vazifeli bilmek. * üzerine alınan iş.
derun šœ›: f. îç taraf. Dâhil. * Kalb.
derunî šœ›ž: f. Gönülden, içten.
derva(h): f. şaşkın, şaşırmış olan, hayran. * Başaşağı asılmış. * Lâzım, zaruri, lüzumu olan, gerekli.
dervah: f. Hastalıktan yeni kurtulan, iyice kendisine gelemeyen kimse. * Sağlam, metin, muhkem. * Doğru, asıl, gerçek. * Yiğitlik, cesaret, cesur olmak, şecaat. * Ayıp, utanma. * Sertlik, kabalık.
dervaze: f. Kapı. şehir. şehir kapısı, kale kapısı.
dervâze-î nuş $: Mc: Ağız.
dervîş šœÿ: f. Gayet mütevazi ve kanaatkâr olan. * Kimsesiz, fakir. * Mâneviyâtla gönlü zengin olan fakir. * Mürid veya şeyh.
dervîşân: (Derviş. C.) f. Dervişler.
dervîşâne šœÿƒ›œ: f. Dervişe yakışır halde, saflık ve kalenderlikle. Müstağni ve fakir bir surette.
dery: Bilmek.
derya šœÿƒ: f. Deniz, bahr.
derya-bend: f. Liman. * Tersane.
derya-mîsal: Deniz gibi çok olan, denizi andıran.
derya-neverd: f. Denizde dolaşan, denizde gezen.
derya-nuş: f. çok fazla içki içen.
derya-yi ahdar: Yeşil deniz. * Mc: Sema, gök.
derya-yi ebyaz šœÿƒžó‚¤„ÿ‘: Akdeniz.
derya-yi esved šœÿƒžó‚¤žš: Karadeniz.
derya-yi umman šœÿƒžó‚”šõƒ›: Açık deniz. Umman Denizi. Okyanus.
deryab: f. Akıllı, anlayışlı, müdrik.
deryaçe: f. Göl, küçük deniz.
deryan: Bilmek, ilim.
deryanîye: Hörgücü ikiden fazla olan sığır nevi.
deryuz: f. Dilencilik.
derzen: f. îğne.
de's š¤ž: Yemek.
des šž: f. Eş, eşit, müsâvi, benzer, denk.
des' šž”: Def'etmek kovmak. * Ağız dolusu kusmak.
de'sa: Câriye.
desaîs šžƒ¡ž: (Desise. C.) Vesveseler, desiseler. Gizli hileler.
desaîs-î şeytanîyye: şeytanca desiseler, hileler.
desak: Bir kabın dolduktan sonra taşıp dökülmesi.
desatîr šžƒ…ÿœ: (Düstur. C.) Düsturlar, kaideler. (Desatir-i hikmet, nevamis-i hükümetle; kavanin-i hak, revabıt-ı kuvvetle imtizac etmezse cumhur-u avamda müsmir olamaz. M.)
desatîr-î âlîye šžƒ…ÿœó‚”ƒ™ÿœ: Yüksek ve ulvi düsturlar ve kaideler.
desatîr-î hîkmet šžƒ…ÿœó‚ˆ˜š…: Hikmet düsturları. Hikmet ve maslahatın iktiza ettirdiği kaideler.
desâtîr-î îlmîye šžƒ…ÿœó‚”™šÿœ: îlmin düsturları. îlmin icab ettirdiği kaideler.
desâtîr-î îslâmîye šžƒ…ÿœó‚¦ž™ƒšÿœ: îslâma ait kaide ve düsturlar.
desem: (C.: Düsum) Yağ. * Uyuz.
desen: Fr. Eşyanın, rengini göstermeden, yalnız şeklinin bir satıh üzerine çizilmişi. * Bir kumaşı süsleyen şekiller.
desfan: (C.: Desâfi) Bir şeye tâlip olan kişi.
desî': îki omuz arasında boyun battığı yer.
desîa: Atâ, bahşiş, hediye. * Huy, hulk, tabiat.
desîk: Dolu nesne.
desîmetre: Fr. Metrenin onda birine eşit uzunluk birimi.
desîs: (C.: Desâyis) Gizlenmiş, gizli.
desîse šžÿžœ: Gizli hile, oyun.
desîsekâr: f. Hileci, hile yapan.
desîsekârâne šžÿžœ‚˜ƒœƒ›œ: f. Hilekârcasına. Desise ve hile edene yakışır surette.
deskere: (C.: Desâkir) Dağ başında olan harab kale. * Küçük köy.
deskere: f. şehir ve kasaba, il ve ilçe. * Hasta insan, eşya vs. taşımaya yarayan tahta.
desma: Siyah olan nesne.
desmere: (C.: Desâmire) Dağ başında olan harap yıkık kale.
despot: yun. Rum piskoposu. * Eskiden Bizanslı ve Balkanlı derebeyi.
desr: (C.: Dusur) Bürünmek, örtünmek. * çok olan mal.
desr: Def'etmek, kovmak.
dess š†: Yavaş yağan yağmur. * Acıtıcı derecede dövmek. * Def'etmek.
dess šž: Gizlenmek. * örtmek.
dessas šžžƒž: çok aldatıcı, çok desiseci.
desse: Toprak içinde gömülüp yatan bir nevi yılan.
dest šž…: (C.: Düsut) Dört bucaklı yastık ve elbise. * Hile.
dest šž…: f. El, yed. * Mc: Kudret, fayda, nusret, galebe. * Düstur. * Tasallut. * îkmâl. * âli makam. Meclisin şerefli yeri.
dest ü pâ(y): El ve ayak.
dest-alay: f. Bulaşık el, bulaşmış el.
dest-be-dest šž…‚„œ‚šž…: f. Elden ele, el ele. * Peşin satış. * Birbirine bitişik olan.
dest-beste: f. El bağlamış, eli bağlı.
dest-bus: f. El öpme.
dest-bürd: f. Kuvvet, kudret. * üstünlük, zafer, muvaffakiyet.
dest-dîraz: f. El uzatan, zulmeden. * Sarkıntılık etme, el uzatma.
dest-erre: El bıçkısı. Testere.
dest-gâh šž…ªƒœ: f. îş yeri, tezgâh. * îktidar, servet, kuvvet.
dest-gîr šž…ªÿœ: f. Muavenet. Arka olmak. Tutucu, yardımcı, muin. Zahir.
dest-güşa: f. Avuç açan el açan.
dest-güzar: f. îmdada yetişen, yardım eden, yardımcı.
dest-huş: f. Oyuncak.
dest-î gaybî šž…‚•ÿ„ÿ: f. Görünmez el, inâyet-i îlâhi. * Mc: Allah'ın yardımı.
dest-î îstîbdad šž…ó‚¦ž…„šƒš: îstibdadın verdiği azap, istibdadın eli.
dest-î rast šž…‚œƒž…: Sağ el, sağ taraf.
dest-keş: f. Gözleri görmeyen bir kimseyi ellerinden tutup dolaştıran. * Kazanç. Kâr. * Yay gibi elde kolaylıkla idare olunabilen şey. * Dilenci. * Bir işten vazgeçen.
dest-mal: f. Elbezi.
dest-maye: f. Sermaye, elde olan şey.
dest-muze: f. Armağan, hediye.
dest-pak: f. Fakir, fukara. * Mendil. * Dindar.
dest-renc: f. El emeği. El ile yapılan iş. * ücret, kazanç, kâr.
dest-res šž…œž: f. îsteğine ulaşan, elini yetiştiren. * Kudret, zenginlik, iktidar.
dest-suze: f. Nişanlı kız.
dest-vane: f. Savaşta giyilen demirden yapılmış eldiven. * Kadınların kollarına taktıkları süs eşyası, bilezik. * Meclisin baş kısmı.
dest-var(e): f. çoban değneği. Baston. * El bileziği. * Ele benzer, el gibi, el kadar.
dest-yar: f. Yardımcı, muin. Arka.
dest-yarî: f. Yardım, muavenet.
dest-zen: f. Tutunma. * El uzatma.
destak: şarabın beyazlığı ve dökülmesi.
destan šž…ƒ›: f. (Dest. C.) Eller. * Hikâyeler, masallar. * Hile, tezvir, mekir. * Meşhur Zâloğlu Rüstem'in babasının nâmı.
destar šž…ƒœ: f. Sarık, imâme, başa sarılan tülbent.
destar-çe: f. Mendil.
destar-i hümayun: Pâdişah sarığı.
destarbend: f. Sarık saran, sarıklı.
deste šž…œ: f. Tutam, bağ, demet, kabza. * Muin, mededkâr. * Süpürge. * Küstah.
deste-çub: f. Sopa, değnek.
deste-dad šž…œ‚šƒš: f. El veren, yardım eden.
deste-dad-i teslîm: f. Teslim elini veren, itaat eden, uyan.
destec: Desti. * Kola takılan bilezik.
destek: f. Bir şeyin yıkılıp devrilmemesi için, o şeye vurulan payanda, dayanak. * Küçük el. * Yün ve pamuk gibi şeyleri eğirmeye yarıyan âlet.
destî šž…ž: f. Testi.
destîne: f. Bilezik, el bileziği.
destroyer: ing. çok sür'atli giden küçük savaş gemisi, torpido muhribi.
destur šž…œ: f. îzin, müsaade. şerlilerden kurtulmak için söylenen söz. * Allah'ın inayeti.
destur (düstur): Asıl. * Kanun. * Vezir-i azam, baş vezir.
deşîşe: Bulgur.
deşne: f. Hançer.
deşne-î subh: Tan yeri. (Bu tabir, tan yerinin ilkönce hançer şeklinde göründüğünden kinaye olarak denmiştir.)
deşt: f. Bozkır, çöl, sahra. Kumluk ve nebatsız geniş arazi.
deşt-î hayat: Hayat çölü.
deşt-î kipçak: Dinyester ile îrtiş arasında bulunan geniş step.
detektîf: (Bak: Dedektif)
determînant: Fr. Denklemlerin çözümlerini rahatlıkla bulmaya yarayan matematiksel tablo.
dev šÿ: şeytan, ifrit, cin.
de'v: Aldatmak, hud'a.
deva šƒ£: îlâç, çare. Hastalığın iyi olmasına sebeb olan gıda.
deva na-pezîr: Devâsı bulunmaz hastalık.
deva-saz: f. çâre bulan, ilâç tertip eden.
devabb šƒ„: (Dabbe. C.) Binek hayvanları. Hayvanlar. * Yürüyenler.
devac: f. üste örtünecek şey. Yorgan.
devadar šƒšƒœ: f. Devâlı, devâ verici, iyileştiren.
devahî šƒœÿ: (Dâhiye. C.) Büyük belâler. Afetler. Kazâlar. * çok üstün zekâ sahipleri.
devahîl: (Dâhile. C.) îçler, batınlar.
devahîn: (Dâhine. C.) Duman çıkaran bacalar.
devaî šƒ¡ÿœ: (Devâiye) îlâç cinsinden. îlâca âit ve müteallik. Devaya dâir.
devaî šƒ”ÿ: (Dâiye. C.) Batından, içten gelen bir duyguyu teşvik edici hâlât.
devaîr šƒ¡œ: (Dâire. C.) Daireler. Resmi işlerin görüldüğü yerler.
devaîr-î askerîye šƒ¡œó‚”ž˜œÿœ: Askeri daireler.
devaîr-î devlet šƒ¡œó‚š™…: Devlet daireleri.
devaîr-î mütedahîle: îç içe daireler.
devaîr-î resmîye šƒ¡œó‚œžšÿœ: Resmi daireler.
devalüasyon: Fr. Paranın değerinin düşürülmesi.
devam šƒš: Bir halde bulunma, sürekli olma, daimilik. * Bir işe veya bir memuriyete gidip gelme. * Sebat.
devan: f. Hızlı yürüyen, koşan, seğirten.
devanîk: (Dânık. C.) Bir dirhemin dörtde birleri.
devar: Baş dönmesi hastalığı.
devarî' šƒœ”: (Dır. C.) Zırhlar. Zırhlılar. Zırhlı gemiler.
devat: (C.: Devâyât) Divit.
devavîn: (Divân. C.) Divânlar, eski şairlerin şiirlerini topladıkları kitablar.
devb: Kötü hâl.
devbel: Bir karar üzere durup büyümeyen küçük eşek.
devdat: çocukların oyun oynadığı yer.
devderî: Kısa boylu cariye.
devende: f. Seyyah. Seyahat eden, gezen, dolaşan.
deveran šœƒ›: Dönüş, dolaşmak. Tedavül. Yerinde durmamak. Devretmek.
deveran-i dem šœƒ›ó‚šš: Kan dolaşımı, kan deveranı.
deveran-i dünya šœƒ›ó‚š›ÿƒ: Dünyanın dönüp devretmesi.
devf: Suda ıslamak. * Irak etmek, uzaklaştırmak. * Misk ezmek.
devh: Hor, hakir olmak. Hor, hakir etmek. * Kahretmek.
devha šˆœ: (C.: Devah-Devâyih) Büyük ağaç.
devîr šœ: (Devr) (C: Edvâr) Nakil. Birisinin uhdesinden diğerinin uhdesine geçirmek. * Bir şeyi sonuna kadar okuyup bitirmek. Geçmiş dersleri hatırlama. * Bir şeyin çevresinde dolaşmak. Dönme. * Seyahat. Bir memleketi dolaşmak. * Bir şeyin kendi mihveri üzerinde dönmesi. * Aktarma, bir şeyin bir kaptan veya bir yerden diğerine nakli. * Bir şeyin diğerine teslimi. * Bir bölük veya takım askerin teftiş veya emniyeti muhafaza için dolaşması. * Bazı ehl-i tarikatın dönerek ettikleri zikir, sema. * Müzikte, her ölçüye verilen isim olup, umumiyetle büyük ölçüler ve peşrevler için kullanılır. * Tas: Dünyaya gelme (Nüzul), geldiği yere dönme hali (Uruc). * Dairevi bir hareket. Bir şeyin diğer bir şey etrafında dönmesi. Dolaşmak. * Müddet. Zaman. çağ. * Bir şeyi başkasına devretmek. * Biri birisini icad etmek. (Bak: Hudus)
devîr daîresî šœ‚šƒ¡œœ‚žÿ: Denizde geminin çeşitli hızla ve muhtelif dümen açısı ile çizdiği dâire.
devîr ve teselsül šœ‚…ž™ž™: Davanın delile ve delilin davaya taalluk etmesiyle kaziyenin dönüp dolaşıp yine eski hâline gelerek hallolunamaması.
devîrlî: Fiz: Müsavi zaman aralıkları ile tekrarlanan hareket. Periyodik.
devîye: Otsuz sahrâ. Otu olmayan çöl
devîyy: Nerden geldiği anlaşılamayan sesler, gürültüler, patırtılar.
devk: Döğmek. * Karışmak.
devke (deveke): Karışmak, ihtilât.
devkes: Arslan. * çok adet, çok miktar.
devle (düvle): "Devlet" kelimesinin Arapça tabirlerde geçen bir şekli. * îki asker muharebe ettiklerinde birinin diğerine galip olması. (Düvlet malda; devlet harpte ve mertebede kullanılır.)
devlet š™…: Sınırları belli olan bir memleketin sahibi olan insanların kurduğu siyasi, hukuki, idari mahiyetteki merkezi teşkilât. Devlet, teşekkül tarzı, takip ettiği esas siyaset, temsil ettiği hâkimiyet ve iktidarın mahiyeti bakımından çeşitlere ayrılır:1- Kapitalist Devlet: îktisadi siyasete, şahsi mülkiyet, şahsi teşebbüs ve serbest rekabete dayanan, iktidar ve hâkimiyetin kapitalist sınıfın elinde bulunduğu devlet şeklidir.2- Sosyalist ve Komünist Devlet : şahsi mülkiyeti ortadan kaldıran, yerine işçi sınıfı adına devlet mülkiyetini ikame eden, işçi sınıfı hâkimiyeti namı ile komünist partisi diktatörlüğünü getiren devlet şeklidir.Bu iki devlet şeklinin iktisad siyasetleri ile siyasi iktidar ve hâkimiyet anlayışları farklı olmakla beraber devlet idaresinde dine yer vermemekte birleşirler.3- Faşist Devlet: Menfi milliyet ve unsuriyet fikrini siyasette hâkim kılan, şahsi teşebbüse müsaade eden; fakat devletin vesayeti ve hâkimiyeti altına alan, meslek zümreleri adına iktidar ve hâkimiyeti tek parti ve şefinin eline veren devlet şeklidir.4- Teokratik Devlet: Hâkimiyet ve iktidarın, ruhban sınıfının elinde bulunduğu bir devlet şeklidir. Daha çok Hristiyan âleminde asırlar boyunca bu devlet şekli cemiyet ve milletlere hükmetmiş, fakat tahrif edilmiş încil'e sâhib oldukları ve îlâhi iktidar ve hâkimiyet yerine ruhban sınıfının hâkimiyet ve iktidarını ikame ettikleri için, insanın fıtratındaki hakikatı taharri ve hürriyet fikri galebe çalarak bu devlet ve idare şekli Fransız ihtilâliyle yıkılmış, fakat ihtilâlciler ve muakibleri beşeriyeti yeniden ıztırablara dûçar eden kapitalist, sosyalist ve faşist sistemlerden başka birşey getirememişlerdir. çünki hareket ve istinad noktaları beşeri fikir ve ölçüler olup materyalist (maddeci) dünya görüşlerinin zaruri neticesi olarak teavün yerine cidal; hak yerine kuvvet; iktisat yerine ihtiyaçları tezyid ve tahrik ettiklerinden beşeriyetin huzur ve saadetlerini bozdular.5- îslâm Devleti: îktidar ve hâkimiyeti milliyet ve unsuriyet, yahut içtimai sınıflarda veya ruhban sınıfında değil; yalnız Allah'ta kabul eder. Halkı veya siyasi temsilcisi olan kişiyi yahut meclisleri, îlâhi iktidar ve hâkimiyetin tatbikçi memurları olarak kabul eder.(Zaman-ı sâbıkta revabıt-ı içtima ve levazım-ı taayyüş ve fevaid-i medeniyet o kadar tekessür ve teşa'ub etmediğinden, bazı kalil adamların fikri, devletin idaresine yarı kâfi gibi idi. Amma bu zamanda revabıt-ı içtima o kadar tekessür etmiş ve levazım-ı taayyüş o derece taaddüt etmiş ve semerat-ı medeniyet o kadar tefennün etmiş ki, ancak yalnız kalb-i millet hükmünde olan meclis-i meb'usan ve fikr-i ümmet makamında olan meşveret-i şer'i ve seyf ve kuvvet-i medeniyet menzilinde bulunan hürriyet-i efkâr o devleti taşıyabilir ve idare ve terbiye edebilir. R.N.)
devlet ü îkbal š™…‚¦—„ƒ™: Ulviyet ve iyi tâlih.
devlet-abadî: f. Hindistan'ın Devlet-âbâd şehrinde imal edilen ve güzel san'atlarda kullanılan bir çeşit kâğıt.
devlet-î âlîye š™…ó‚”ƒ™ÿœ: Osmanlı împaratorluğu.
devlet-meab: Devletin saadet ve ihtişamının sığınacağı yer, hükümdar.
devlet-medar: Büyüklük merkezi olan (hükümdar)
devletçîlîk š™…‡ÿ™˜: Halk işlerinin, hususan büyük sanayi ve ziraatin devlet vasıtası ile işletmesi usulü. Cemiyetin umuma âid olan işleri ve bu işler için lâzım gelen teşkilât, müessese ve sâirelerini devlet eliyle yapılmasını kabul eden idâre sistemi. * Halkın hususi teşebbüslerini veya büyük müesseselerini devlete devretmek fikri. (Bunun ifratı fertlere ve millete zulümdür ve dinsizlik rejimi olan komünizme giden bir usuldür.)
devlethane: f. Ev, köşk, konak.
devletlî (devletlü): f. Eskiden vezir ve müşir gibi büyük rütbeli kimselere verilen bir ünvan.
devletlü necâbetlü: Osmanlılar zamanında şehzâdeler için kullanılan bir tabirdir.
devletlü re'fetlü: Eskiden seraskerler için kullanılan ünvan.
devletlü semâhatlü: Zamanında şeyh-ül îslâmlara verilen bir ünvan.
devletlü utufetlü: Vezirlere, müşirlere, padişah damatlarına verilen ünvan.
devr šœ: (Bak: Devir)
devr šœ: f. Casus, hafiye.
devr-han: f. Kur'an-ı Kerim'i devamlı okuyup devreden kişi.
devr-î âlem šœó‚”ƒ™š: Dünya seyahati, dünya gezisi, dünyayı gezmek.
devr-î bâtil šœ‚„ƒ’™: Man: Kısır devir. Bir hükmü ikinci bir hüküm ile, bunu da birincisi ile isbatlamaya çalışma yolu.
devr-î dîl-ârâ: En hoş devir. Gönlü hoş eden zaman.
devr-î ebvab šœ‚¤„ƒ„: Kapı kapı gezip dolaşmak.
devr-î felek šœó‚–™˜: (Bak: Devr-i zaman)
devr-î kasir šœ‚—ƒœ: (Devre-i kasire) Fiz: Kısa devre.
devr-î lâle: Lâle devri, lâle mevsimi, lâle zamanı.
devr-î mîhnet šœó‚šˆ›…: Dünya, cihan, küre-i arz.
devr-î sâbik šœó‚žƒ„—: Bir önceki hükümet. Geçmiş devir.
devr-î tefrîh šœ‚…–œÿ‰: Kuluçka devri.
devr-î terakkî šœó‚…œ—õž: îlerleme devri.
devr-î zaman šœó‚šƒ›: (Devr-i felek) Tali, kader. şans.
devrak: şarap ölçeği.
devran šœƒ›: Devir, felek, zaman, deveran, dünya.
devranî: Deverana âit ve müteallik.
devre: (C.: Devrât) Dönüş dönme, dönem. * Birkaç yıldan meydana gelen zaman süresi. * Elektrik devresi. üzerinden elektrik akımı geçmekte olan bir iletken yolun tamamı.
devrîy: (Devriyye) Geceleri gezen kol takımı, gezici karakol. * Bülbül, karatavuk, sığırcık ve bu gibi kuşların dahil olduğu sınıf.
devrîyye: Osmanlı împaratorluğu devrinde ilmiye sınıfına mahsus bir pâye.
devs: Ziynet etmek, süslemek. * Bir şeyi ayağı ile basıp çiğnemek.
devsere: Büyük, semiz, kuvvetli deve.
devş: Fâsid olmak.
devv: Otsuz çöl.
devvar šƒœ: Durmayıp dönen, devreden. Devredip gezen. * Gerdân. * Kâbe-i Muazzama'nın bir adı. * Haremden alıp beraber tavaf edilen taş.
devvare: Geo: Daireler çizmeye yarayan bir âlet, pergel.
deyabüz: îki ırgaçla dokunan bez.
deyacîr: (Deycür. C.) Karanlıklar, zulümatlar.
deybub: Koğucu, dedikoducu.
deycuc: (C.: Deyâcic) Karanlık, zulmet.
deycur: (C.: Deyâcir) Karanlık.
deydan: Edep. * âdet.
deyden: Edep. * âdet.
deydenet šÿš› : âdet, usul.
deydenun: Toplamak. * Haslet, huy, âdet. * Oyun.
deyh: (C.: Diyeha) Hor ve rezil olmak.
deyku': Katı, şedid.
deylem: Karıncaların ve kenelerin toplandığı yer. * Belâ. * Zahmet. * Düşman. * Türaç kuşunun erkeği. * Cemaat. * Bir kabile adıdır ve ehline "Deylemi" derler.
deymas: (C.: Deyâmis) Hamam. * Alçak zemin.
deymum šÿšš: Devamlı, berkarar, zevalsiz.
deymumet: Daimlik, devam, dâimiyet.
deymumî šÿššÿ: Devamlılık, devam, dâimiyet.
deyn šÿ›: Borç. Verilmesi lâzım gelen şey. * Fık: Zimmetinde sâbit olan şey.
deyn-î hâl šòÿ›ó‚ˆƒ™: Huk: Herhangi bir vakte bağlı ve te'hir edilmeyen borç.
deyr: (C.: Edyâr) Kilise, manastır. * âlem-i insaniyet, insanlık âlemi.
deyranî: Manastır adamı.
deyrhane: f. Kilise, manastır.
deysak: (C.: Deyâsik) Uzun yol. * Beyaz olan şey.
deysan: Cömertlik.
deysem: Köpekten olmuş kurt eniği. * Sultan böreği denilen kırmızı çiçekli bir ot.
deyseme: înci.
deyyan šÿƒ›: Herkesin hesabını ve hakkını en iyi bilen ve veren. Hâk Teâla. Kahhar. Hâsib. Hâkim. Kadir. Râi. Cenâb-ı Hak.
deyyar šÿƒœ: Bir kimse. Ehad. * Yurt sahibi birisi. * Manastır sahibi.
deyyas: Kaba, galiz olan kimse.
deyyus: Derare. Karısının kötü hâllerine göz yuman ve ses çıkarmayan adam.
de'z: Boğmak. * Bir şeyi doldurmak.
dia: Rahat.
diame: (C.: Diam-Deâyim) Evin direği. * Ulu, şerif kişi, seyyid.
diayet: Dâvet.
dibabe: Yumuşak nesne.
dib'an: (C.: Dabâin-Dıbâ) Erkek sırtlan.
dibatr: Katı nesne.
di'bîl: Belâ. * Meşakkat, güçlük.
dibk: Bürc dedikleri nesne ki ağaçta biter; yazda ve kışta bitmez. * Ağaç posası.
dibne: Gülmek. * Maymun sesi.
didd: (C.: Ezdad) Mugâyir, aykırı. * Düşman. * Nazir, misil, benzer.
di'f: (C.: Ez'âf) Her nesnenin bir misli miktarı.
difda': (C.: Defâdı') Kurbağa.
difdi' (difda'): (C.: Dafâdi) Kurbağa.
diffe: Irmak ve kuyu kenarı.
digs: (C.: Edgas) Yaş ve kuru karışık bir tutam ot. * Te'vili sahih olmayan karışık rüya.
diham: (Dahm. C.) Kalın ve iri olan şeyler.
dihas: çok, kesir. * Eskimeye yakın olan.
dihh: Güneş, şems.
dihk ‘ˆ˜: Gülme.
dihk-âver: f. Güldüren, güldürücü.
dihl: Kısa boylu, tıknaz kimse.
dihle: Bir kişinin her işine karışan has adamı.
dihrac šˆœƒ‡: (Dahrece) Yuvarlama.
dihris: (C.: Dehâris) Terzilerin kullandığı tiriz denen cisim.
dihvenne: Habis kimse. * Semiz kısa boylu, tıknaz kişi.
dihye šˆÿœ: Sahabeden bir zâtın adı. (R.A.)
di'îl: ölüme yakın olan hasta deve. * Kurbağa yumurtası.
diîn: Asıl. * Maden.
di'îs: Süngü ile çok vuran kimse.
dikak: Herşeyin ufalmışı, incesi, kırıntısı. * şirden adı verilen bağırsak.
dikîs: Akılsız kadın.
dikk: Yufka gibi ince olan şey. * Bir nevi sıtma.
dikka: (C.: Dükuk) Rüzgârın savurduğu toprak. * Uzaklaşmış olan şey.
dikrar: (C.: Dekârir) Koğucu, dedikoducu. * Belâ. Zahmet. * Yalan söz. * Fuhşiyât.
dil' ‘™”: Karpuz veya kavun dilimi. * Tıb: Kaburga kemiği. * Geo: Dik kenar. Kenar.
dil'-î kâzîb: Tıb: Göğüs kemiğine dayalı beş adet küçük kaburga kemiği.
dil-azar š™‚¥ƒœ: f. Gönlü inciten, hatır kıran.
dilamîs: Yumuşak ve berrak olan şey.
di'lîye: Deve kuşunun dişisi.
dimad: Yara üstüne yapılan yakı ve bağlanan bez.
dimar ‘šƒœ: Cehalet devrinde Arabistanda bir sanem (put) ismi. * Bir daha sâhibinin eline geçmesi ümid edilmeyen zâil olmuş mal. * Sonraya bırakılan vâde. Müddeti hudutsuz borç. * Gizli.
dimişk: (Bak: Dimişk)
dimn: Her nesnenin arası. * Koltuk.
dims: Duvar temeli.
dina: îzdihamlık, kalabalık, çokluk.
dinn(e): Bahillik.
dintar: çok yaşamış kertenkele.
dir': (C.: Dırâ'- Duru') Cevşen. Cenkte, muharebede giyilen zırh.
dirab: Erkek dişiye aşmak. * Küçük dağlar.
dirahşan šœ‰ƒ›: f. Parlak. Parıldayan. Parlaklık. Münevver, ziyâdar.
diraht šœ‰…: f. Ağaç. şecer.
dirak: (Daraka. C.) Deriden mâmul kalkanlar.
diram: Ateşin alevlenmesi. * Ateşin alevi. * Odun parçası, tahta parçası (tezcek ateş tutuşup alevlenir.)
dirar: Ziyân yetiştirmek.
diraz šœƒ: f. Uzun.
diraz-dest: f. El uzatan. El uzunluğu.
dirazî: f. Uzunluk.
direfs: îpek. * Katı, sağlam nesne. * Büyük iri yapılı adam. * Büyük deve.
dirga: Sıvı, balçık.
dirgam: (C.: Darâgım) Arslan, esed, gazanfer, şir, leys, haydar.
dirhamî: Bir dirhem.
dirr: Avret üzerine avret almak, evli iken bir daha evlenmek.
dirre: (C.: Direr) Sütün çokluğu. * Sütün akanı. * Turra. * Kırbaç.
dirrîz: Bahil kimse. * Kısa boylu, âdi kadın.
dirs ‘œž: Azı dişi. * Katı, muhkem yer. * Az yağmur. * Kötü huy.
dirs: (C.: Derâsa-Edrâs) Kertenkele, fare ve kedi gibi hayvanların eniği.
dirv(e): Av öğrenmiş olan köpek yavrusu. * Dağ ağaçlarından pelit ağacına benzer bir ağaç.
di's: Kum. * Kumdan yığılmaş yumuşak tepe.
di've: Nesep dâvâsı etmek. * Yalan dâvâ etmek.
diya: Helak olmak, telef olmak.
diyk ‘ÿ—: (Bak: Dik)
di'zabe: Kısa boylu ve eti çok olan kimse.
dî: f. Dün, dünkü gün, bugünden bir evvelki gün.
dî-şeb: Dün gece.
dîabe: Davet.
dîae: şehadet parmağı.
dîam(et): Binaya vurulan destek, direk, payanda. * îleri gelen, makamca yüksek olan baş başkan, reis, şef.
dîbac: (C.: Debâbic) Atlas dedikleri kıymetli ipek bez.
dîbace: f. Mukaddeme, başlangıç, önsöz.
dîbagat š„ƒ• : Tabaklama. Deriyi kullanılır ve temiz hale koyma işi.
dîbare: (C.: Dibâr) Bir evlek yer.
dîbbîc: Bir, ehad.
dîbbîh: Bir, ehad.
dîbg: Dibâgat etmek. Arınıp pâk olmak.
dîbl: Belâ ve zahmet.
dîbr: çokluk.
dîbre: çokluk.
dîbs (dîbîs): Pekmez. Hurma pekmezi. Bal. * çok cemaat.
dîbsa' (debsâ): Dişi çekirge.
dîcac: Ummanda yetişen büyük bir dikenli ağacın suyudur ve sabun gibi kiri izâle eder.
dîda': Devenin şiddetle yelmesi ve sıçraması. * Ay sonu.
dîdaktîk: yun. Mevzuu, hikmet ve nasihattan ibaret olan söz. öğretici.
dî'dan: Devenin çok yelmesi. * Bir şeyi örtmek.
dîdar šÿšƒœ: f. Mülâkat, görüş. * Görünme. * Yüz. çehre. * Görüş kuvveti, göz. * Açık, meydanda.
dîdar-i hürrîyet šÿšƒœ‚ˆœÿ…: Hürriyetin güzel yüzü.
dîdar-i pâk šÿšƒœ‚¨ƒ˜: Temiz yüz.
dîde šÿšœ: f. Göz, ayn, çeşm. * Görmek. * Gözcü. * Göz bebeği. * Göz ucu.
dîde-bân šÿšœ‚„ƒ›: Gözcü, bekçi, nöbetçi.
dîde-gîryan šÿšœ‚ªœÿƒ›: Teessürle ağlayan göz. Ağlayarak.
dîf š–: (C.: Edfâ) çok hararet. * Derin duvar. * Deveden gelen fayda, menfaat.
dîfaf: Hazırlandırmak.
dîfl š–™: Zakkum ağacı. * Katran. Zift.
dîfla: Ağu ağacı denen ve çok acı olan nesne.
dîfnas: Akılsız, ahmak kimse. (Müe: Difnes)
dîg: f. Topraktan yapılmış tencere, çömlek.
dîger: f. Başka, diğer, öteki.
dîger-bâr: f. Başka zaman, başka defa.
dîger-bîn: f. Başka kişilerin faydaları için fedakârlıkta bulunan kişi.
dîger-gun: f. Değişmiş, başkalaşmış, bozuk.
dîger-kâm: f. Başkalarını düşünen.
dîger-ruz: f. Diğer gün, başka gün.
dîh šœ: f. Köy, karye. * On sayısı.
dîh: f. "Veren, verici" mânalarına gelir ve kelimelerle birleşir. Meselâ: ârâm-dih $ : Rahatlık veren.
dîh: (C.: Diha) Hurma salkımı.
dîh-dar: f. Köy ağası.
dîh-gan: f. Ekinci, çiftçi, köylü.
dîh-hüda: f. Köy kâhyâsı, köy ağası.
dîhak šœƒ—: Dolu bardak.
dîhan šœƒ›: Kırmızı deri, sahtiyan. * (Dühn. C.) Vücuda sürünülecek yağlar.
dîhat: (Dih. C.) f. Köyler, karyeler.
dîhçe: f. Küçük köy. * çiftçi, köylü.
dîhda: Yuvarlamak. Döndürmek.
dîhi: Köyle ilgili, köylü, köye mensub.
dîhîm: f. Taç.
dîhîş: f. Verme, veriş, bağışlama, ihsan, atiyye.
dîhkan (dühkan): (C: Dehâkin) Sipâhi. * Köy kethüdâsı. * Emirlerin tasarrufunda kuvvetli olan, sözü geçen adam. * Bezirgân. * Acem fellahlarının maslahatgüzarı.
dîhlas: Arslan. * Yavuz, bahâdır, kahraman, çeri kimse.
dîhlîz: (C.: Dehâliz) Ev ile kapı arası.
dîk ‘ÿ˜: Darlık, sıkıntı. Gam. Kalbe sıkıntı veren.
dîk šÿ˜: Horoz.
dîk-ul elfaz ‘ÿ—‚ƒ™¤™–ƒ“: îfade zorluğu. Gayet ince ve derin ve ruhen hissedilen bazı mânaların ifade edilemeyişi.
dîk-un nefes: Nefes darlığı. 
dîk-ül efraf: çatal ibikli horoz.
dîkkat š—…: încelik, dakik oluş. Ehemmiyet ve kıymet verme.
dîkkat-î nazar š—õ…ó‚›“œ: înceden inceye düşünme ve bakma. Bakış inceliği.
dîkta šÿ˜…ƒ: Lât. Diktatörlerin davranışları. * Hiç ses çıkarmadan yerine getirilecek emir.
dîktatör šÿ˜…ƒ…œ: Fr. Mevcut kanunları çiğneyerek, örf ve adalet esaslarına aykırı olarak, devleti keyfine göre idare eden devlet adamı. Müstebid.
dîkte: Fr. Başkası tarafından yazılmak üzere söyleyip yazdırma. * Karşı koymayacak olan birisine, aşırı arzu ve isteklerini bildirip kabul ettirme.
dîl šÿ™: t. Lisan, zeban. * Ağızdaki tat alma duygusu ve konuşma uzvu. * însanların konuştukları lehçelerin her birisi. Lügat. * Muhtelif âlât ve edevâtın uzunca ve yassı, ekseriya oynak kısımları. * Coğ: Denizin içine uzanmış üstü düz mumluk, uzunca kara parçası. * Mc: Gıybet, mezemmet, dedi-kodu, çekiştirme.(însanın yüz cihazatından birtek cihazı olan lisanı; bir et parçası iken, iki büyük vazifesiyle yüzer hikmetlere, neticelere, meyvelere, fâidelere âlet oluyor.. Taamların zevkindeki vazifesi, ayrı ayrı bütün tatları bilerek cesede, mideye haber vermek ve rahmet-i îlâhiyyenin matbahlarına dikkatli bir müfettiş olmak ve kelimeler vazifesinde kalbe ve ruha ve dimağa tam bir tercüman ve santral olmak; elbette gayet parlak ve kat'i bir surette ihatalı ilme delâlet ve şehadet eder. Birtek dil, hikmetleri ve meyveleriyle böyle delâlet etse; hadsiz lisanlar ve hadsiz zihayatlar, nihayetsiz masnuat, güneş zuhurunda ve gündüz kat'iyetinde nihayetsiz bir ilme delâlet ve şehadet ve Allâm-ül Guyub'un daire-i ilminden ve hikmetinden ve meşietinden hariç hiçbirşey yoktur diye ilân ederler. ş.)
dîl š™: f. Gönül, kalb, niyet. * Cesâret, yürek. * Mandıra, ağıl.
dîl-âgâh: f. Kalbi uyanık. Akıllı, bilgili, görgülü. Gönül anlar.
dîl-ârâ: Gönül avutan, gönül süsleyen.
dîl-ârâ(y) š™‚¥œƒÿ: f. Kalbi süsleyen, gönlü zinetlendiren.
dîl-ârâm š™‚¥œƒš: f. Gönül eğlendirici, kalbe rahatlık veren. Gönül okşayan.
dîl-âsâ: f. Gönlü rahatlandıran, avutan.
dîl-asude š™‚¥žšœ: f. Kalbi rahat.
dîl-aşub: f. Kalbi sıkan, yüreğe sıkıntı veren, gönle eza veren. * Kalbi meftun eden güzel.
dîl-âver š™¥œ: Gönül alıcı.
dîl-âver š™¥œ: f. Yiğit. Cesaretli. Yürekli. * Gönül alıcı.
dîl-âverân: (Dil-aver. C.) Dilaverler, yürekliler, yiğitler.
dîl-avîz š™ƒÿ: f. Câzib, çekici, gönle asılan. Gönlü asılı tutan, dilber.
dîl-azad: f. Gönlü rahat, gönlü bir şeyle ilgili olmıyan.
dîl-azurde š™‚¥œšœ: f. încinmiş. Gönlü, kalbi kırılmış.
dîl-baz š™„ƒ: f. Güzel konuşan. Sözü ve işi hoş olan. Gönül eğlendiren.
dîl-bend: f. Gönül bağlıyan, seven.
dîl-ber š™‚„œ: f. Gönül alan, kalbi çeken. Güzel, dilber.
dîl-beste š™„ž…œ: f. Kalbi bağlı, âşık.
dîl-cu(y): f. Gönül çeken, gönül arıyan.
dîl-dade š™šƒšœ: f. Gönül vermiş, âşık.
dîl-dar š™šƒœ: f. Kalbi hükmü altında tutan. Sevgili, mâşuk.
dîl-duz: f. Kalbe batan, gönül delen.
dîl-düzd: f. Gönül çalan.
dîl-efruz š™‚ƒ–œ: (Dilfiruz) f. Kalbi yakan, gönül parlatıcı.
dîl-ferah: f. Sevinçli, gönlü rahat.
dîl-fîgar: f. Gönlü yaralı, âşık.
dîl-fîrîb: f. Gönlü aldatan, câzibeli.
dîl-germ: f. öfkelenmiş hiddetlenmiş, gönlü kızmış.
dîl-gîr: f. Kalbe sıkıntı veren gönül tutan. * Gücenmiş olan, kırgın.
dîl-güşa: f. îç açan, gönül açan, kalbe ferah veren. * Türk musikisinde bir mürekkeb makam.
dîl-hah: f. Gönül talebi, gönül arzusu.
dîl-harab: f. Gönlü yıkılmış, gönlü kırılmış.
dîl-hiraş: f. Yürek parçalıyan, tırmalıyan.
dîl-hun š™‰›: f. Kalbi yaralı, yüreği kanlı. Mükedder, mağmum.
dîl-hurrem š™‚‰œš: f. Neş'eli, gönlü sevinçli.
dîl-huş: f. Yüreği rahat, gönlü hoş.
dîl-î âvâre: Serseri gönül.
dîl-î derya: Denizin ortası.
dîl-î dîvane: Divâne gönül, deli gönül.
dîl-î pür-âteş: Ateşli gönül.
dîl-î suzan: Yanık, ateşli gönül.
dîl-î şeb: Gecenin ortası, gece yarısı.
dîl-î vîran: Harap gönül, yıkık gönül.
dîl-î zâr: Zavallı gönül.
dîl-keş š™˜: f. Gönlü çeken, kalbi cezbedici.
dîl-kub: f. Gönül zedeliyen, vuran.
dîl-mürde: f. Duygusuz, kalbi ölmüş.
dîl-nîşîn: f.Gönlüde yer tutan. Lâtif, hoş.
dîl-nüvaz: Gönül okşayan.
dîl-rîş: f. Dertli, kalbi yaralı, gönlü yaralı.
dîl-rüba: f. Gönül alan, gönül kapan.
dîl-saz: f. Gönül yapan.
dîl-sîr: f. Gözü gönlü tok.
dîl-sîtan: f. Gönül alan.
dîl-suz: Gönül yakan.
dîl-şad š™‚ƒš: f. Sevinmiş. Kalbi hoş olmuş.
dîl-şîkaf: f. Yürekleri delen, çok acıklı, dokunaklı.
dîl-şîken š™˜›: f. Can sıkıcı, kalb kırıcı.
dîl-şîkeste š™˜ž…œ: f. Kalbi kırık, gönlü kırılmış olan.
dîl-şüde: f. Gönlü gitmiş. âşık.
dîl-şüküfte: f. Gönlü açılmış, ferahlamış.
dîl-teng: f. Sıkıntılı, kederli, gönlü darda olan.
dîl-tengî: f. Gönlü darlığı, iç sıkıntısı.
dîl-teşne š™‚…›œ: f. Kalbi susamış. Gönlü çok istekli, çok özlemiş.
dîlahîs: Leşker, asker. çeri başı.
dîlalet: Kılavuzluk etmek. * Nazlanma. îşve. * üstünlük, galebe.
dîlas: (C.: Düles) Hızlı, seri.
dîlas (delîs): Yumuşak ve berrak olan nesne.
dîldîl: f. Iztırab, acı, elem, sıkıntı, azab. înilti.
dîldîl-künân: înleyenler, acı çekenler, ıztırab çekenler.
dîle: f. Dil, gönül, kalb yürek. * Gönül sahibi.
dîlekçe: (Bak: îstida)
dîlhas (dülâhîs): Arslan. çeri kimse.
dîlîr: (C.: Dilirân ) Bahadır, cesur, cesaretli, yiğit, yürekli.
dîlîrân: (Dilir. C.) Bahadırlar, cesurlar, cesaretliler, yiğitler, yürekliler.
dîlîrâne: f. Mertçesine, yiğitçesine, bahadırcasına.
dîlîrî: f. Mertlik, yiğitlik, yüreklilik.
dîlüvîyum: Jeo: Nehirlerin en eski alüvyonlarına verilen isim.
dîm: f. Yüz, yanak, çehre, surat.
dîma ššƒ: f. (Bak: Demâ)
dîma' ššƒ”: Göz yaşı akan yerlerin izi.
dîma' ššƒ£: (Dem. C.) Kanlar.
dîmağ ššƒ•: Beyin. Kafanın içi. (Bak: Kalb)(Dimağda merâtib var birbiriyle mültebis ahkâmları muhtelif. Evvel tahayyül olur sonra tasavvur gelir.Sonra gelir taakkul, sonra tasdik ediyor sonra iz'an oluyor, sonra gelir iltizam sonra itikad gelir.îtikadın başkadır, iltizamın başkadır. Herbirinden çıkar bir hâlet; salâbet itikaddan.Taassub iltizamdan, imtisal iz'andan, tasdikten iltizam, taakkulde bitaraf, bibehre tasavvurda.Tahayyülde safsata hasıl olur, mezcine eğer olmaz muktedir.Bâtıl şeyleri güzel tasvir etmek, her demde, sâfi olan zihinleri cerhdir, hem idlâli...S.)
dîmam: çocukların yüzlerine sürülen ilâç. * Sevap.
dîmar: Helâk, mahv.
dîmase: Yumuşak. * Asanlık, kolaylık.
dîme: (C.: Diyem) Gündüz veya gecenin üçte biri miktarı ile tam gün kadar sürebilen, gürleme ve yıldırımı, olmayan yağmur.
dîmen šš›: Süprüntülükler. Mezbele. Gübre. Fışkı.
dîmîşk: şam şehri. Suriye'nin başkenti.
dîmîşkî: şam şehriyle alâkalı. şam'a ait ve müteallik. * şam'da yapılan ve güzel san'atlarda kullanılan bir nevi kâğıt.
dîmkîs: îbrişim.
dîmmet: Deve ve koyun tersi.
dîmn: Deve ve koyun tersi.* Selin getirdiği çörçöp.
dîmne šš›œ: f. Tilki.
dîmne: (C.: Dimen) Ters. * Duvar temeli. * Kin, düşmanlık. * Süprüntülük.
dîn šÿ›: Ceza, ivaz. * îman ve amel mevzuu olarak insanlara Cenab-ı Hak tarafından teklif olunan Hak ve hakikat kanunlarının hey'et-i mecmuasıdır. Din, kâinatın, dünyanın hayatın ve insanın yaratılış gayeleri ve var oluş şekillerini açıklıyarak, onları mânasızlıktan ve abesiyetten kurtarır. însanların cemiyet hayatında barış içinde ve kardeşçe yaşamalarını sağlar, hakiki saadete ulaştırır. Dinin zayıfladığı cemiyetlerde ırkçılık ve ihtilâlci ideolojiler yayılır. Milletin birlik ve dirliği bozulur. * Cenab-ı Hakk'ın Dergâh-ı Uluhiyyetine kulluk edasına vesile ve medar olan ibadet, îslâm, şeriat. * Millet. * âdet, hâl, siyaset. * Hesab. * Kahr, galebe, istilâ. * Mâlik olmak. Aziz olmak. * îtaat etme. Verâ, takvâ. Mâsiyet ve ikrah ve hizmet. * Hüküm, kazâ ve ihsân. * Bir şeyi âdet eylemek, de'b. * Siret ve tarikat. * Tedbir ve tevhid. * Melik, mülk. * Birisini hoşlanmadığı şeye sevketmek. *Ist: Allah ile kul ve kullar arasındaki münasebetleri tanzim eden nizam.
dîn šÿ›: (Dyne) Fr. Fiz: Bir gramlık bir kütlenin hızını, saniyede bir santimetre artıran kuvvet ölçüsü.
dîn-î ferîd: Tek ve benzersiz olan hak din. îslâm dini.(Bernard Shaw demiş: "Din-i Muhammedi'nin (A.S.M.) en yüksek makam-ı takdire çıkmasının sebebi: Gayet acib ve sağlam bir hayatı te'min etmesidir. Bana açılan budur ki: O din; tek, yektâ, emsalsiz bir din-i ferid olup, bütün muhtelif ayrı ayrı hayatın etvarlarını ve çeşitlerini hazmettiriyor. Yâni: Islah ve istihale tarzında tasfiye ve terakki ettiriyor. Hem Muhammed'in (A.S.M.) dini öyle bir dindir ki, insanın ayrı ayrı bütün milletlerini kendine celbedebilir. Ben görüyorum ve itikad ediyorum ki: Beşere vâcibdir ki desin: "Muhammed (A.S.M.) insaniyetin halâskârıdır. Ve halâskârlık namı, O'na verilmek lâzımdır." M.)
dînak: îri gövdeli, şişman kadın.
dînamîk šÿ›ƒšÿ˜: yun. Cisimlerin hareketleriyle bunları meydana getiren sebebler arasındaki alâkayı araştıran mekanik ilminin bir kolu. * Hareket eden, durup dinlenmek bilmeyen, hareketli. * Fls: Sâbitin zıddı olarak bir kuvvet tesiriyle dâim hareket halinde bulunan ve bulunduran, bir değişmesi, bir oluşu olan. Hareketle birlikte te'sirli kuvveti de olan.
dînamo: yun. Hareketi elektrik akımına çevirmeye mahsus âlet.
dînan š›ƒ›: Küpler.
dînar š›ƒœ: Lât. Eskiden kullanılan altın ve sikkeli para.
dîndar šÿ›šƒœ: f. Dini kaidelere hakkıyla riayet eden, dininin emirlerini yerine getiren, mütedeyyin.
dîndarane šÿ›šƒœƒ›œ: Dindar bir kimseye yakışacak tarzda.
dînen šÿ›øƒ: Din bakımından, diyanet noktasından, dince.
dînkas: îfsad etmek, bozmak.
dînnabe: Kısa boylu kimse.
dînname: Kısa boylu.
dînneme: Kısa boylu.
dînperver šÿ›‚¨œœ: f. Sağlam dindar, dine hizmet eden. Salabet-i diniye sâhibi.
dînya: Emmi oğlu, amca oğlu.
dîplomat šÿ¨™šƒ…: yun. Memleket hakkında siyasi söz sâhibi. Dış meseleler hakkında milletlerarası işlerle uğraşan siyaset adamı. * Becerikli, söz söyliyebilen.
dîr' šœ”: Zırh, demirden gömlek. * Kadın gömleği.
dîr-baz: f. Uzun zaman, uzun müddet, uzun.
dîrahş: f. Nur, ziya, parıltı, parlama, ışık.
dîrahşan: f. Parlıyan, parlak.
dîrahşende: f. Işıklı, nurlu, ışıldayan, parıldayan.
dîraht: f. Ağaç. şecer.
dîraht-i meyvedâr: Meyve veren, yemişli ağaç.
dîrak: Tâbi olmaklık, itaat etmeklik.
dîran: (Dâr. C.) Evler, hâneler.
dîrase šœƒžœ: Kitab okumak. * Elbiseyi eskitmek. * Gizli yol. * Harmanda buğday döğmek. * Uyuz olan deveyi katranlamak.
dîrayet šœƒÿ…: Zekâ, bilgi. Kuvvetli tecrübe sahibi olmak. * Fetanet. Temkin ve tecrübeye dayanan akıl.
dîrayetkâr: f. Bilgili, dirâyetli, kavrayışlı.
dîrayetlî šœƒÿ…™ž: Kavrayışlı, zeki, bilgili, anlayışlı.
dîrdîh: Yaşlı, pir, ihtiyar kişi.
dîrdîm: Ağzında dişleri kırılmış ve kütelmiş yaşlı deve.
dîrefş: f. Alem, bayrak, sancak.
dîrektîf šÿœœ‚˜…ÿ–: Fr. üst makamlardan, tutulacak yol üzerine verilen emirlerin tümü, hepsi. Talimat, emir. Nasıl, ne şekil olacağına çalışacağına dair emir.
dîrektuvar: Fr. Fransız ihtilâlinin üçüncü yılında Konvansiyon'un yerine geçen idare şekli.
dîrem šœœš: (Dirhem) f. Eskiden kullanılan bir ağırlık ölçüsü. şimdiki üç gram ağırlık. Okka denen eski ağırlık ölçüsünün (1/400) kadarıdır. şer'an, orta büyüklükte yetmiş tane arpa ağırlığı. * Eskiden kullanılan ve beş kuruş değerindeki gümüş para. Akça.
dîrem-sera: f. Darbhâne, para basılan yer.
dîreng: f. Gecikme, yavaşlık, teenni, teahhur. * Dinlenme, karar, istirahat, aram.
dîrev: f. Ekin biçme, hasat.
dîrev-ger: f. Ekin biçen, orakçı.
dîrha: Süngü ile oynadıkları halka.
dîrham: (C.: Derâhim) Kuruş.
dîrhem šœœš: (Bak: Direm)
dîrhevs: Katı, şiddetli nesne, şedid.
dîrîğ šœÿ•: f. Men'etmek, korumak, esirgemek. * Eyvâh, yazık.
dîrîga: f. Yazık, eyvahlar olsun!
dîrîn(e): f. Eski, kadim.
dîrîtnot šÿœÿ…›ƒ…: (Diritnavt) ing. Büyük harp gemisi.
dîrkîte: Acem diyarında bir oyun adıdır. (Bir yere gelip raks ederler.)
dîrvas: Büyük deve. * Boynu kalın olan adam. * Arslan. * Köpek ve devenin sütü.
dîryak: Tiryâk, ilâç.
dîrz: (C.: Duruz) Dünya nimetleri. * Lezzet.
dîsam: şişe ağzına konulan tıpa. * Yaraya bağlanan bez. * Kulak içine sokulan şey. * Yarık ve delik tıkamada kullanılan tıkaç.
dîsar: (C.: Düsür) üste giyilen kaftan, elbise. * Yatak çarşafı. * Arapçada elbise demek olduğu hâlde Osmanlıcada yalnız Farsça kaidesi ile yapılan sıfat terkiblerinde ziyadelik, çokluk, bolluk mânasında kullanılmıştır.
dîsar šžƒœ: (C.: Düsür) Kenet, urgan, halat, perçin, mismar.
dîse: f. Kişi, şahıs, zât, fert.
dîsîplîn šÿž¨™ÿ›: Fr. Uyulması lâzım gelen kaide ve yasaklar. * Nizam ve intizam te'mini için zihni, ahlâki, ruhi, cismani tâlim ve terbiye.
dîskalîfîye: Fr. Müsabaka dışı bırakılmış.
dîv: f. Dev. * îblis, şeytan. * Cinn, ifrit.
dîv-bad: f. şiddetli rüzgâr, kasırga, fırtına. * Divanelik, delilik, cinnet.
dîv-beçe: f. Deve yavrusu.
dîv-came: f. Eskiden savaşlarda giyilen kaplan veya arslan postekisi.
dîv-çe: f. Sülük. * Kadın tuzluğu adı verilen bir bitki çeşiti. * Ağaç kurdu, güve. * Arka kaşağısı.
dîvan šÿƒ›: Eskiden yaşamış şâirlerin şiirlerinin toplandığı kitap. * Büyük meclis. Büyük ve idâre işlerine bakan bilgili, nüfuzlu kimselerin toplandıkları yer.
dîvan durmak šÿƒ›‚šœš—: Huzurda hazır olarak beklemek.
dîvan-i ahkâm-i adlîye šÿƒ›ó‚¤ˆ˜ƒšó‚”š™ÿœ: Huk: Kanunlara göre, bakılacak dâvalarla ilgilenmek üzere 1284 yılında kurulan ilk nizâmiye mahkemesi.
dîvan-i âlî šÿƒ›ó‚”ƒ™ž: Yüce divân.
dîvan-i deâvî nezaretî: çavuşbaşılığın kaldırıldığı 1836 (Hi: 1252) tarihinde bunun yerine kurulan daire. Fakat 1870 (Hi: 1287) tarihinde Adliye Nezareti'nin teşekkülü üzerine kaldırılmıştır.
dîvan-i eş'âr: şiirler divanı, şiirler kitabı.
dîvan-i harp šƒ›‚ˆœ„: Harp divanı. Yüksek rütbeli askerlerin harp mes'eleleri veya harp suçluları hakkında işler için toplandıkları meclis.
dîvan-i hümâyun: f. Halkın dâva ve şikâyetlerinin dinlenip halledildiği, devlet meselelerinin görüldüğü padişah huzuru. Bu mecliste; sadrazam, şeyh-ül îslâm, kazaskerler, defterdarlar ve sair büyük devlet ricali bulunurdu.
dîvan-i îlâhî šÿƒ›ó‚¦™úœž: âhiretteki hesap günü. Haşirde muhasebe günü.
dîvan-i nübüvvet šÿƒ›ó‚›„õ…‚: Peygamberler cemaati, peygamberler meclisi.
dîvançe: f. Kafiye itibariyle harf sırası tertibiyle yapılan küçük şiir mecmuası.
dîvane šÿƒ›œ: f. Deli. Aklı başında olmayan.
dîvane-gî: f. Delilik, divânelik.
dîvane-rev: f. çılgın, delicesine davranan.
dîvanhane šÿƒ›‰ƒ›œ: f. Odalar arasındaki büyük salon. Büyük ev. Divan kurulacak büyük oda. Saraylarda odalar hâricinde olan büyük salon.
dîvar: f. Duvar.
dîvâr-ger: f. Duvarcı.
dîve: f. îpek böceği.
dîvek: f. Ağaç kurdu, güve.
dîver: f. Ev sahibi.
dîvît: Yazı yazmak için kullanılan hokka ve kalemi bir arada ihtiva eden mahfaza.
dîyaf: Bir mevzi.
dîyanet šÿƒ›…: Dindarlık. Dinin hükümlerine riâyet ve muktezasınca amel etmek. Din emirlerinin hüsn-ü ihtiyar ile tatbiki. Din işleri.
dîyar šÿƒœ: (Dâr. C.) Memleket.
dîyar-i âhar: Başka, diğer memleket.
dîyar-i gurbet šÿƒœ‚•œ„ : f. Gurbet diyarı. Yabancı memleket.
dîyar-i küfr šÿƒœó‚˜–œ: îslâm ülkelerinden hariç olan memleketler.
dîyar-i rum šÿƒœ‚œš: f. Eskiden Osmanlı ülkesindeki Anadolu.
dîyas(e): Ekini davar ayağı ile bastırıp çiğnetmek. * Kılıcı ruşen etmek, kılıcı parlatmak.
dîyat: (Diyet. C.) Diyetler. (Bak: Diyet)
dîyeke: (Dik. C.) Dikler, horozlar.
dîyer: (Dâr. C.) Dârlar, hâneler, evler.
dîyet šÿ : Kan bedeli. Yaralanan veya öldürülen bir kimse için en yakın vârisine ödenmesi şer'an hükmolunan para veya mal. Can pahası. * Para, değer. Kıymet.
dîyet šÿÿ…: Tar: Almanya'yı meydana getiren devletlerin özel parlamentolarına verilen isim.
dîyet-î kâmîle: Huk: öldürülen şahsın nefsine bedel olarak, câniden veya ailesinden alınan tam diyet olup, miktarı öldürülen kişiye göre değişir.
dîz: f. Kal'a, sur.
dîza: Noksanlaştırmak. * Eziyet vermek. * Ezâ etmek. * Hor ve hakir etmek.
dîzçek: Dizleri muhafaza etmek için muharebelerde kullanılan bir nevi zırh.
dîzdar: f. Kale muhafızı, kale ağası.
dîz(e): f. Levn, renk.
doğa: (Bak: Tabiat)
doğa ötesî: (Bak: Metafizik)
doğma š•šœ: yun. Fikir, rey. * Fls: Kat'i olarak ileri sürülen fikir.
doğmatîzm: (Bak: Nassiye)
dok: ing. Gemi tamir veya inşasında kullanılan üstü örtülü havuz. * Ticari eşya için rıhtımlarda yapılan büyük depo.
doktrîn š—…œÿ›: yun. Hatt-ı hareket. Hareket tarzı. Düstur, tarik. Re'y. * Fls: Bir sistem meydana getiren fikir ve kanaatlerin hepsi. Bir felsefe veya edebiyat okulunun fikirlerinin tümü.
dolap š™ƒ„: (C.: Devâlib) Kuyudan su çıkarıp bahçeleri sulamaya mahsus döner makine. * Her çeşit döner çark, çıkrık. * îçine eşya vesaire konulan raflı veya rafsız göz. * Eskiden selâmlık ile harem arasında eşya alıp vermeye mahsus döner dolap ki, veren ile alan birbirlerini görmezlerdi. * îşlerin idaresi. * Mc: Hile, hile ile iş görme.
dolunay š™›‚¥ÿ: t. Ayın yuvarlağına karşı gelen yarım küre yüzeyinin tamamıyla aydınlık görünmesi hâli. Ayın 14 veya 15 nci günleri. * Bedir.
domanîç: Kambur. Tümsekli, fırlak.
domînyon: ing. Büyük Britanya împaratorluğu'nun, anavatanla aynı hakları olan deniz aşırı parçalarından beherine verilen isim.
dost šž…: (C.: Dostân) f. Sevilen insan, muhib, yâr. * Erkek veya kadın sevgili, mâşuk, mahbub, mâşuka, mahbube. * Hakiki dost ve âşıkların ve âriflerin âşık oldukları Allah.
dostan: (Dost. C.) Dostlar.
dostane šž…ƒ›œ: f. Dostça, dostlukla.
dostî: f. Dostluk.
doz: Kim: Bir maddenin bir karışıma girmesi gereken muayyen miktarı. * Tıb: Bir hastaya bir defada veya bir günde verilecek ilâç miktarı. * ölçü, miktar.
dönüm: 919 m2 lik eski bir arazi ölçüsü.
dövîz: Fr. Yabancı devlet parası. * Yabancı ülkelerde ecnebi paralarla ödenecek olan poliçe, çek gibi senetler.
dram šœƒš: yun. Korkunç ve kanlı tiyatro piyesi. * Müthiş bir vakıa. Musibet, felâket. Heyecan uyandıran hâdise veya hareket.
dramatîk šœƒšƒ…ÿ˜: yun. Drama benzer. Heyecan verici, acıklı. * Temsil yapılmak üzere yazılan heyecan verici veya acıklı tiyatro eseri. Acıklı olanına Trajedi, gülünç olanına da Komedi denir.
du': (C.: Ezvâ-Zayân) Erkek baykuş.
dua š”ƒ£: Allah'a (C.C.) karşı rağbet, niyaz, yalvarış, tazarru. * Salât, namaz. * Cenab-ı Hak'tan hayır ve rahmet dilemek. Allah'ın rızâsını, hidayet ve istikamete muvaffakiyyeti dilemek, yalvarmak. * Peygamber'e (A.S.M.) salavat getirmek. * Birisini çağırmak. * Birisini bir şeye sevketmek. * Bir kimseyi bir isimle tesmiye etmek. * Söz, kelâm. * Okumak.(... Duâ ubudiyyetin ruhudur ve hâlis bir imanın neticesidir. çünkü, duâ eden adam duâsı ile gösteriyor ki: Bütün kâinata hükmeden birisi var ki, en küçük işlerime ıttılaı var ve bilir; en uzak maksadlarımı yapabilir; benim her halimi görür, sesimi işitir. öyle ise, bütün mevcudatın bütün seslerini işitiyor ki benim sesimi de işitiyor, bütün o şeyleri O yapıyor ki en küçük işlerimi de Ondan bekliyorum, Ondan istiyorum...Duânın en güzel, en lâtif, en leziz, en hazır meyvesi, neticesi şudur ki: "Duâ eden adam bilir ki; birisi var ki, onun sesini dinler; derdine derman yetiştirir, ona merhamet eder; Onun kudret eli her şeye yetişir. Bu büyük dünya hanında o yalnız değil, bir Kerim Zât var; ona bakar, ünsiyet verir... M.)(Duâ-yı kavli-i ihtiyarinin makbuliyeti, iki cihetledir. Ya aynı matlubu ile makbul olur veyahud daha evlâsı verilir.Meselâ: Birisi kendine bir erkek evlâd ister. Cenâb-ı Hak, Hazret-i Meryem gibi bir kız evlâdını veriyor. "Duâsı kabul olunmadı" denilmez. "Daha evlâ bir surette kabul edildi" denilir. Hem bâzan kendi dünyasının saâdeti için duâ eder. Duâsı âhiret için kabul olunur. "Duâsı reddedildi." denilmez. Belki, "Daha enfa bir sûrette kabul edildi." denilir. Ve hâkezâ... Mâdem Cenâb-ı Hak Hakim'dir, biz ondan isteriz, o da bize cevap verir. Fakat hikmetine göre bizimle muamele der. Hasta tabibin hikmetini ittiham etmemeli. Hasta bal ister; tabib-i hâzık, sıtması için sulfato verir. "Tabib beni dinlemedi." denilmez. Belki âh ü fizârını dinledi, işitti, cevap da verdi; maksudun iyisini yerine getirdi. M.) (Mü'minin mü'mine en iyi duâsı nasıl olmalıdır?Elcevap : Esbâb-ı kabul dairesinde olmalı. çünkü, bâzı şerait dahilinde duâ makbul olur, şerait-i kabulün içtimaı nisbetinde makbuliyeti ziyadeleşir. Ezcümle: Duâ edileceği vakit, istiğfar ile mânevi temizlenmeli: sonra makbul bir duâ olan Salâvat-ı şerifeyi şefaatçı gibi zikretmeli ve âhirde yine Salâvat getirmeli. çünkü, iki makbul duânın ortasında bir duâ makbul olur. Hem $ yâni "Gıyaben ona duâ etmek"; hem hadiste ve Kur'an'da gelen me'sur duâlarla duâ etmek. Meselâ: $ $ gibi câmi duâlarla duâ etmek, hem hulus ve huşu ve huzur-u kalb ile duâ etmek; hem namazın sonunda, bilhassa sabah namazından sonra; hem mevâki-i mübârekede, hususan mescidlerde, hem cum'ada, hususan saat-i icabede, hem şuhur-u selâsede, hususan leyali-i meşhurede; hem Ramazan'da, hususan leyle-i Kadir'de duâ etmek kabule karin olması rahmet-i îlâhiye'den kaviyyen me'muldür. O makbul duânın ya aynen dünyada eseri görünür; veyahut duâ olunanın âhiretine ve hayat-ı ebediyesi cihetinde makbul olur. Demek aynı maksad yerine gelmezse, duâ kabul olmadı denilmez; belki daha iyi bir surette kabul edilmiş denilir. M.)(Dördüncü nevi ki; en meşhurudur...Bizim duamızdır. Bu da iki kısımdır: Biri, fiili ve hâli; diğeri, kalbi ve kalidir. Meselâ: Esbaba teşebbüs, bir dua-yı fiilidir. Esbabın içtimaı, müsebbebi icad etmek için değil, belki lisan-ı hâl ile müsebbebi Cenab-ı Hak'tan istemek için bir vaziyet-i marziye almaktır. Hattâ çift sürmek hazine-i rahmet kapısını çalmaktır. Bu nevi dua-yı fiili, Cevad-ı Mutlak'ın isim ve ünvanına müteveccih olduğundan, kabule mazhariyeti ekseriyet-i mutlakadır. îkinci kısım: lisan ile, kalb ile dua etmektir. Eli yetişmediği bir kısım metalibi istemektir. Bunun en mühim ciheti, en güzel gayesi, en tatlı meyvesi, şudur ki: "Dua eden adam anlar ki: Birisi var; onun hatırât-ı kalbini işitir, herşey'e eli yetişir, herbir arzusunu yerine getirebilir.. Aczine merhamet eder, fakrına medet eder."îşte ey âciz insan ve ey fakir beşer! Duâ gibi hazine-i rahmetin anahtarı ve tükenmez bir kuvvetin medarı olan bir vesileyi elden bırakma. Ona yapış âlâ-yı illiyyin-i insaniyete çık, bir sultan gibi bütün kâinatın dualarını, kendi duan içine al. Bir abd-i külli ve bir vekil-i umumi gibi $ de. Kâinatın güzel bir takvimi ol!... S.)
duâ-yi fîîlî š”ƒ£‚–”™ž: Fiil ile yapılan dua. Yâni: îstenilen şeyin sebeplerini yerine getirmeye çalışmak.
duâ-yi hayr š”ƒ£‚‰ÿœ: Hâyırlı dua, hayır isteyen dua.
duâ-yi kavlî š”ƒ£‚—ò™ž: Sözle yapılan dua ki bildiğimiz meşhur duâlardır.
duâ-yi müstecab š”ƒ£‚šž…‡ƒ„: Kabul olunan dua.
duâg š”ƒª: (Duâhân) f. Duâ okuyan. Duâ eden.
duat: (Dâi. C.) Duâ edenler. Allah'a yalvaranlar. * Dâvet edenler.
duban: Duman.
dubu': Yapışmak.
du'ce: Gözün büyük ve siyah olması.
ducret: Sıkıntı, gönül darlığı, zahmet. Zaruret.
ducret-ver: f. Sıkıntılı.
dçar š§ƒœ: f. Yakalanmış. çatmış. Mübtelâ. * Ulaşmış.
dud šš: f. Duman, sis. Tütün. * Elem, gam, keder, tasa.
dud šš: Kurt, böcek.
dud-alud: f. Dumanlı.
dd-hâne: f. Kabile, silsile, hânedan, soysop.
dud-î harîr: îpek böceği.
dude ššœ: f. Kavim, kabile, aşiret, ocak, aile. * îs'inden mürekkeb yapılan çıra.
dude ššœ: Kurtcağız, küçük solucan, böcek.
dudhar: f. Kelebek. * Aşçı, yemek pişiren kimse. * Külhancı.
dudman: f. Hanedân, sülâle, akarib, aile, kabile, kavim, aşiret.
dudu: Hanım, kadın, hatun.
dudu: (Tuti) Dudu kuşu, papağan.
dug: f. Ayran.
duga: Akılsız kadın.
duga': Kedi miyavlaması. * Tilki sesi. * Zelil, hakaret görmüş kimsenin sesi.
dugab: Tavşan sesi.
dugaga: Ahmak, akılsız kişi.
dugata: Eğri bir ağaç cinsi.
dugd: f. Gelin, yeni evlenmiş kız.
dugmeran: Kara, esved.
dugmus: (C.: Degâmis) Rengi siyaha yakın küçük bir su canavarı.
dugn: Karanlık, zulmet.
dugta: şiddet. * Meşakkat, zorluk.
duh š‰: f. Kız, kerime, duhter. * Havai fişek. * Hasır otu, hasır sazı.
duh š‰: f. çorak, otsuz ve çıplak arazi. * Tüysüz, çıplak yüz ve baş. Köse ve dazlak. * Yapraksız ve meyvasız ağaç. * Hasırotu.
duha ‘ˆÿ: Kuşluk vakti. * Güneş. * Vuzuh ve beyan. * Kur'ân-ı Kerim'in 93. Suresinin adı. Vedduhâ da denir.
duhala š‰™ƒ£: (Dahil. C.) Yabancılar. Muhacirler. Sığınanlar. Dahilde olanlar.
duhan š‰ƒ›: Duman. Tütün. * Kur'an-ı Kerim'in 44. suresinin adı. * Mc: Gaflet ve dalâlet dumanı ki, hakikatların görünmesine mâni olur. Arap lisanında galib olan şerre, duhan tesmiye ederler. * Kıtlık ve kuraklık.
duhan-i ateş š‰ƒ›ó‚¥…: Ateşin dumanı.
duhan-i mübîn š‰ƒ›ó‚š„ÿ›: Aşikâre duman. (Bu duhan hakkında iki tefsir rivayet olunmaktadır. Birisi: îbn-i Mesud Hazretlerinden mervi olduğuna göre; şiddetli açlık ve kaht seneleridir. çünkü çok aç olan kimseye, gerek gözlerinin za'fından ve gerek çok kuraklık ve kahtlık senelerinde havanın fenalığından, semâ dumanlı görünür. Bir de Arab, galib olan şerre, duhan tesmiye eder. Nitekim dumanlı hava tâbirini biz de kullanırız.) (E.T.)
duhas: Denizlerde çok olan büyük bir canavar. (Arkasıyla, boğulan kimselere yardım edip kurtarır, "dülfin" de derler.)
duhh: Tütün.
duhl: (C.: Dehâhil) Ufak kuşlar.
duhmesan: Kara yağız, iri yapılı adam. * Akılsız adam.
duhn: Darı.
duhne: Tohum tânesi, tek tâne. * Darı.
duhruce: (C.: Dehâric) Yellengen böceğinin yuvarladığı ters. * Deve kuşunun yavrusu.
duhseman: Kara yağız, iri vücutlu adam.
duht: f. Kız, kerime.
duht-ender: f. üvey kız. * Eskiden kadın esirlerinin bir cinsi.
duhte: f. Sağılmış. * îğne ile dikilmiş.
duhter š‰…œ: f. Kız.
duhter-î hîndî: Hindistanlı kız.
duhtere: f. Bekârlık, kızlık.
duhterî: f. Kızlık, bekârlık.
duhuk: Doğurduktan sonra rahmi çıkan dişi deve.
duhul š‰™: îçeri girme. îçeri dahil oluş.
duhul ü huruc: îçeri girip çıkma.
duhul-î muzafferâne: Muzafferce giriş.
duhulîye š‰™ÿœ: Eskiden, satılmak üzere şehir ve kasabalara getirilen her cins ticaret malından alınan vergi. * Bir yere girmek için verilen para.
duhur: Def'etme, çıkarma, kovma, uzaklaştırma.
duhur: Zillet, zelillik, hakirlik, aşağılık. Adilik.
duhus: Bâtıl olmak.
duhye: Kuşluk vakti kesilen kurban.
du'k: Zayıf adam.
duka: Eskiden Avrupa'ca pek yüksek bir asalet ünvanı idi.
dukak: (C.: Dekâyık) înce nesne. * Un. * Zor, güç.
dull: Helak.
dum (devâm): Sâbit ve sâkin olmak.
du'ma: Ulu yol.
dumr: Zayıflık. * Hafiflik.
dumu': (Dem'. C.) Göz yaşları.
dumur: Bir uzvun maddi veya mânevi kabiliyetinin körelmesi. Gıdasızlıktan dolayı bir uzvun kuruyup kalması. Helâk. Körelmek. * Bir yere izinsiz gitmek.
dumur ‘šœ: Büyüyüp gelişememek. Zayıflıktan, hayvanların karnının içeri çökmesi.
du'mus: (C.: Deâmis) Rengi siyaha benzer bir küçük su canavarı.
dumuz: Susma, sükut.
dn š›: Aşağı, alçak. Kolay. Zayıf. Gölgeli. Aşağılık. Altta, aşağıda.
dn š›: Gayrı, diğer, maadâ.
dun-hîmmet: Gayretsizlik, himmetsizlik. (Bak: Himmet.)
dn-perver: f. Kötü kimseleri koruyan, alçak kişileri muhafaza edip onların ilerlemelerine yardımcı olan.
dunak: Nezle.
dune: Hastalık.
dunehu hart-ül katat š›œ‚‰œ’‚ƒ™—…ƒ…: "Elini dikenli ağaç üzerine çekmek, ondan daha kolay." meâlinde bir tabirdir.
dur ü dîraz: Uzun uzadıya.
dur-baş: f. "Uzak ol!" anlamına gelen bir emir. * Değnek, sopa, âsa.
dur-bîn: f. Uzak gören. Uzağı gösteren âlet.
dur-bînî: f. îlerisini görürlük, uzağı görmeklik.
dur-dest: f. Ulaşılması zor şey, erişilmesi güç şey. Uzak, uzun.
dur-endîş šœ‚¤›šÿ: f. önceden görüp düşünen. Tedbirli. Her şeyin ilerisini evvelden mülâhaza eden. îlerisini düşünen.
dur-nüma(y): f. Uzağı gösteren.
dur-nüvîs: f. Uzağı yazan. Telgraf.
dura-dur: f. Uzaktan uzağa. Uzak uzak. Uzun uzadıya.
durah: Gökte melâike kâbesi olan beyt-il mâmur.
durat: Yellenme.
durbe: âdet, haslet. * Cür'et. * Tecrübe.
durc: îçine inci ve altın konulan küçük hokka.
dure: Hakir ve şânı küçük olan adam.
durî: f. Uzaklık.
durît: Kovmak, def etmek.
durr: Zayıflık. Hâli yaramaz olmak.
durre: (C.: Dür-Dürrât-Dürer) înci.
duru' šœ”: (Dır. C.) Savaşda giyilen zırhlar, cevşenler, çelik elbiseler.
duru' šœ£: Uzak, ırak, baid.
durub ‘œ„: (Darb. C.) Döğmeler, vurmalar, darblar.
durub-u emsal ‘œ„ó‚¤š†ƒ™: Meşhur sözler. Darb-ı meseller. Ata sözleri.
durus: Kuyu örülen taş.
dş š: f. Omuz. Ketif. * Dün gece. * âlem-i menâm, rüya âlemi. * Mütesadif ve mütelâki olan.
dş azmak: Rüyâda iken kirlenmek, ihtilâm olmak.
duşab: f. Hurma ve üzüm pekmezi. Pekmez.
duşîze: (C.: Duşizegân) f. Kız, bâkire. El değmemiş.
du'şuka: Bir böcek cinsidir ve sahrâlarda olur.
duud(e): Nezle olmak.
duva: Baykuş sesi.
duz: f. Dikici, diken, dikmiş.
duzah š‰: f. Cehennem. Tamu. * Mc: Keder. Külfet.
duzah-mekân: f. Makamı Cehennem olan kâfir, münâfık.
duzahî: f. Cehennem'e mahsus, cehennemi, zebani.
duzene: f. Sivrisinek, arı gibi haşeratın iğnesi.
dü-âlem: îki dünya. Dünya ve âhiret.
dü-bâlâ: f. îki kat.
dü-cîhan š‚‡œƒ›: îki cihan. Dünya ve âhiret.
dü-dîde: f. îki göz.
dü-dîlî: f. Tereddüt, kararsızlık, neticeye varamamak.
dü-gane: f. îki adet, iki tane, ikiz. çift.
dü-gîtî: f. îki âlem. Dünya ve âhiret.
dü-muy: f. Saçına sakalına kır düşmüş adam.
dü-nîm(e): f. îki parça, ikiye yarılmış, bölünmüş ikiye ayrılmış.
dü-pa: îki ayaklı.
dü-ru: îki yüzlü.
dü-şah(î): f. çatal ağaç. * Tomruk. * Eskiden suçlunun boynuna takılan çatal ağaç.
dü-ta: îki kat.
dü-vazdeh: f. Oniki.
dü-vîst: f. îki yüz.
dü-vüm(în): f. îkinci, saniyen.
dü-zeban: f. îki dilli.
düabe: Lâtife etme, şaka yapmak. * Oyun.
dübar: çarşamba günü.
dübar(e): f. îki kat, çift kat, kat kat, katmerleşme.
dübb š„: Ayı.
dübb-ü asgar š„‚ƒ•œ: Küçük ayı denen ve Kutup yıldızı etrafında devreden yedi tanelik yıldız kümesi.
dübb-ü ekber š„‚ƒ˜„œ: Büyük ayı tâbir edilen, kutup yıldızı ile beraber etrafındaki yedi yıldız.
dübba': Kabak.
dübbe: Yol, tarik.
dübeyt: f. îki beyitten müteşekkil rübainin diğer ismi.
düble: Beyaz helva parçası. * Büyük lokma.
dübr: (Dübür) Kıç, mak'ad, süfre. * Bir işin nihayeti, sonu. * Bir şeyin arkası, gerisi.
dübse: Siyaha benzeyen kırmızılık.
dübsîyy: Kumruya benzer bir kuş.
dü'bub: Zayıf nesne. * çirkin huylu, kısa boylu kimse. * Kolay yol. * Uzun at. * Karınca nevinden bir nev. * Hububattan bir cins.
dübul: Su arkı.
dü'bus: Ahmak.
düca: Zulmet, karanlık.
dücac: Galebe ile çağrışmak. * înlemek. * Aldatmak, kandırmak.
dücace š‡ƒ‡œ: (Bak: Decace)
dücale: Katran.
dücce: Fazla karanlık, ziyade zulmet.
dücce-î lücce: Denizin engin karanlığı.
dücî: (Dücye. C.) Karanlıklar, zulümat.
dücme: Karanlık, zulmet.
dücne: (C.: Dücen-Dücenât) Kapalı hava, karanlık.
dücun: Bulutun göğü bürüyüp örtmesi.
dücüc: (Decâc. C.) Tavuklar. Tavuk, horoz ve piliç cinsleri.
dücünne: (C.: Dücünnât) Bulut kat kat olma. * Karanlık, zulmet. * Yağmur yağma.
dücye: (C.: Dücâ) Bal arısının kovanı. * Avcılar kümesi. * Zulmet, karanlık.
düden: Coğ: Yerin altında akan suların oyup meydana getirdiği derin kuyu.
düello š¤™™: îtl. Hakareti tamir için iki kişi arasında hususan Avrupa'da ve şâhitler önünde yapılan silâhlı çarpışma.
düf: (C.: Düfuf) Def.
düf'a: (C.: Difâ) çok çabuk akan su.
düfak: Bir şeyin dolu olması.
düffa': Büyük sel.
düfn: Gömülmüş kuyu.
düfuk: Atılmak. * Dökülmek.
dühat šœƒ…: Akıllılar. Akılda çok ileri olanlar. Dehâ sâhibi. Son derece anlayışlı ve zekâ sahibi olanlar.
dühdün: Bâtıl nesne.
dühdür: Bâtıl nesne.
dühme: Siyahlık, karalık.
dühn šœ›: Ot, yemiş veya çiçekten çıkarılan yağ.
dührîyy: Yaşlı, ihtiyar, müsinn.
dühr šœœ: Devirler, zamanlar. Dünyalar.
dühül: f. Davul.
düka': Deve öksürüğü.
dükas: Uyuklamak.
dükne: Siyâha benzer bir renk.
dülake: Davar emziğinde kalan süt bakiyesi.
dülbe: (C.: Düleb) çınar ağacı.
dülbent: f. Tülbent.
dülce: (Delce) Gece vakti bir yere gitmek.
düldül š™š™: Fahr-i Kâinat (A.S.M.) Efendimize mahsus bir katır ki, sonradan Hz. Ali (R.A.) Efendimize bahş buyurulmuştur.
dülfîn: Denize düşenlere yardım edip, onları kurtaran bir balık.
dülke: Küçük bir canavar.
dülu': Huruç etmek, çıkmak.
düluk š™˜: Batma, güneş batması.
düluk-uş şems š™˜‚ƒ™šž: Güneşin batışı.
dü'lul: (C.: Dâlil) Belâ, zahmet, dâhiye.
düm: f. Kuyruk.
düm-bürîde: f. Kuyruğu kesik.
düm-çe: f. Kısa kuyruk, kuyrukçuk.
düma ššÿ: (Dümye. C.) Suretler. Küçük putçuklar.
düma': Hastalık veya ihtiyarlık sebebiyle gözden akan yaş. * Bahar günlerinde üzüm çubuğundan akan su.
dümac: çok sağlam nesne. * Gizli örtülü olan şey.
düman: Yemişin çürüklü olması. * Ekine su düşüp, kesilmek.
dümasîr: (Demser) înişi yumuşak olan yer. * Etli, büyük deve.
dümdar šššƒœ: f. Askerlikte arttaki emniyeti te'minle vazifeli, geriden gelen ve askeri tâkib eden birlik. Ordunun geriden emniyet kuvveti. * Mc: Son zamanlarda gelen büyük evliyâullah.
dümel (dümmel): Tıb: Büyük kan çıbanı.
dümluk: Yassı, yuvarlak taş.
dümlus: Berrak, yumuşak nesne.
dümlüc: Doğan kuşu. * Kan alacak yer.
dümme: Arap oyunlarından bir oyun ismi. * Yol, tarik.
dümu' šš”: (Dem'. C.) Gözyaşları.
dümuk: Ansızın duhul etmek, birdenbire girmek.
dümur: Destursuz olarak eve girmek.
dümus: Geceleyin çok karanlık olmak.
dümye: (C.: Dümâ) Oyun. * Ağaçtan yapılmış nakışlı suret. Sanem.
dünbal(e): f. Kuyruk.
dünb(e): f. Kuyruk.
dünbek: f. Bekçi davulu. * Dümbelek.
dünu': Horluk, hakirlik.
dünüvv š›: Ulaşmak, yakın olmak.
dünya š›ÿƒ: (Müz: Ednâ) (Denâet veya dünüvv. den) En yakın, en aşağı. * şimdiki âlemimiz. (Ahirete veya ölüme en yakın olmasından bu isim verilmiştir.) (Dünyâ, âhiretin tarlasıdır. Bir kitab-ı Samedanidir. Hem bir mezraadır. Hem birbiri arkasında dâim gelen geçen âyineler mecmuasıdır. Hem seyyar bir ticaretgâhtır. Hem muvakkat bir seyrangâhtır. Hem bir misafirhânedir.)(Ehl-i dalâletin vekili der ki, ehadisinizde dünya tel'in edilmiş. "Cife" ismiyle yâdedilmiş. Hem bütün ehl-i velâyet ve ehl-i hakikat, dünyayı tahkir ediyorlar. "Fenadır, pistir" diyorlar. Halbuki: Sen bütün kemalât-ı îlâhiyyeye medar ve hüccet, onu gösteriyorsun ve âşıkane ondan bahsediyorsun?Elcevap : Dünyanın üç yüzü var: Birinci Yüzü : Cenab-ı Hakk'ın esmâsına bakar. Onların nukuşunu gösterir. Mâna-yı harfiyle, onlara ayinedarlık eder. Dünyanın şu yüzü, hadsiz mektubât-ı Samedaniyyedir. Bu yüzü gayet güzeldir. Nefrete değil, aşka lâyıktır.îkinci yüzü : âhirete bakar. âhiretin tarlasıdır. Cennet'in mezraasıdır. Rahmetin mezheresidir. şu yüzü dahi, evvelki yüzü gibi güzeldir. Tahkire değil, muhabbete lâyıktır.üçüncü yüzü: însanın hevesatına bakan ve gaflet perdesi olan ve ehl-i dünyanın mel'abe-i hevesâtı olan yüzdür. şu yüz çirkindir. çünkü: Fânidir; zâildir, elemlidir, aldatır. îşte hadiste varid olan tahkir ve ehl-i hakikatın ettiği nefret bu yüzdedir.Kur'ân-ı Hakim'in kâinattan ve mevcudattan ehemmiyetkârane, istihsankârane bahsi ise; evvelki iki yüze bakar. Sahabelerin ve sair ehlullahın mergub dünyaları, evvelki iki yüzdedir. şimdi dünyayı tahkir edenler dört sınıftır:Birincisi : Ehl-i mârifettir ki, Cenab-ı Hakk'ın mârifetine ve muhabbet ve ibadetine sed çektiği için tahkir eder.îkincisi : Ehl-i âhirettir ki ya dünyanın zaruri işleri onları amel-i uhreviden men'ettiği için veyahut şuhud derecesinde imân ile Cennetin kemalât ve mehâsinine nisbeten dünyayı çirkin görür. Evet Hazret-i Yusuf Aleyhisselâm'a güzel bir adam nisbet edilse yine çirkin göründüğü gibi; dünyanın ne kadar kıymetdar mehâsini varsa, Cennetin mehâsinine nisbet edilse, hiç hükmündedir.üçüncüsü : Dünyayı tahkir eder. çünkü; eline geçmez. şu tahkir, dünyanın nefretinden gelmiyor; muhabbetinden ileri geliyor.Dördüncüsü : Dünyayı tahkir eder. Zira dünya, eline geçiyor. Fakat durmuyor gidiyor. O da kızıyor. Teselli bulmak için tahkir eder. "Pistir" der. şu tahkir ise; o da, dünyanın muhabbetinden ileri geliyor. Halbuki, makbul tahkir odur ki; hubb-u âhiretten ve mârifetullah'ın muhabbetinden ileri gelir.Demek makbul tahkir, evvelki iki kısımdır. Cenab-ı Hak, bizi onlardan yapsın. âmin. S.) (Bak: Alessevri velhut)
dünyadâr: f. Dünya işleriyle uğraşan, mal ve mülk sahibi olan. Dünya hayatına fazla meyilli olan.
dünyalik: t. Zenginlik, para ve mal.
dünyaperest š›ÿƒ¨œž…: f. Dünyaya tapacak derecede ehemmiyet verip âhiretini düşünmeyen. Maddiyatı çok seven.
dünyevî š›ÿž: (Dünyeviye) Bu âleme mensub ve müteallik. Dünyaya âit ve dünya ile alâkalı.
dür šœ: (Bak: Dürr)
dür-dane: f. înci tanesi. * Mc: çok güzel ve sevimli çocuk.
dürahîs: Katı nesne. * Gövdesi etli olan insan veya hayvan.
düramîh: Yürürken sallanan kişi.
dürb šœ„: (Bak: Derb)
dürbe: âdet. Haslet. * Cür'et ve mümareset. Tecrübe.
dürbîn: Uzaktan gören, dürbün.
dürc-î zer: Altın kutusu.
dürc(e): Kutu, kutucuk, küçük kutu. * Mücevherat kutusu. * Hokka gibi olan ağız, biçimli ağız.
dürdakis: Başla boyun arasında olan kemik.
dürd(e): f. Tortu, çöküntü, posa, işe yaramayan kısım.
dürdî: f. çöküntü, tortu.
dürdür: Dişin kök yeri. * çocukların dişlerinin çıkıp bittiği yer.
dürece: Süllem, merdiven. * Bağırtlak kuşu. (Kanatlarının içi siyah ve dışı boz olan bir kuş.)
dürer šœœ: (Dürr. C.) f. Büyük inciler.
dürer-bâr šœœ‚„ƒœ: înciler yağdıran. * Mc: çok kıymetli ve güzel sözler söyleyen.
dürer-î semavî šôœòœó‚žšƒž: Aslı vahiy ile gelen, parlak hakikatlı mânalar. Semâvi inciler.
dürhamîn: Belâ. Zahmet, meşakkat.
dürnuk: (C.: Derânik) Bir cins döşek.
dürr šœ: (Dürdâne, dürre) f. înci. înci tanesi.
dürr-dane: (Bak: Dürdâne)
dürr-efşan: f. înci serpen. Söylediği sözler inci olan ağız.
dürr-î cân šœ‚‡ƒ›: f. Canın incisi. çok sevgili.
dürr-î dirahşân šœšœ‰ƒ›: Parlak inci.
dürr-î meknun šœõó‚š˜››: Mahfazalı parlak inci.
dürr-î mîsâl šœ‚š†ƒ™: f. Misâlin incisi. înci misâlinde, misâlin parlağı.
dürr-î nâb: Beyaz, parlak inci.
dürr-î şîrab: îri, büyükçe inci.
dürr-î yegâne šœõó‚ÿªƒ›œ: Eşi ve benzeri bulunmayan tek inci.
dürr-î yekta šœ‚ÿ˜…ƒ: f. Benzeri olmayan, tek inci. * Mc: Hz. Peygamber (A.S.M.)
dürr-î yetîm šœ‚ÿ…ÿš: f. Sadef içinde tek olan inci. * Mc: Hz. Peygamber Muhammed (A.S.M.)
dürrace: (C.: Derrâc) Türac denilen kuş.
dürrae: (C.: Derâri) Ferâce, kaftan, elbise.
dürrat: (Dürre. C.) Büyük, iri inci taneleri.
dürre-î beyzâ šœœ£‚„ÿ‘ƒ£: f. Parlak, büyük inci.
dürrî: Dürr'e mensub, inci ile ilgili.
dürşe: Hâcet, ihtiyaç.
düru': (Dır'. C.) Zırh gömlekler.
düruc: Dürmek. * Geçmek. * Koymak.
dürud: f. Dua, medih, tahiyye, selâm. * Ekin biçme. * Yontmuş ağaç, kereste.
dürug: f. Yalan, Doğru olmayan söz.
dürug-zen: f. Yalancı.
dürur: înmek. * Akmak, seyelân.
dürus šœž: (Ders. C.) Dersler. * Müfret olarak: Bir şeyin eseri mahv ve müzmahil olmak.
dürus-î nâfîa: Faydalı olan dersler.
dürüst šœž…: f. Sıhhati yerinde, sağ, sahih, salim. * Doğru, hatasız. * Bütün, tam.
dürüstî: f. Doğruluk, düzgünlük, sağlamlık.
dürüşt: f. Katı, kalın, yağun. * Kaba, sert.
dürüştî: f. Kabalık, sertlik, katılık, kalınlık, yoğunluk.
dürye: Bilmek.
dürzî: (C.: Düruz) Suriye'nin güneyi ile ürdün ve îsrâil'de yaşayan ve sonradan Araplaşmış olan bir kavimdir. Arapça konuşurlar. Dalâlet fırkalarından en bâtıl yolda olan bir fırkadır.
düsme: Toz bulaşmış olan nesne. * Adi, alçak kimse.
düsse: Başa soğuk geçmek.
düsse: Arap çocukları arasında meşhur olan bir oyun.
düstur šž…œ: f. Umumi kaide. Kanun, nizam. * örnek, nümune * üslub. îzin, müsaade. * Mu'teber ve mu'temed kimse. * Destur.
düsum: (Desem. C.) Yağlar.
dü'sur: (C.: Deâsir) Yıkılmış havuz.
düsur: Mahvolma. Eseri kalmama. Ortadan kalkma. Nişanı belirsiz olma. * Kaftan eskime. * Ev köhne olma.
düsür: (Disar. C.) Perçinler, halatlar, kenetler. Geminin tahtalarını birbirine bağlayan rabıtalar.
düsür š†œ: (Disar. C.) üste giyilen kaftanlar, elbiseler. * Yatak çarşafları.
düş š: f. (Bak: Dûş)
düşab šƒ„: f. Pekmez.
düşenbîh: f. Haftanın ikinci günü, pazartesi.
düşeş š‚: f. îki altılık. Tavla zarında iki defa altı gelmesi.
düşîn(e): f. Dün gece.
düşnam: f. Sövme, sövüp sayma, ta'n.
düşvar šƒœ: f. Müşkil. Güç. Zor.
düşvar-ger: f. Dağ.
düşvarî: f. Zorluk, güçlük, suubet.
düvab: îşi birbirine ulaştırmak.
düval: f. Tasma, kayış.
düvam: Sabit ve sakin olmak.
düvar: Baş çevrilme.
düvel š™: (Devlet. C.) Devletler.
düvel-î muazzama š™‚š”“šœ: f. Büyük devletler. Düvel-i muazzama-i îslâmiyye gibi.
düvel-î mü'telîfe: Anlaşmış devletler. Birinci Cihan Harbinde: îngiltere, Fransa, Rusya ve îtalya.
düvel-î müttefîka š™‚š…–—œ: f. îttifak etmiş, birlik olmuş, birleşmiş devletler.
düvelî: (Düveliyye) Devletlerle alâkalı.
düvuk: Ahmaklık, hamâkat.
düvvac: Hâkimlerin giydiği bol kaftan. * Yorgan. * Tac.
düvvame: çocukların çevirerek oynadığı bir fırıldak.
düyun šÿ›: (Deyn. C.) Borçlar.
düyunat: (Düyun. C.) Borçlar.
düzd: (C.: Düzdân) f. Sârık, hırsız.
düzdan: (Düzd. C.) f. Hırsızlar, sürrak.
düzdâne: f. Hırsız gibi, hırsıza yakışır şekilde, hırsızca.
düzdî: f. Hırsızlık, sirkat.
düzeç: (Uydurma bir kelimedir.) (Bak: Tesviye âleti)
düzenbaz: Hile yapan, aldatıcı.
düzîne: On iki parçadan ibaret takım.
düzlem: (Uydurma bir kelimedir.) (Bak: Müstevi)
düztaban: t. Tıb: Ayak tabanı düz olan kimse. Böyle kişiler çabuk yorulurlar ve hızlı yürüyemezler.