gabane: Kişinin fikir ve tedbirinin zayıf ve eksik olması.
gabarî: Fr. Kara nakil vasıtalarındaki yükün yükseklik ölçüsü.
gabavet •„ƒ…: Ahmaklık, anlayışsızlık, bönlük, kalın kafalılık. (Fıtnetin zıddı)
gabavet-î mücesseme: Büyük ahmaklık.
gabb: Sıtmanın gün aşırı tutması.
gabe: Sık ormanlar, balta girmemiş koru ormanı.
gaben: Rey ve tedbirin zayıf ve eksik olması.
gaber: Büyük meşakkat.
gabere: Ağaçlık yer. * Bir şey üzerine çökmüş toz.
gabes: Karanlık gece. * Biraz bulanık renkte olan beyazlık.
gabeş: (C.: Agbâş) Gecenin sonu.
gabgab: (C.: Gebâgıb) çifte gerdan çene altı. şakak.
gabî •ƒ„ÿ: Ahmaklık eden, budalalık eden.
gabî •„ÿ: Anlayışsız, ahmak, bön.
gabîbe: Sabah sağılan koyun sütünün üzerine akşam yine sağıp, ertesi güne bekletilip ekşiyen süt.
gabîn •ƒ„›: Aldatıcı, hilekâr, alışverişte hile eden.
gabîr: îstikbal. * Gr: Gelecek zaman. * Kalan.
gabîse: Keş ile karıştırılmış yağ.
gabît: (C: Gubut) çukur yer. * Bir dere ismi. * üstüne mıhfe bağlanan çok kuvvetli hayvan.
gabîyy: Zekâsı az olan. Geri zekâlı.
gabn •„›: Alışverişte hile ile çok kazanmak. Haram olan alışveriş.
gabn: Aldatmak. Hud'a. * Noksan etmek, noksanlaştırmak.
gabn-i fâhîş: Bir alışverişde veyahut ticari anlaşmada taraflardan birisinin nisbetsiz şekilde fazla aldanması.
gabr: Bâki olmak, ebedi olmak. * Memede kalan süt bakiyyesi.
gabra •„œƒ£: Yeryüzü, toprak, arz. * Nebat envâından bir nev'i. * Kuraklık, kıtlık. * çok tuzlu. * Toprak rengi.
gabs: Karıştırmak.
gabt: "Koyun semiz mi" diye el ile yoklamak.
gabta: (Bak: Gıbta) 
gabye: Büyük taneli olan şiddetli yağan yağmur.
gad •š‚ó‚•šƒ: (Gadâ, gaden) Yarın, ertesi.
gad •ƒš: Gelen, gelici.
gada •‘ƒ£: (Gazâ) (Gadat. C.) Dağ armudu ağaçları. Dikenli ağaçlar. * Ateşi uzun müddet devam eden seksek ağacı.
gada: öğle yemeği. (Bak: Gıda)
gadab •‘„: (Bak: Gazab)
gadaîr: (Gadire. C.) Saç örgüleri.
gadak: çok fazla, bol, kesir.
gadarîf: (Gudruf. C.) Kıkırdak kemikleri, kıkırdaklar.
gadat •šƒ : Sabahın erken zamanı. Sabah vakti.
gaddar •šƒœ: Kahredici, öldürücü. Ahdine vefâ etmeyip hıyânet eden. Hâin, zâlim, çok zulmeden.
gaddarane •šƒœƒ›œ: f. Acımadan, merhametsizcesine, zulmedercesine.
gaddare: Arapların cenbiyesine benzer pala nev'inden bir silâh.
gade: Bedeni yumuşak olan kadın.
gaden •šƒø: Yarın, yarınki gün.
gadîr •šÿœ: Durgun su, gölcük, sel suyu birikintisi.
gadîr •ƒšœ: (A, uzun okunur) Gadreden, fenalık eden, zulmeden, hıyanet eden.
gadîr-î nefs: Nefse fenalık eden.
gadîre: (C: Gadâir) Saç örgüsü. * çulha çukuru.
gadîrî: (Gadiriyye) Gölde yaşayan hayvan veya bitki.
gadîyye: (C.: Gadiyyât) Tan ağarmasıyla güneş doğması arası, sabahın erken saatleri.
gadn: Sarkık ve sülpük olmak.
gadr •šœ: Hâinlik, vefâsızlık, merhametsizlik. Muâmelede aldatmak.
gadr-i mutlak •šœ‚š’™—: Mutlak gadr, zulüm.
gadrdîde: f. Gadir görmüş, kendisine haksızlık edilmiş olan.
gadve: Sabahtan öğle vaktine kadar yürümek.
gaf •ƒ–: Fr. Beceriksizce ve yersiz söz yahut davranış.
gaf •ƒ–: Ağaç cinslerinden bir nevi.
gafa: Her şeyin kemi ve yaramazı. * Toza benzer bir âfet. (Hurma koruğunun üstüne gelip olgunluktan men'eder ve lezzetini bozar.)
gafak: Yağmurun yavaş yavaş yağması.
gafer (gufâr): Kadının baldırında, alnında veya başka yerinde olan kıl.
gaffar •–ƒœ: (Gufran. dan) Günahları örten, günahları bağışlayıcı. Mağfireti çok. * Kullarının günahlarını afveden Cenâb-ı Hak (C.C.)
gaffar-üz-zünub •–ƒœ‚ƒ™‹›„: Günahları örten, affeden Allah (C.C.)
gafî: Her şeyin kemi, yaramazı, kötüsü.
gafîl •ƒ–™: Dikkatsiz, iyi düşünmeyen, uyanık olmayan. Haberi olmayan, ihtiyatsız, başına geleceği önceden düşünmeyen. Allah'ı unutan. Kendi gayr-ı meşru zevkine dalan. (Günde bir taşı binâ-yı ömrümün düştü yere,Can yatar gafil, binası oldu viran bihaber. (Niyazi-i Mısri)
gafîlâne •ƒ–™ƒ›œ: f. Körü körüne, ihtiyatsızca, dalgınlıkla. Gafilcesine.
gafîlen: Habersizce, gafil olarak.
gafîr •–ÿœ: çok fazla, sayısız, kalabalık. * örten, etrafını çeviren. * Umumi. * Boyun, boğaz ve kafada olan tüyler.
gafîr •ƒ–œ: Mağfiret eden, kusurları örten, afveden Allah (C.C.)
gafîr-üz zenb •ƒ–œ‚ƒ™‹›„: f. Günahları örtüp afveden, suçları bağışlayan Cenab-ı Hak (C.C.)
gafîs: Kara ağaç.
gafk: Hücum etmek, vurmak. * Birbiri ardınca cima etmek.
gaflet •–™ : Dikkatsizlik, endişesizlik, vurdumduymazlık. En mühim vazifeyi düşünmeyip, Cenab-ı Hakk'a itaat gibi işleri bilmeyip, başka kıymetsiz şeylerle uğraşmak. Nefsine ve hevesâtına tâbi olarak Allahı ve emirlerini unutmak.
gafleten: Dalgınlıkla, gaflet eseri olarak.
gafr: örtmek, setr etmek. * Menazil-i kamerden üç küçük yıldız.
gaful (gafle): Aldanmak. * Terk etmek. * Belirsiz ve idraksiz olmak.
gafur •–œ: (Gaffar ile aynı mânadadır.) çok mağfiret ve merhamet eden, suçları en çok afveden. Cenab-ı Hak (C.C.)
gafur-ur rahîm •–œ‚ƒ™œˆÿš: Kusurları örten, adâletle en ziyade merhamet eden Cenab-ı Hak (C.C.). Mü'minlerin kusurlarını affederek muhafaza eden.
gafve: Azıcık uyumak.
gâh ªƒœ: (Geh) f. Yer. (Yer ve zaman bildiren "ek" dir.)
gâh bâ-gâh ªƒœ‚„ƒ‚ªƒœ: f. Zaman zaman.
gâh bâşed gâh nebâşed: Bazı olur, bazı da olmaz.
gâh ü bî-gâh: Sıralı sırasız, vakitli vakitsiz.
gâh ü na-gâh: Vakitli vakitsiz, zamanlı zamansız.
gaheb: Gaflet.
gâhî ªƒœÿ: (Gehi) Arasıra, zaman zaman.
gahvare: f. Beşik.
gaîb •ƒ¡„: Göz önünde bulunmayan, hazırda olmayan. Kaybolmuş olan. Görünmeyen âlem. * Gr: üçüncü şahıs, hazırda olmayan kimse.
gaîbâne •ƒ¡„ƒ›œ: f. Hazırda görünmeksizin, yüzyüze olmadan. Gizliden.
gaîle •ƒ¡™œ: Dert, sıkıntı, baş belâsı. Tasa, zor iş. * Düşünce.
gaîle-î zâîle: Sona eren sıkıntı, ardı kesilen elem.
gaîr: Gayret. * însan topluluğu. 
gaît •ƒ¡’: Necaset, neces, insan pisliği. * çukur yer. Düz ve geniş yer.
gaîyye •ƒ¡ÿœ: Bir şeyin sebeb ve neticesini ileri süren felsefe mesleği. * Maksad ve gayeye âit. Son ile alâkalı. Gaye, maksad ve neticeye mensup ve müteallik. (Fr.: Finalizm)
gaîz •ƒ¡“: Kızgın, öfkeli, gayzlı.
gaîza •ƒ¡‘œ: Yere batan sular, eksilen su. * Bir malın değerinin eksilmesi, azalması.
gak: Karga sesi.
gakfeka: Doğan sesi.
gal ªƒ™: (Gâle) f. Uzak, baid, ırak.
gal •ƒ™: (C: Gılâl) Ağaçlı çukur yer. * Muz ağacı. * Selem ağacının bittiği yer. * Bir ot cinsi.
gala •™ƒ£: Yüksek kıymet, pahalılık. * Bir şeyin haddini aşması.
gala (galeyân): Kaynamak.
galak: (C: Ağlak) Kapı kilidi.
galaka: Deri dibâgat ağacı.
galal •™ƒ™: (Gılâl) (Galle. C.) Zahireler. Mahsuller. * Akarât kiraları.
galan: çok susayan, çok susamış olan.
galat •™ƒ’: Hata. Yanlış. * Kaideye uymaz söz.
galat-g: f. Yalan yanlış söyleyen.
galat-i basar: Görme duyusunun yanılması. (Meselâ: Su içine batırılmış olan bir çubuğun, kırılmış gibi görünmesi.)
galat-i meşhur: Yanlış olduğu hâlde herkes tarafından kullanılan kelime veya terkib.
galat-i rü'yet: Renk körlüğü. Bir rengi, aslından başka renkte görme. *Görme bozukluğu.
galat-i tahakkümî: Bir kelimenin gerek lâfzı ve gerekse mânası itibariyle herkesin kullandığı gibi kullanılmaması.Bu, başlıca üş şeyden olur:1- Nazımda vezne uydurmak için bir kelimenin telâffuzunu değiştirmek, hecesini uzatmak ve kısaltmak yahut harfini gizlemek.2- çeşitli mânâları olan bir kelimeyi meşhur olmayan bir mânâda kullanmak.3- Gramere ait kaide hatası yapmak. Meselâ: Zen merde, civân pire, keman tirine muhtaçEczâ-yı cihân cümle biri birine muhtaçbeytindeki "bir" kelimesinin hecesi uzatılarak galat-ı tahakkümi yapılmıştır.
galat-nüvîs: f. Yalan yanlış yazan, yanlış tesbit eden.
galatat •™’ƒ…: Galatlar, hatalar, yanlışlar.
galba •™„ƒ£: Ağaçları gür ve sık olan koruluk, bahçe. * Pek yüksek ve büyük tepe.
galc: Azgınlık. * Su içtikten sonra dil ile yalanmak. * Atın yelmeyip bir tarzda yürümesi.
galeb •™„: (Galb) üstünlük. Yeğinlik.
galebe •™„œ: üstün gelmek. Yenmek. Bozmak. çokluk. * Bastırmak. * Yeğin olmak. 
galebe çalmak: Galib olmak, üstün gelmek.
galel •™™: (C.: Eğlâl) Koruluktan akan su. * Susuzluk.
galerî •ƒ™œ‚œÿ: Fr. San'at eserinin sergilendiği salon veya koridor. * Tiyatroda seyircilere ait balkon. * üstü örtülü uzun yer. * Yer altında açılmış uzun, dar yol.
gales: Gecenin sonunda olan karanlık.
galet: Hesapta yanılmak.
galeyan •™ÿƒ›: Kaynayış. çoşup taşmak. Yerinde duramamak. * Tuğyan ve azgınlık.
galeyan-i efkâr: Fikirlerin galeyanı. Fikirlerin coşması. 
galeyan-i mâ': Suyun kaynaması.
galfak: Geniş, vâsi. * Yumuşak. * Su içinde yetişen yassı yapraklı bir ot. * Kurbağa yosunu.
galgale: Sür'atle gitmek. * Gecenin gitmesi. * Haber vermek.
galî •ƒ™ÿ: Pahalı. Kıymetli. Ağır. * Haddini tecâvüz eden, haddini aşan.
galîb •ƒ™„: üstün. Yenen. Mağlub eden. Ekser.
galîb-î mutlak: Tam olarak galip. Kayıtsız şartsız hâkimiyet sahibi.
galîba •ƒ™„ƒ: Tahminen. çok zaman. Her halde. Galiben, ekseriyetle.
galîbane: f. Muzaffer ve galib olana yakışacak şekil ve surette.
galîben •ƒ™„øƒ: Ekseriya. çok zaman. üstün olarak. Tahmin olduğu üzere.
galîbîyyet •ƒ™„ÿ : üstünlük. Yenmek. Mağlub etmek.
galîf: Gön ve deri dibâgat etmekte kullanılan bir ot.
galîl: (C: Gılâl) Güneşin harareti. * Susuzluk harareti. * Kin, hased. * Devenin yulafına karıştırıp yedirdikleri hurma çekirdeği.
galîs: Arpa ve buğday karışımından yapılan ekmek.
galîs (gals): Kenger otu.
galîye •ƒ™ÿœ: Galeyan eden. * Değerinden çok pahalı. * Misk ve amberden yapılmış meşhur koku. * Hoş kokulu kıymetli madde.
galîye-bâr: f. Güzel kokulu şey saçan.
galîye-dân: f. Güzel kokulu şeylerin muhafaza edildiği kap, mahfaza.
galîye-gun: f. Güzel siyah renkli.
galîyun: çoban mayası.
galîz(e) •™ÿ“: çirkin. * Terbiye dışı. * Yoğun. Kaba. * Kokmuş madde.
galk: Kapıyı kapamak, kapıyı kilitlemek.
gall •™: Girmek, sokmak, akmak. * Boynunu, elini zincir ile bağlamak. * Hâinlik yapmak. Hıyanet etmek. * Ganimet malından hırsızlık etmek.
gallat: (Galle. C.) Mahsuller, zahireler. * El emekleri, çalışmanın semereleri. * Ev kirası gelirleri.
galle •™œ: Mahsul geliri. Ekin, irat, gelir. * Akarât kirası. * Hammaliye kirası. * Susamak.
galle-dan: f. Tahıl anbarı, zahire deposu.
galle-füruş: f. Zahireci, zahire ve hububat satan.
galle-î vakf: Vakfın faide ve mahsulü. Bununla vakfın tabii ve hukuki semereleri anlaşılır. Vakıf paraların ticareti ve vakıf akarların kirası, vakıf bahçelerin sebze ve meyveleri bu kabildendir.
gals: Karıştırmak. * Lâzım olmak. * Cür'et etmek.
galsame: Solungaç. Suda yaşıyan hayvanların nefes alma organları. * Gırtlak ağzı, hançere. * Boğaz deliğinin başlangıcı.
galtan: f. Yuvarlanan, tekerlenen.
galtîde: f. Tekerlenmiş, yuvarlanmış.
galuta: (C: Gulutât) Kişiyi zora düşüren meseleler.
galva': Yiğitliğin başlangıcı. * Gençlik sür'ati.
galve: (C: Galevât) Bir okatımı miktarı yer.
galyot: Baş ve arka tarafları birbirinin aynı olan eski cins bir gemi.
gam •š: (Bak: Gamm)
gam ªƒš: f. Köy, karye. * Hatve, adım. * Ayak, kadem.
gam-gîn: Gamlı, kederli.
gama: örtmek, setretmek.
gama' (gimâ): Ev örtüsü, çatı.
gamaîm: (Gımâme. C.) Hayvanların, yem yemelerini veya ısırmalarını önlemek gayesiyle ağızlarına takılan torba gibi şeyler.
gamak: Rutubet, ıslaklık. Rutubetli hava.
gamam(e) •šƒšœ: Bulut. Beyaz bulut. * örtmek.
gamare: Bönlük, ahmaklık, bilmezlik.
gamas: Göz pınarından akan irin ve çapak.
gamaza (gumuza): çukur, çukurluk. * Sözün anlaşılmasını zorlaştırmak.
gamc: Suyu sora sora içmek. * Deve yavrusunun anasının karnı ve ayaklarının altına gelmesi.
gamce (gumce): Kabın dibinde kalan su.
gamd: Zarf, mahfaza. Kın.
gamem: Saçın, alnı ve başı örtmesi.
gamet: Cinsiyet hücresi.
gamez: Malın ve davarın kemi ve küçüğü.
gamgama •š•šœ: Haykırma. Muharebe edenlerin bağırtısı. * Kalb dinlendiğinde işitilen ses. * Sözü, belirsiz söylemek. * Kalbin bulunduğu yer.
gamiz: Anlaşılmaz, anlaşılması güç. * Kapalı ve karışık söz. * çukur yer. * Zayıf kişi.
gamiza •ƒš‘œ: Kolay anlaşılmayan ince mes'ele. Derin. * Mâruf ve mütebeyyin olmayan hesab.
gamîc: Huy ve tabiatı doğru ve istikametli olmayan.
gamîde: Yemen'de bir kabilenin adı.
gamîl: Tüyü gitmiş yumuşak deri.
gamîm: Yoğurt yapmak için kaynatılan süt. * Yoğurt.
gamîn: Yumuşak.
gamîn: f. Tasalı, hüzünlü, kederli, gamlı.
gamîr •ƒšœ: Ekilmemiş, terkedilmiş ıssız yer. * Faydalanılmamış şey. * Mamur olmayan harap yer.
gamîr: Kurumamış yeşil ot.
gamîs: üstü kuru, altı yaş olan ot. * Ağaç ve otların arasında olan küçük su arkları.
gamîze: Akıl zayıflığı, ahmaklık, geri zekâlılık.
gaml: Tüyünü yolmak için deriyi dürüp gömmek.
gamm •š: Keder, tasa, dert, elem, kaygı.
gamm-abad: f. Keder ve hüznü bol. Gamlı.
gamm-alud: f. Kederli, gamlı, hüzünlü, kaygı veren.
gamm-dîde: Kederli, tasalı, gamlı, hüzünlü.
gamm-feza: f. Kederi artıran, hüznü çoğaltan.
gamm-gîn •šªÿ›: f. Kederli, hüzünlü, gamlı.
gamm-güsar: f. Teselli veren, gam ve kederi defeden dert ortağı. Arkadaş.
gamm-güsâr: f. Teselli veren, hüzün ve kederi defeden.
gamm-hane: f. Hüzün ve tasa yeri. * Mc: Dünya.
gamm-har: f. Kederlenen, hüzünlenen, tasalanan.
gamm-i fîrkat: Uzaklık gamı, ayrılık derdi.
gamm-nak: Gamlı, kederli.
gamm-nîsar: f. Hüzün veren, kederli eden.
gamm-penah: f. Tasalı yer, kederli yer. Kederin, tasanın sığındığı yer.
gamm-perver: f. Keder veren, hüzünlendiren, gam artıran.
gamm-zede: f. Kederli, hüzünlü, gamlı, tasalı.
gammaz •šƒ: Birisine iftira ederek zarar veren. Münafık, fitneci. * Adamın ayıplarını arayıp gizli şikâyet eden. * Tersane kethüdalarına mahsus altı çifte kayık.
gammazane: f. Fitnecilikle, gammazlıkla, koğuculukla.
gammazîyyet: Koğuculuk, fitnecilik, gammazlık.
gamn: Yumuşaklık.
gamr •šœ: Derinlik, suyun derinliği. çok su, büyük deniz. * Uzun, geniş libas. * Cehalet, gaflet. * şiddet.
gamre: (C.: Gamerât) Tecrübesizlik, görgüsüzlük, anlayışsızlık. * îzdiham, kalabalık. * Fenalığa dalmak. * şiddet. * Zahmet.
gams: Suyu şiddetli içmek. * Bir şeyi hakir görmek, birisine iftira etmek. * Nimete şükretmemek. * Göz yummak.
gams •šž: Yıldız kayması. * Suya dalmak.
gamt •š’: Minnetsiz ve şükürsüz olmak. * Horlamak, hakir görmek.
gamt •š…: çok yemekten dolayı midenin şişmesi. * Ağırlık olmak.
gamtaş: Gözü zayıf gören.
gamus: f. Manda, kömüş.
gamus: şiddetli emir. * Süngü ile vurup, ucunu diğer taraftan çıkarmak. * Karnındaki yavrusu belli olmayan deve.
gamuz: îtham olunan, töhmet altında bırakılan. * îçinden kan giden dişi deve.
gamz •š‘: (C.: Gamuz) Göz yummak, gizli olmak, yumuşak muamele etmek. * Kolay görerek ihmal etmek. * çukur yer.
gamz: Kaş ve gözle işaret, göz kırpmak. * çene veya yanak çukurluğu.
gamze •šœ: Süzgün bakış.
gamze-fîgen: f. Gamze saçan, süzgün süzgün bakan.
gamze-î câdu: Büyüleyen gamze. Süzgün bakış.
gamze-î cellâd: Cana kıyan yan bakış.
gamze-î dîl-duz: Gönül delen süzgün bakış.
gamze-î fettân: Câzibedar ve süzgün bakış.
gamze-î hunhar: Kan içen yan bakış.
gân ªƒ›: f. Cemi' yapmak için, sonu "e" sesi ile biten kelimenin sonuna gelir bir "ek" tir. Meselâ: Bendegân $ : f. Hizmetçiler, bendeler.
gana: Kifayet, kâfi gelme. * Menfaat, fayda.
ganaîm •›ƒ¡š: (Ganimet. C.) Harpte ele geçen mallar. Ganimetler.
ganaîm-î bahrîye: Harbte ele geçirilen düşman gemileriyle, bunlara ait her türlü levâzım ve eşyâlar.
ganaîm-î harbîye: Harbde düşmandan alınan top, tüfek, gemi, vasıta, yiyecek, içecek vs. gibi ganimetler.
ganbot: Yapısı küçük olmakla beraber, nisbeten ağır toplarla mücehhez harp gemisi. 
gâne: f. Bazı sayıların sonlarına eklenerek "lik" halinde sıfatlar yapılır. (Meselâ: Cihâr-gâne: f. Dörtlük.)
ganec: Koca. * şeyh.
ganem •›š: Koyun.
ganes: Su içtikten sonra teneffüs etmek.
gang: ing. Haydut çetesi. 
ganî •›ÿ: Zengin, kimseye muhtaç olmayan, elindekinden fazla istemiyen. Varlıklı, bol.
ganî-yî mutlak •›ÿ‚š’™—: (Gani-yi ale-l ıtlak) Cenab-ı Hak. Her şeye sahip ve hiç kimseye hiçbir cihetle ihtiyacı olmayan gani.
ganîm: Ganimet alan.
ganîmen: Ganimet almış olarak.
ganîmet •›ÿš : Harpte düşmandan alınan mal. * çalışmaksızın ele geçen nimet.
ganîmîn: Harbe bizzat iştirak edip, ganimet almağa hak kazanan muzaffer mücahidler.
ganîye: çok hoş, çok lâtif. * Kadın şarkıcı. * Zengin kadın veya kız.
ganm: Kabile ismi.
gannac: (Gunc. dan) çok işveli, çok nâzik.
ganyan: Fr. At yarışında birinci gelen.
gar ªƒœ: (Ger) f. Kelimeye eklemekle nisbet veya fâillik mânası verilir. Yapan, yapıcı mânasınadır. Meselâ:
gar •ƒœ: Mağara. în. Kehf. * Defne ağacı. * Gayret. * Fesad. * Tren istasyonu. * Tıb: Beden âzalarında olan cep gibi çukur yer. 
garabet •œƒ„ : Yabancılık. Gariblik. * Tuhaflık. * âcizlik, beceriksizlik. * Gizli olmak. Hilaf-ı âdet olmak. * Iraklık. * Edb: Ne demek olduğu herkesçe anlaşılmayacak kelime ve tabirlerin söz arasında kullanılması.
garabet-cu: f. Tuhaf şeylere meraklı olan, garip şeyler arayan.
garabet-nüma: f. Yabancılık çeken. Garip, tuhaf.
garabîb •œƒ„ÿ„: Katı, siyah şey. * Koyu renkli.
garabîl: (Gırbâl. C.) Delikleri iri olan elekler, kalburlar.
garabîn: (Gırbân. C.) Kargalar.
garaîb •œƒ¡„: (Garib. C.) Acaib şeyler. Hayret edilecek şeyler. Tuhaflıklar.
garaîbat: (Garâib. C.) Garib ve şaşılacak şeyler. Alışılmadık, tuhaf ve acaib nesneler.
garaîbperest: f. Garib, tuhaf şeylere çok düşkün olan ve çok seven.
garak: Suya batmak.
garam •œƒš: Helâk. Mahv. * Aşk. Sevdâ. şiddetli arzu. * Hedef.
garamet: (C.: Garâmât) Diyet ve borç gibi şeyleri ödeme. Resim, vergi.
garameten: Herkese eşit olarak, taksim ederek, paylaştırarak, hakkına göre.
garan: Tavşancıl kuşunun erkeği. * Açlık. * Zayıflık.
garare: (C: Garâyir) Büyük kıl çuval, harar. * Gafil olmak.
garat •ƒœƒ…: (Gâret. C.) Yağmalar. çapulculuklar.
garayîr: (Garâre. C.) Büyük kıl çuvallar, hararlar.
garaz •œ‘: (C: Ağraz) Maksat, niyet, gaye, kasıt. Kötü niyet. Kin. * Ok atılan nişan. * Izdırab. Acı. * Zelillik.
garaz-alud: f. Garezi, hususi bir maksadı olan.
garaz-i aslî: Asıl gaye, esas maksad.
garaz-kâr: f. Düşmanlıkla, eden, hased eden, kin güden.
garazen: Düşmanlıkla, garez ederek.
garazkârane: f. Hased ve düşmanlıkla.
garb •œ„: (C: Gurub) Güneşin battığı taraf. Batı. * Sığır derisinden yapılan büyük kova. * Sakaların su koydukları büyük tulum. * Atıldıktan sonra bulunmayan ok. * Yürügen at. * Nasır acısı (gözde olur). * Göz yaşı. * Göz yaşının geldiği damar. * Kenar.
garb-i cenubî: Güney batı.
garb-i şîmalî: Kuzey batı.
garben: Batıdan, garb cihetinden, batı tarafından.
garbî (garbîyye): Batı ile alâkadar, Avrupa'ya mensub. * Aşağı Mısır'ın batı kısımları.
garbîyyun: Garplılar, Avrupalılar. Batı memleketleri ahalisi.
garde: (C: Megârid) Mantar.
gardîyan: Fr. Kolcu, nöbetçi, muhafız.
gare: (C: Gârât) Bükmek.
gareb •œ„: Gümüş kadeh. * Kavak ağacı. * Havuzla kuyu arasına dökülen su. * Bir nevi koyun hastalığı.
gared: Güzel ses.
gareng: f. çığlık, feryat.
garer: Sonu mâlum olmayan, neticesi bilinmeyen.
gares: Açlık.
garet •ƒœ…: (A, uzun okunur) Yağmacılık. Düşmanın malını yağma etmek. * Göbek.
garet-ger: Yağmacı. çapulcu.
garetger •ƒœ…ªƒœ: (A, uzun okunur) f. Yağmacı. çapulcu.
garetgerân: f. Yağmacılar, çapulcular.
gareyn •ƒœÿ›: (A, uzun okunur) Alt ve üst çene, yâni ağız. * îki gar.
garez: Kayıştan yapılan üzengi. * Ağaç üzengi.
garf: (C: Guref-Agrâf) Kurtarmak. * El ile su almak. * Bir şeyi kesmek.
gargara: Suyu, içilen ilâcı veya başka bir sıvıyı, boğazda oynatıp çalkalama. * Tavuk ve güvercinin ötmesi. * Can boğaza gelip tereddüt etmek. * çömleğin kaynayıp fıkırdaması. * çoban koyuna haykırıp çağırması.
garî: f. Kararsız, sebatsız.
garîb •ƒœ„: (A, uzun okunur) Batan. Gurub eden. * îki omuz arası. * Devenin hörgücüyle boynu arası.
garîb-nüvaz: f. Kimsesizlere ve gariplere yardım eden. Biçareleri ve zavallıları koruyan.
garîb-üd dîyâr: Memleketin yabancısı.
garîbane: f. Garip gibi, garip kimselere yakışır şekilde, garipçesine.
garîb(e) •œÿ„: Hayret verici. Tuhaf. * Kimsesiz. Zavallı. * Gurbette olan.
garîf: (C: Guruf) Birbirine girmiş sık ve çok ağaç.
garîk •œÿ—: Suda boğulmuş.
garîkun: Katran köpüğü.
garîm •œÿš: Alacaklı. * Hasım. Rakib. Borçlu veya üzerinde borçtan başka hakları olan kimse.
garîn: Havuz dibinde olan balçıklı su. * Her nesnenin kap dibinde kalan çöküğü, tortusu.
garîr: Kefil. * Güzel ahlâk. * Durumdan veya işten anlamıyan.
garîse: Yeni dikilmiş fidan.
garîyy: Cemil, güzel, hüsün.
garîz: Taze nesne.
garîze •œÿœ: Asıl. Yaratılıştan olan. Sevk-i îlâhi. Huy.
garîzîye •œÿÿœ: Tıb: Yaratılışa âit. Yaşamaya âit. Doğuştan. Normal.
gark •œ—: Batmak, suda boğulmak.
gark-ab: f. Suya batmış olan, boğulmuş.
garka: Bir içim miktarı süt. * Suya batmış.
garkad: Bir dikenli ağaç. * Medine-i Münevvere'de olan kabristana "Baki-ul Garkad" denir.
garkan •œ—øƒ: Batarak, boğularak.
garm: çekmek.
garnîzon: Fr. Bir şehir veya müstahkem mevkideki birliklerin tamamı. * Askeri birliklerin bulunduğu şehir.
garr •œ: Aldatmak. * Hırsa düşmek. * Alnında dirhemden büyücek beyazlık bulunan at.
garr •ƒœ: Beyhude ve bâtıl şey. * Gafil adam. * Aldatan. * Kuyu kazan.
garra •œƒ£: Parlak. Beyaz. Güzel. şa'şaalı. * Kur'an'ın kudsi nurlarının parladığı Medine-i Münevvere'nin bir ismidir.
garran: f. Kükreyen, haykıran. Homurdanan.
garre: Gafil kişi, gaflette bulunan kimse.
garrende: f. Kükreyerek vahşileşen arslan ve benzeri yırtıcı hayvan.
gars •œž: Ağaç fidanı dikmek. * Dikilmiş fidan.
gars-i eşcar: Ağaç dikimi.
gars-i yemîn: Sağ el ile dikilen fidan. * Bir kimsenin yanından, fidan gibi ayrılmayan kişi.
garsan: Karnı aç kimse.
garur •œœ: Dünyada insana gurur veren herhangi bir şey. * Aldatıcı. * Allahı unutturan.
garv: Acip.
garz •œ: Batırma, sokma. îğne sokma.
garz: Doldurmak. * Noksan etmek, noksanlaştırmak.
gasa: Uzunluk.
gasagis: Arslan, esed.
gasak •ž—: (Gusuk-Gasekan) îlk koyu karanlık. * Küfrün karanlığı. * Gözün dumanlanıp, seçemez olması. * Göz kararması. * Herhangi bir şeyin akması, dökülmesi. * çok soğuk ve fena kokan içki veya su. * Kuvve-i şeheviyye. * Seyelân.
gasak-ul leyl •ž—‚ƒ™™ÿ™: Gecenin ilk karanlığı.
gasas: Dolu olma. * Yediği ve içtiği şeyin boğazda durması.
gasase: (Gasis-Gususe) Davarın zayıf olması. * Sözün boş ve faydasız olması. * Yaradan irinin akması.
gasb •„: Başkasına âit bir şeyi zorla, rızası olmadan almak. Zorla almak. * Zorla alınan şey.
gasb-i emval: Malların gasbedilmesi, zorla alınması.
gasb-i nukud: Paraların cebren alınması.
gasben: (Gasb. dan) Cebren alarak, zorla gasbederek.
gasben anh: Ona rağmen.
gasben ank: Sana rağmen.
gasem: Gecenin sonunda olan karanlık.
gaser: Rüzgârın çukur yere getirip yığdığı.
gaseyan •žÿƒ›: Mide bulantısı. Kusmak.
gasgase: Silahsız savaşmak.
gasib •ƒ„: Gasbeden, zorla alan.
gasib-ül gasib: Gasbedilmiş malı gasıbdan gasbeden.
gasik •ƒž—: Gecenin ilk karanlığı. Gece. Karanlık. * Ay doğmak.
gasîl: Yıkanmış.
gasîme: çekirgeli yemek.
gasîre: Cemaat, topluluk.
gasl •ž™: Yıkama. Gusül. şartlarına uygun şeklide boy abdesti almak. (Bak: Gusül) * Birisini döğüp vücudunu acıtmak.
gasl-î meyyît: ölünün yıkanması.
gaslak: Pişmemiş ve tuzlanmamış olan şey.
gasm: Karanlık, zulmet.
gasn: Kesmek.
gasr (gasrâ): Asılsız, alçak kimseler.
gass: încelik, zavallılık. * Biçare, zavallı. * Tatsız, yavan.
gass ü semîn: Fakir ve zengin. Zayıf ve semiz.
gassak ”žƒ—: Ehl-i cehennemin vücudundan akan irin. * çok soğuk ve fenâ kokulu içilmez şey.
gassal •žƒ™: (Gasl. den) ölü yıkayıcı.
gassan: Dolu, mümteli.
gasuk: Karanlık olmak.
gasul: Su. Bir şey yıkamakta kullanılan su.
gasul: çöğen denilen şey. 
gaşam: (C: Guşâm) Mübâlağa ile zulmeden.
gaşan: (Gaşayân) Gönül dönmek. * Akıl gidip, bihoş olmak.
gaşemşem: şecaatinden kimseye baş eğmeyen. * Başını döndürüp yabana iltifat etmeyen. * Zulmedici. * Methi istediği gibi yapamamak.
gaşeyan •ÿƒ›: Kendinden geçmek. Kendini kaybetmek. Bayılmak. Gaşyolmak.
gaşîye •ƒÿœ: Perde. örtü. * Kıyamet. * Dilenci ve cerrar. * Ziyârete gelen dostlar gurubu.
gaşîye suresî •ƒÿœ‚žœœ‚žÿ: Kur'an-ı Kerim'de 88. suredir. Mekkidir.
gaşîye-dâr: f. At uşağı, seyis.
gaşm: Zulüm etmek, zulüm yapmak.
gaşmere: Yönelmek.
gaşş: örtmek, setretmek.
gaşş: Hâin.
gaşum: Zâlim, gaddar. * Muannid, inatçı.
gaşve: (Gışâve-Guşve) Perde, hicap, örtü. * Göz kararmak.
gaşy: Bayılma, kendinden geçme.
gaşy-âver: f. Baygınlık veren, bayıltan.
gaşyet: Kendinden geçme, bayılma. * örtmek. * Hayret.
gaşyet-î mevt: Koma hali.
gaşyolma •ÿ‚ƒ™šœ: Kendinden geçme. Kendini bilemez hale gelmek.
gata: (Gıtâ) (C: Agtıye) Perde, örtü.
gatamtam: çok su.
gatarîf(e): (Gıtrif. C.) Başkanlar, başlar, reisler, önderler. * Soylu ve asaletli kimseler, itibarlı ve seçkin kişiler.
gataş: (C: Agtaş) Karanlık. * Devamlı su akan gözdeki zayıflık.
gatata: (C: Gıtât) Bağırtlak cinsinden bir kuş.
gataye: Kertenkeleden büyük bir hayvan.
gatfan: Ev içinde su dökmek için yapılan yer. * Erkek ismi.
gatgata: çömleğin kuruyup kaynaması.
gatît: Horlamak.
gatrafe: Büyüklenmek, ululanmak, kibirlenmek.
gats: Batırılma, daldırılma. * Batırma, daldırma.
gatt: Birbirine tâbi olmak. * Gizlemek. * Mükedder etmek, üzmek. * Suya dalmak.
gâv: f. öküz, sığır, bakara.
gâv-ban: f. Sığır çobanı, sığırtmaç.
gâv-i deştî: Yaban sığırı.
gava •ÿ: Yoldan çıkmış. Yolunu şaşırmış. Azgın.
gavadî: Sabah bulutu.
gavafîl: (Gafile. C.) Gafiller, gaflette bulunanlar.
gavaîl: (Gaile. C.) Musibetler, belâlar. * Dertler, sıkıntılar, kederler, hüzünler. * Felâketler, âfetler.GAVALî $ (Galiye. C.) Güzel kokular.
gavamiz •ƒš‘: (Gamız. C.) Anlaşılması zor hakikatler. înce ve derin mes'eleler.
gavanî: (Ganiye. C) Zenginler. * Kadın şarkıcılar.
gavaş: (Gaşiye. C.) örtücü, örten.
gavaşî •ƒÿ: (Gaşiye. C.) Kıyametler. * örtü. At takımından sayılan bir nevi örtü.
gavaya: (Gaviyye. C.) Sapmışlar, sapıtmışlar.
gavayet: Dalâlete düşme, hak yoldan sapma. * Azgınlık.
gavayet-î nefs: Nefsin azgınlığı.
gavc: Enli ve yassı olmak. * Muzdarip olmak, acı çekmek.
gavelan: Acı bir ot.
gavga: f. Döğüşme, kavga, vuruşma. Gürültü. Savaş, muhârebe, harp.
gavga: çekirge. * însanların rezilleri. Adi, aşağılık olan kimseler.
gavî •ƒÿ: (A, uzun okunur) çok azgın. çok sapkın. Yoldan şaşıp azıtan zâlim.
gavîyy •ÿ: Azgın. Zâlim. * Tek başına kalan.
gavl: (C: Gavâyil) Helâk etmek. * Kin tutmak. * çok miktar toprak. * Feyizden uzaklık.
gavr •œ: Bir şeyin dibi. çukur. * Batmak. * Derinlik, nihayet. Kök, esas, temel. * Tefekkür, teemmül. * Dolanmak. * Hakikat.
gavr-i amîk: Derin dip.
gavr-i în'îdam: Yokluk çukurunun dibi.
gavr-i mes'ele: Mes'elenin esası, mevzuun künhü.
gavs •: Suya dalmak. Dalgıçlık. * Mc: Bir mes'elenin derinliğine ve hakikatine muttali' olup bilmek. * îyi anlamak. * Maslahata gayret ile girmek.
gavs •†: çağırma. Nida. Medet istemek. * Yardım edici. Medet verici. * Kurtuluş. (Bak: Aktâb)
gavs-ül a'zam: Abdülkadir-i Geylani (K.S.) Hazretlerinin nâmı. En büyük Gavs. Evliyâullahın büyüğü. Gavs-i Ekber de denir. (Bak: Geylani)(Bir zaman Hazret-i Gavs-ı Azam şeyh Geylâni'nin (K.S.) terbiyesinde, nazdar ve ihtiyâre bir hanımın bir tek evlâdı bulunuyormuş. O muhterem ihtiyare gitmiş oğlunun hücresine, bakıyor ki, oğlu bir parça kuru ve siyah ekmek yiyor. O riyazattan za'fiyetiyle vâlidesinin şefkatini celbetmiş... Ona acımış. Sonra Hazret-i Gavs'ın yanına şekva için gitmiş. Bakmış ki, Hazret-i Gavs kızartılmış bir tavuk yiyor. Nazdarlığından demiş: "Ya üstad! Benim oğlum açlıktan ölüyor. Sen tavuk yersin!" Hazret-i Gavs tavuğa demiş: "Kum Biiznillâh" O pişmiş tavuğun kemikleri toplanıp, tavuk olarak yemek kabından dışarı atıldığını mutemed ve mevsuk çok zatlardan Hazret-i Gavs gibi kerâmât-ı hârikaya mazhariyeti dünyaca meşhur bir zatın bir kerâmeti olarak mânevi tevatürle nakledilmiş. Hazret-i Gavs demiş: "Ne vakit senin oğlun da bu dereceye gelirse, o zaman, o da tavuk yesin." îşte Hazret-i Gavs'ın bu emrinin mânâsı şudur ki: Ne vakit senin oğlun da, ruhu cesedine, kalbi nefsine, aklı midesine hâkim olsa ve lezzeti şükür için istese, o vakit leziz şeyleri yiyebilir... L.)
gavsîyyet •†ÿ : Evliyaullahın başı olmak. Velâyet mertebelerinden yüksek bir makam sahibi olmak. (Bak: Aktab)
gavt: Derin çukur. * Bir şeyin içine girme, batma, garkolma.
gavta: Ağaçlık, sulak yer. * Toprakta çukurluk.
gavta: f. Suyun içindeki derinlik.
gavta-baz: f. Dalgıç.
gavta-bazî: f. Dalgıçlık.
gavta-gâh: f. Dalma yeri.
gavta-har: f. Dalan, batan.
gavun: (Gavi. C.) Azgınlar, azmışlar, doğru yoldan çıkıp dalâlete düşmüş olanlar.
gâvur ªƒœ: Kâfir. Merhametsiz, inatçı.
gavvas •ƒ: çok gayretli. çalışkan. * Suya dalan. * înci arayan dalgıç.
gayahîb: (Gayheb. C.) Gece karanlıkları.
gayat •ƒÿƒ…: (Gâye. C.) Gâyeler.
gayat •ÿƒ’: çalgı.
gayb •ÿ„: Gizli olan. Görünmeyen. Belirsiz. * Güman. Hislerle veya akıl ile bilinmeyen şey. (Bak: Ahbar-ı gayb)(Demek Cenab-ı Hakk'ın gayet büyük ve mükemmel bir rahmeti, re'feti ve şefkati, gaybı bildirmemektedir. Bilhassa masum hayvanlar hakkında daha tamdır. Demek sefihane lezzette sen hayvanlara yetişemezsin. Binler derece aşağı düşersin! çünki, hayvana nisbeten gaybi olan şeyleri senin aklın görüyor. Elemini alıyor. Setr-i gaybda bulunan istirahat-ı tammeden bilkülliye mahrumsun. S.)
gayb-aşîna •ÿ„‚¥›ƒ: f. Gaybı bilen. Gaybdan haberi olan. Gelecekten veya âhiretten haberi olan.
gayb-bîn •ÿ„‚„ÿ›: f. Gaybı gören. Herkesin bilemediği geleceği feraseti ile hissedip bilen. îstikbalden haber veren.
gayb-dan: f. Gaybı bilen.
gayb-ül gayb: Kalbde olmayan şey. Hiç ortada eseri, varlığının, geleceğinin izi ve nişanı olmayan. Gaybın gaybı olan.
gaybet •ÿ„…: Başka yerde bulunmak. Hazırda olmamak. Gıybet. Bir şeyin diğer bir şey içinde gaib olması. (Bak: Gıybet)
gaybî •ÿ„ÿ: Hazırda olmayan. Görünmeyenlere âit. Hazır olmayanlara âit. Başka âlemdekilere âit. âhirete âit. Gayba âit ve müteallik.
gaybubet •ÿ„„ : Gayıplık, hazırda olmayıp başka yerde olma.
gayda: (C: Guyed) Nazik ve yumuşak tenli genç kadın. (Müz.: Agyed)
gaydak: Geniş. * Yumuşak. * Kerim kişi. îyi huylu kimse. * Keler yavrusu. * Büluğ çağına varmamış çocuk.
gaye •ƒÿœ: Maksad, kasdedilen, netice, sonuç.(Her şeyin vücudunun müteaddit gayeleri ve hayatının müteaddit neticeleri vardır. Ehl-i dalâletin tevehhüm ettikleri gibi dünyaya, nefislerine bakan gayelere münhasır değildir. Tâ, abesiyyet ve hikmetsizlik içine girebilsin. Belki her şeyin gayât-ı vücudu ve netaic-i hayatı üç kısımdır. Birincisi ve en ulvisi Sani'ine bakar ki; o şeye taktığı hârika-i san'at murassaatını, şâhid-i Ezeli'nin nazarına resm-i geçit tarzında arzetmektir ki, o nazara bir ân-ı seyyale yaşamak kâfi gelir. Belki, vücuda gelmeden, bilkuvve niyyet hükmünde olan istidadı yine kâfidir. îşte, seriüz-zeval lâtif masnuât ve vücuda gelmeyen, yâni sünbül vermeyen birer hârika-i san'at olan çekirdekler, tohumlar şu gayeyi bitemamiha verir. Faidesizlik ve abesiyyet onlara gelmez. Demek her şey; hayatiyle, vücudiyle Saniinin mu'cizat-ı kudretini ve âsâr-ı san'atını teşhir edip, Sultan-ı Zülcelâl'in nazarına arzetmek birinci gayesidir...îkinci kısım: Gaye-i vücut ve netice-i hayat: Zişuura bakar. Yâni, herşey Sâni-i Zülcelâlin birer mektub-u hakaik-nüma, birer kaside-i letafetnüma, birer kelime-i hikmet-edâ hükmündedir ki; melâike ve cin ve hayvanın ve insanın enzârına arzeder.. mütalâaya dâvet eder. Demek, ona bakan her zişuura ibretnüma bir mütalâagâhdır.üçüncü kısım: Gaye-i vücut ve netice-i hayat: O şeyin nefsine bakar ki; telezzüz ve tenezzüh ve beka ve rahatlıkla yaşamak gibi cüz'i neticelerdir. Meselâ: Azim bir sefine-i Sultaniyyede bir hizmetkârın dümencilik ettiğinin gayesi: Sefine itibariyle yüzde birisi kendisine, ücret-i cüz'iyyesine ait.. doksandokuzu Sultana ait olduğu gibi; herşeyin nefsine ve dünyaya ait gayesi bir ise, Sâni'ine ait doksandokuzdur. îşte bu teaddüd-ü gayattandır ki; birbirine zıt ve münâfi görünen hikmet ve iktisad, cud ve sehâ ve bilhassa nihayetsiz seha ile sırr-ı tevfiki şudur ki: Birer gaye nokta-i nazarında cud ve seha hükmeder. îsm-i Cevvad tecelli eder. Meyveler, hubublar; O tek gaye nokta-i nazarında bigayr-i hisâbdır. Nihayetsiz cûdu gösteriyor. Fakat, umum gayeler nokta-i nazarında; hikmet hükmeder. îsm-i Hakim tecelli eder.. Bir ağacın ne kadar meyveleri var, belki her meyvenin o kadar gayeleri vardır ki; beyan ettiğimiz üç kısma tefrik edilir. şu umum gayeler, nihayetsiz bir hikmeti ve iktisadı gösteriyor. Zıt gibi görünen nihayetsiz hikmet, nihayetsiz cud ile seha ile içtima ediyor. Meselâ: Asker ordusunun bir gayesi, te'min-i âsâyiştir. Bu gayeye göre ne kadar asker istersen var ve hem pek fazladır. Fakat, hıfz-ı hudut ve mücahede-i a'dâ gibi sair vazifeler için, bu mevcut ancak kâfi gelir. Kemâl-i hikmetle muvazenededir. îşte hükümetin hikmeti, haşmet ile içtima ediyor. O halde, o askerlikte fazlalık yoktur denilebilir... S.)
gaye-î hayal: Hayalde tasavvur edilen ve ona varılması istenen gaye ve maksat. îdeal.
gayed: Nazik ve yumuşak tenli olmak.
gayet •ƒÿ : çok, pek çok. * Nihayet. Gaye. Encam.
gayet-ül-gaye: Gayenin esası, en son derece. (Bak: Vicdan)
gayeten •ƒÿ : Son derece, çok fazla olarak.
gayetsîz: Nihayetsiz, sonsuz.
gayf: Eğilmek, meyl.
gayheb: (C.: Gayâhib) Gece karanlığı.
gayit: (C: Gaytân-Agvât) çukur yer. * Kenef.
gayîr: Irak, baid, uzak.
gayk: (Gayuk) Fikri karışık olmak.
gayl: Irmak, nehir. * Ağaç, şecer. * Cima etmek. * Kadının hâmile iken çocuğuna süt emzirmesi.
gayle: şişman kadın.
gaylem: Kul, cariye. * Kablumbağanın erkeği. * Mevzi ismi. * Mugaylân ağacı.
gaym •ÿš: Bulut. * Sisli bulut tabakası. * Pek susayıp hararetlenmek.
gayme: çok fazla susama, susuzluk.
gayn •ÿ›: Susuzluk. * Arapçada "ayn" harfinden sonra gelen harfin adı.
gayna: Yaprakları çok olan yaş ağaç.
gayne: Aralarından su akamayan birbirine girmiş ve dolaşmış ağaçlar.
gayr •ÿœ: Diğer, başkası, mâadâ, âher, yabancı. (îstisnâ edâtıdır. Başlarına getirildiği kelimeyi nefy yapar.)
gayr-endîş •ÿœƒ›šÿ: f. Başkalarını düşünen, şefkatli ve cömert kimse.
gayr-i kabîl •ÿœ‚—ƒ„™: Mümkün ve kabil değil, imkânsız. Mümkün olmayan, olamaz.
gayr-i ma'kul •ÿœ‚š”—™: Akıl işi olmayan, aklın kabul etmediği.
gayr-i mahdud: Hudutsuz, uçsuz bucaksız, sonsuz.
gayr-i mahsur •ÿœ‚šˆœ: Hasrolunmamış. Sınırsız.
gayr-i me'luf •ÿœ‚š¤™–: Alışılmamış, ülfet edilmemiş.
gayr-i me'mul: Umulmadık. Beklenmedik. Birdenbire.
gayr-i mebzul: çok kullanılmayan. Az bulunan şey.
gayr-i meczuz •ÿœ‚š‡‹‹: Devamlı, kesilmeden.
gayr-i memnun: Devamlı. Kesiksiz. * Minnetsiz, sürekli.
gayr-i men hüve leh •ÿœ‚š›‚œ‚™œ: Sâhibinden gayrısı.
gayr-i menkul: Naklolunamayan, taşınamayan (tarla,bağ, ev gibi) mallar.
gayr-i mer'î: Görünür olmayan, görünmeyen.
gayr-i meskun: îçinde oturulmayan yer. Kimsesiz yer.
gayr-i meş'ur •ÿœ‚š”œ: Duyulmayan, hissedilmeyen. (Bak: Taht-eş şuur)
gayr-i meşru' •ÿœ‚šœ”: Allah'ın rızâsına uymayan, şeriat hârici, kanunsuz iş.(Tarık-ı gayr-ı meşru' ile bir maksadı tâkibeden galiben maksudunun zıddı ile ceza görür. -Avrupa muhabbeti gibi.- Gayr-ı meşru' muhabbetin âkıbetinin mükâfatı, mahbubun gaddarane adavetidir. M.)
gayr-i mutabik: Uygun gelmeyen, uymayan. 
gayr-i mutemed •ÿœ‚š”…šš: Kendine itimad edilmeyen.
gayr-i müekkede •ÿœ‚š¢˜šœ: Tekrarlanmamış ve takviye edilmemiş. * Zanni ve kat'i delil ile sâbit olmayıp, Peygamberimizin (A.S.M.) bazan devam buyurdukları iş veya amel.
gayr-i mümkîn •ÿœ‚šš˜›: Mümkün olmayan, imkânsız.
gayr-i münbît •ÿœ‚š›„…: îyi ve bol yetiştirmeyen. Münbit olmayan.
gayr-i münfekk: Bitişik, ayrılmaz.
gayr-i münîf •ÿœ‚š›ÿ–: Münif olmayan. (Bak: Münif)
gayr-i münkati': Devamlı, fasılasız, kesiksiz.
gayr-i müslîm: Müslüman olmayanlar. îslâmiyete girmeyenler.
gayr-i müsmîr: Verimsiz, faydasız, meyvesiz. (Bak: Desâtir)
gayr-i mütecezzî •ÿœ‚š…‡ÿ: Ayrılamayan, bölünemeyen.
gayr-i mütenahî •ÿœ‚š…›ƒœÿ: Sonsuz, nihayet bulmaz, bitmez.(Bir noktayı tam yerinde icad etmek için, bütün kâinatı icad edecek bir kudret-i gayr-ı mütenahi lâzımdır. Zira, şu kitab-ı kebir-i kâinatın her bir harfinin, bâhusus zihayat her bir harfinin, her bir cümlesine müteveccih birer yüzü, nâzır birer gözü vardır. M.)
gayr-i şuurî: şuursuz, şuurun dışında.
gayr-i uzvî •ÿœ‚”‘ÿ: Cansız. Uzvi olmayan. (înorganik)
gayr-i zarurî: Zaruri ve mecburi olmayan.
gayret •ÿœ : Dikkatle ve sebatla çalışmak. * Kıskanmak, çekememek. * Hareketli ve temiz hislerle çalışmak. * Dine, imana, namus gibi kıymetlere tecavüz edenlere karşı müdafaa için harekete gelmek.
gayret-î bâtila: Faydasız ve boşu boşuna uğraşma.
gayret-î câhîlîye: Körü körüne uğraşmak. Allah'ın razı olmadığı lüzumsuz şeylere kıymet vererek didinmek.
gayret-î dînîyye: Din için gayret etme.
gayret-î merdane: Mertçesine gayret.
gayret-mend: f. Gayretli, çalışkan.
gayret-şîar: f. Gayretli. çalışkan.
gayretkeş: çalışkan, çabalayıcı. * Bir tarafı tutan, taraftar. * Kıskanç.
gayri •ÿœÿ: Başkası, diğeri. Artık. (Bak: Gayr)
gayrîyet •ÿœÿ : Ayrılık. Gayrılık.
gays •ÿ†: îmdad. Yardım. * Yağmur. * Yağmurla meydana çıkan çayır.
gays-i nâfî': Faydalı yağmur.
gaysan: Gençlik şiddeti.
gaytale: (C: Gıytal) Sık bitmiş olan ağaç. * Seslerin karışması.
gayub: (Gayâb-Gaybe) Kaybolmak.
gayur •ÿœ: Hamiyetli. çok çalışkan. Dayanıklı. çok gayretli. * Kıskanç. ("Gayyur" diye yazılması yanlıştır.)
gayuran: (Gayur. C.) çalışkanlar, gayretkeşler, gayretliler.
gayurane: f. Gayretli olan kimseye yakışır şekilde, çalışkan kimseler gibi.
gayy •ÿ: Aklın istikametini, yolun doğrusunu kaybetmek. Rüşdün zıddı.
gayya •ÿƒ: Cehennemin beşinci tabakasındaki çok korkunç bir kuyunun adı. îçine düşenin kolay kolay kurtulamıyacağı korkunç yer.
gayyîr: (Gayyür) Gayretli kimse.
gayz •ÿ“: Hiddet, kin, öfke, gadab. Dargınlık. Hınç.
gayz •ÿ‘: Bir şeyin pahası eksilmek. Hilkati noksan olma. Kıymetten düşük şey. * Suyun eksilip azalması, yere çekilmesi.
gayz ü gazab: Kızgınlık ve hiddet.
gayz-efşan: f. Hiddetli, öfkeli, kızgın.
gayza: Meşelik.
gayzeran: îtburnu.
gaz: f. Isırma, dişle tutma. * Diş.
gaza •ƒ£: (C.: Gazevât) Din uğrunda kâfirlerle yapılan mücadele, muhârebe, düşmana kasdetmek. Cenketmek.
gaza-yi ekber: Din uğrunda kâfirlerle yapılan büyük muhârebe.
gazab •‘„: Hiddet, öfke, dargınlık, kızgınlık.
gazab-i îlahî: Allah'ın gazabı. Belâ, musibet.
gazab-nak: f. öfkeli, hiddetli, kızgın. Dargın.
gazaben: Gazabla, hiddetle, öfkeyle.
gazal: (C: Gazale-Gazelân) Ceylân. Geyik, âhu. Geyik yavrusu. * şarkıcı, mızıkacı. *Güzel göz.
gazale: Dişi geyik. * Güneşin yükselmesi.
gazalî •ƒ™ÿ: (Bak: îmam-ı Gazali)
gazalî •ƒ™ÿ: Onyedinci asırda şiirleri ile tanınan Bursa'lı bir şâirin adıdır.
gazamîr: Malı çok olan, zengin.
gazanfer •‘›–œ: Kahraman. * îri arslan.
gazanfer-î gazub: Kükremiş arslan.
gazanferâne: f. Arslancasına, arslan gibi.
gazar: Bir cins güvercin. * çok, fazla.
gazat •‘ƒ : (C: Guzâ) Dağ armudunun ağacı. * Dikenli ağaç. * Seksek ağacı.
gazât •ƒƒ…: Gazlar.
gazât-i muzirra: Zararlı gazlar. Zehirli gazlar.
gazaza: Eksiklik.
gazb: Kızıl boya, kırmızı renkli boya.
gazban •‘„ƒ›: (Gadbân) Dargın, kızgın.
gazbe: Sağlam, sert taş.
gaze ªƒœ: f. çocuk salıncağı.
gaze •ƒœ: f. Kadınların yüzlerine sürdükleri düzgün allık.
gazefe: Bağırtlak kuşu.
gazel •™: Tek kişinin özel bir ahenkle okuduğu manzume. (Aşk ve nefis gibi hislere ait olup, anlamı dine aykırı olursa ve kadın sesi ile câiz değildir.) * Edb: Klâsik şark şiirlerinin en çok kullanılan ve (5-15) beyitlik şekil. * Sonbaharda ağaç üzerinde kuruyan yapraklar. * Ceylân. * Lâtif şey. * Güzel kadınların bahsi ve medhi. * Kadınlar sohbetini sevmek. * Köpeğin, geyiğin sesinden ürkmesi.
gazel-han: f. Gazel okuyan.
gazel-hanî: f. Gazel okuyuculuk.
gazel-nüvîs: f. Gazel yazan.
gazel-sera: f. Nazım şekilleri arasında gazel meydana getiren.
gazelîyyat: Gazel tarzında yazılmış şiirler.
gazem: Bir ot cinsi.
gazete: Fr. Genellikle günlük çıkan ve büyük boy olan neşriyat organı. (Bak: Mürcif)
gazevan: Hızlı giden iyi at.
gazevat •ƒ…: (Gazve. C.) Din uğrunda yapılan harbler.
gazf: Kulağın sarkık olması. * Kırmak. * Geceleyin karanlık olmak.
gazgaza: Zillet, aşağılık. * Eksik, noksan.
gazif: Yumuşak, geniş.
gazir: îyi dibâgat olunmamış deri.
gaziye: çok karanlık olan yer. * Büyük nurlu şey.
gazî •ƒÿ: Din uğrunda harbeden. Cihadda yaralanmış veya harbetmiş olan kimse. Harpte ordunun başına geçen kumandan. Muzaffer olan ve harpten sağ dönen.
gazîd: Katı sesli. * Yumuşak ot.
gazîme: Gazem denilen otun yetiştiği yer.
gazîr: Bol, çok, kesretli, ziyade, fazla.
gazîr(e): Mülâyim, yumuşak. Nâzik, uysal.
gazîyy: (C: Gazâ) Yeni doğmuş kuzu.
gazîz: Gılâfından yeni çıkan çiçek. * Taze.
gazl •™: îplik eğirmek, bükmek.
gazl •‘™: Budaklanmak.
gazm: Güçle ve şiddetle yemek. * Defetmek, kovmak.
gazn: Hapsetmek. * Kırmak.
gazr: (Gazâre) (C: Gazâyir) Men etmek, engel olmak. * Hapsetmek. * Geçim kolaylığı, maişet genişliği. * Büyük çanak.
gazra: Ucuzluk. * Hayır. * özlü balçık.
gazreme: (C. Gazarim) ölçüsüz, tartısız bir şeyi satmak.
gazruf: (C.: Gazârif) Kıkırdak.
gazub: (Gazab. dan) öfkeli, kızgın, hiddetli. Kükremiş. * Büyük yılan. * Abus deve.
gazv •: Kasdetmek. * Küffarla cenk edip savaşmak.
gazv •‹: Seyelân etmek, akmak. * Münkatı' olmak, kesilmek.
gazva: Malın ve davarın kötüsü.
gazve •œ: Din düşmanı olan cephenin üzerine taarruz. Muharebe. Cenk. Sefer. Din muharebesi. Gazve, gazivden alınmış olup cenk ve kıtal manasınadır. Düşmanla vuruşmak demektir. Siyer ıstılahında Gaza ve gazve tâbirleri Peygamber Efendimizin bizzat hazır bulunduğu muharebeye denir. Peygamber Efendimizin bizzat bulunmadığı müfrezelere Seriye denilir.
gazve-î bedîr: Bedir Gazvesi. Bedir Muharebesi.(Melâikelerin, Resul-i Ekrem Aleyhissalâtü Vesselâm'a hizmeti ve görünmesi ve cinnilerin O'na imân ve itâati, mütevatirdir. Nass-ı Kur'an ve çok âyatla musarrahtır. Gazve-i Bedir'de beşbin melâike, - nass-ı Kur'an ile - önde, sahâbeler gibi ona hizmet edip, asker olmuşlar. Hattâ o melekler, melâikeler içinde, ashâb-ı Bedir gibi şeref kazanmışlar. M.)
gazver: Bir ot cinsi.
gazz •‘: (Gadd) Utancından dolayı önüne bakmak. * Bir şeyin miktarını eksiltmek. * Hurmanın tomurcuğu. * Zerafet sâhibi. * Yeni buzağı.
gazzal: Eğrilen iplik.
gazze: şam'ın doğusunda bir yerin adı. (Resullulah Efendimizin ceddi Hâşim'in kabri ordadır.)
gebe: (Bak: Hâmile) 
gebeş: Koyunun erkeği. Koç. * Mc: Akılsız, ahmak adam.
gebr: f. Ateşe tapan, mecusi.
gec: f. Kireç, alçı, harç.
gecbaz: Oyunda hile yapan, hileci.
geckâr: (Gecger) f. Kireçle badana yapan. Kireç sıvacısı.
geçer akça: t. Rayiç para yerine kullanılır bir tabirdir. Bu tabir, eskiden halk arasında yapılan senetlerde, hükümet tarafından akdolunan mukavelelerde kullanılırdı.
ged: (Gedbe) f. Yoksul, dilenci, fakir, dilenen. * Dilencilik.
geda ªšƒ: f. Fakir. Kimsesiz. Dilenci.
geda-çeşm: f. Dilenci gözlü, yoksul gözlü. * Mc: Aç gözlü, gözü doymaz. 
geda-çeşmane: f. Açgözlülükle, açgözlücesine.
gedayan ªšƒÿƒ›: f. Fakirler. Kimsesizler. Gedâlar.
gedayane: f. Dilencilikle.
gedayî: f. Dilencilik.
gedîklî: t. Tar: Yeniçeri efradı arasında eskilikleri dolayısıyla imtiyazlı olanlar. Bunlar diğer yeniçerilerden ayrılmak için bellerine seraser denilen kumaştan kuşak sararlardı. * Yıkık, çentikli ve düşük yeri olan. * Mülk olduğu halde vakfa ait bir tarafı olan. * Deniz assubayı ki, eskiden yükselerek subay olabilirdi.
geh (gâh): f. Kelimenin sonuna eklenerek yer veya zaman ifade eder.
gehan: f. Zaman, an, vakit.
geh(î) ªœÿ: f. Ara sıra. Bazan.
gehvare: f. Beşik.
gehvare-ger: f. Beşikçi.
gehvare-nîşîn: f. Beşikteki çocuk.
gele: f. Sığır, koyun ve keçi sürüsü. * Sürü.
geleban: f. Sığırtmaç, çoban.
gelu: f. Boğaz.
gelu-gîr: f. Dağ armudu. Ahlat. * Boğazdan geçmesi zor olan şey.
gem vurmak: Mecaz yoluyla mâni olmak, zabtetmek, bağlamak yerinde kullanılan bir tabirdir.
genc (gencîne): f. Define, hazine. Gömülü hazine. Kenz.
genc-î nîhan: Gizli hazine.
gencur: f. Hazine muhafızı, hazinedar.
gend: f. Pis koku, fenâ koku.
genda(y): f. Kokmuş, fenâ kokulu.
gendeme: f. Siğil.
gendîde: Kokmuş.
gendüm: f. Buğday.
gendüm-gun: f. Buğday renkli.
gendümnüma: f. Yüze gülüp aldatan. Hilekâr.
gensoru: (Bak: îstizah)
ger ªœ: Uyuz hastalığı.
ger ªœ: f. Türkçedeki "eğer" kelimesinin kısaltılmış şekli. Eğer, şayet mânasındadır.
ger ªœ: f. îsimlerin sonlarına eklenir ve yapıcılık bildirir bir edattır. Meselâ: Ahen-ger $ : f. Demirci. Zer-ger $ : f. Kuyumcu.
gerçî: f. öyle ise de, her ne kadar.
gerd ªœš: f. Baht, talih. Fayda. * Toz, toprak. * Hüzün, keder, gam, tasa.
gerd ªœš: f. Kelimelere eklenir ve "Dönen, dolaşan" anlamlarını verir. Meselâ: Tiz-gerd $ : çabuk dönen.
gerd-âld: f. Toz toprak içinde.
gerd-âlde: f. Toza toprağa bulaşmış, tozlu topraklı. * Mc: Maddiyatı olan kimse, paralı, zengin.
gerdâ-gîrd: f. Fırdolayı. 
gerdân: f. Dönen, dönücü. çeviren. (Bak: Gerden)
gerde ªœšœ: f. îsimlere eklenerek; etmiş, yapmış, eylemiş gibi mef'uller yapılır.
gerden ªœš›: f. Dönen. Dönücü. * Boyun. * şeci'. Bahadır. Pehlivan.
gerden-bend: f. Boyuna bağlanan nesne, boyun bağı. * Gerdanlık.
gerden-beste ªœš›„ž…œ: f. Boynu bağlı. îtâatli. Boyun eğmiş.
gerden-dâde ªœš›šƒšœ: (Bak: Gerdenbeste) 
gerden-efraz: (Gerden-firâz) f. Kibirli, gururlu. Boyun kaldıran, başı yukarda.
gerden-keş: f. âsi, serkeş, isyankâr. * Mağrur, kibirli. * înatçı, muannid.
gerdena: f. Kuş veya kuzu çevirmesi. * Yürümeye yeni başlayan çocukları, yürümeye alıştırmak için yapılmış bir cins araba. * Kebap şişi. * Fırıldak, topaç.
gerdîde: f. Tavır ve hâlleri değişmiş.
gerdîş: f. Dönme, dönüş. çevrilme, dolaşma.
gerdîş-î zemân: Zamânın dönüşü.
gerdun: f. Dünyâ, felek. * Dönen, dönücü, devreden, çevrilen.
gerdun-mîna: f. Gök, sema, asuman.
gerdun-sîrîşt: f. Mağrur, gururlu, kibirli kimse. * Zâlim, gaddar, kan dökücü. * Tenbel, uyuşuk.
gerdune: f. Araba, otomobil.
gerdune-î îclal: Saltanat arabası.
gergedan ªœªšƒ›: Burnu üzerinde boynuzu bulunan ve file benzeyen vahşi bir hayvan.
gerîlla: (îspanyolca) Büyük bir kuvvete karşı, dağınık küçük kuvvetler tarafından yapılan çete harbi.
gerk: f. Uyuz hayvan.
germ ªœš: f. Sıcak. Kızgın. * çabuk öfkelenen. * Gayretli, hamiyetli. Tez meşreb.
germ ü serd: Sıcak ve soğuk. * Darlık genişlik, iyilik kötülük, acı tatlı.
germ-mend: f. Acele eden, aceleci.
germ-ran: f. Atı çok süren, hızlı at süren.
germ-ülfet: f. Görüşmesi hararetli olan, hararetli ve sıkı-fıkı görüşen.
germa: f. Sıcak.
germa-germ: f. Pek kızışmış, kızışıp ısınmış. * Sıcağı sıcağına.
germa-peyma: f. Sıcaklık ölçeği. Termometre.
germabe: f. Sıcak su hamamı. Kaynarca, kaplıca, ılıca.
germî: f. Hararet, sıcaklık, kızgınlık.
germîyyet: Sıcaklık, hararet. Ateşli ve hızlı çalışma.
gerzîş: f. Zulümden şikâyet etme.
gestî: f. çirkinlik.
geş: Edâ ve naz yaparak yürüme. * Lâtif, hoş, güzel.
geşt: Seyretme, dolaşma, gezme, tenezzüh. * Geçme.
geşt ü güzâr: Gezip tozma, gezme.
geşte: f. "Gezmiş, dolaşmış, dönmüş" anlamlarına gelerek birleşik kelimeler yapılır. Meselâ: Ber-geşte $ : Altüst olmuş. Ser-geşte $ : Başı dönmüş.
gev: (C.: Gevân) f. Yiğit, bahadır, kahraman.
gev-çah: f. Dibi görünebilen pek derin olmayan alçak kuyu.
gevah ªƒœ: (Bak: Güvah)
gevahî ªƒœÿ: (Bak: Güvahi)
gevan: (Gev. C.) Kahramanlar, yiğitler.
gevar ªƒœ: t. Ark. Bahçeleri sulamak için çayırdan ufak bir arkla alının kol.
gevare ªƒœœ: (Gehvâre) Beşik.
gevç: f. Ağaç zamkı.
gevden: f. Sersem, ahmak, şaşkın, anlayışsız.
geven ªƒ›: t. çalı. Dikenli ve bir karış kadar boyunda bir nebat. Aslı Gevân'dır.
gevher ªœœ: f. Akıl ve edeb. * Asıl ve neseb. * Elmas, cevher, mücevher. înci. * Bir şeyin künhü ve esası. Hakikat. * Noktalı olan harf.
gevher-bar: f. Cevher yağdıran.
gevher-efşan: f. Cevher saçan.
gevher-füruş: f. Cevherci, kuyumcu, sarraf.
gevher-î pend: Nasihat küpesi.
gevher-nîsar: f. Cevher serpen. * Mc: Düzgün konuşan, güzel söz söyleyen.
gevher-nîşîn: f. Cevherlerle süslenmiş.
gevher-paş: f. Mücevher saçan. * Mc: çok güzel ve düzgün konuşan.
gevher-şînas: f. Cevherden anlıyan, cevherci, kuyumcu.
gevher-tab: f. Altun ve mücevherlerle işlenmiş kadın eşarbı.
gevherî: f. Kuyumcu, cevherci.
gevherîn: f. Mücevher gibi. * Mücevherli.
gevsale: f. Bir yaşına girmiş sığır yavrusu.
gevz: f. Ceviz.
geylanî ªÿ™ƒ›ÿ: Seyyid Abdulkadir-i Geylani, Gavs-ül A'zam, Gavs, Kutub gibi mecâzi nâm ile bilinen bu zât (Hi: 470-561) yılları arasında yaşamış ve Kadiri Tarikatının müessisidir. Müteaddid müridlerinden bir çoğu sonradan veli olarak meşhurdurlar. Derslerinin te'siriyle birçok Hristiyan ve Museviler Müslüman olmuşlar, ruhâni feyze ermişlerdir. Aktab-ı Erbaa'dan sayılır. (R.A.)
gez: f. Arşın, endaze. * îlgın ağacı. * Okun çentiği. * Tâlim için yapılmış kısa ok.
geza: f. Isırıcı, ısıran.
gezend: f. Musibet, belâ, felâket, âfet. * Elem, keder, hüzün. * Zarar, ziyan.
gezîde: f. Isırılmış, dişlenmiş.
gibb: Nihayet, son, netice. * îki günde bir. Gün aşırı. * -den, -dan, sonra mânâlarına gelir ve birleşik kelimeler yapılır.
gibb-ed duâ: Duâdan sonra.
gibb-eş şehâde: şâhitlikten sonra.
gibb-et tahkîk: Tahkik ettikten sonra.
gibben: Nâdiren, seyrek, arasıra.
gibta •„’œ: îmrenme. Aynı iyi hâli isteme. şiddetle başkasının güzel bir halinin kendisinde de olmasını arzu etme.
gibta-âver: f. Gıbta ettiren, imrendiren.
gibta-fermâ: f. Gıpta verici, imrendirici.
gibta-keş: f. îmrenen, gıpta eden.
gibta-resâ: f. îmrendirici, gıpta ettirici.
gida •šƒ£: Besleyici madde. Vücuda lâzım olan yenecek ve içilecek şeyler. * Kuşluk vakti yenen yemek. * Zihni ve kalbi olgunlaştıracak Kur'an ve iman ilmi ve Allah'a ibadet ve taat.
gida-yi ruh: Ruhun gıdası.
gidaî •šƒ¡ÿ: Gıda olabilen. Gıda cinsinden.
gifare: Kat kat bulut. * Başa örtülen bez parçası. * Yama.
gilab: Birbirine galip olmasını dilemek.
gilaf •™ƒ–: Kın. Kılıcın kılıfı. Bir şeyin üzerinin örtüsü.
gilaf-i latîf: Lâtif örtü.
gilaf-i seyf: Kılıç kını.
gilal •™ƒ™: (Bak: Galâl)
gilale: (C: Galâyil) Zırh altına giyilen kısa gömlek. * Küçük kaftan zıbını.
gilaz: Yoğunluk, koyuluk.
gilaz •™ƒ“: (Galiz. C.) şedid. Sert. Kalın ve kaba şeyler.
gilbit: Taşsız yer.
gildirgiç: Mücellit ıstılahlarındandır. Kitapların kenarlarını kesmeğe mahsus, rende biçiminde bir âlettir.
gilk: Acip ve garip. * Zahmet, meşakkat, güçlük.
gill: Düşmanlık, garaz ve adavet, gizli kin ve haset.
gill u giş •™‚‚•: Aklın muhtelif fikirler üzerinde kararsızlığı. * Gönül darlığı. * Kin ve hile. Hıyanet ve adavet.
gillîm: Cimâı şiddetle arzu eden.
gilman •™šƒ›: (Gulâm. C.) Bıyığı yeni bitmiş gençler. * Cennet'te hizmet gören delikanlılar. * Köleler, esirler.
gilman ü cevarî: Köleler ve cariyeler.
gilman-i enderun: Tar: Topkapı Sarayı (Yenisaray) iç oğlanları hakkında kullanılan bir tabirdir. Bunlar derece ve hizmet itibariyle başka başka odalara ayrılmışlardı.
gilman-i hassa: Tar: Padişahların hususi köleleri. Bunlara ilk zamanlarda "îç oğlanları", daha sonları da "îç ağaları" da denilirdi. Bunlar, "Enderun-u Hümayun" denilen ve sarayın Babussaade'den içeride bulunan kısmında hizmet ederler; derece ve hizmet itibariyle başka başka odalarda otururlardı. Bu odalar; Büyük ve Küçük Odalar, Doğancı Koğuşu, Seferli Odası, Kiler Odası, Hazine Odası adlarını taşırlardı.
gilme: (Gulâm. C.) Delikanlılar, gençler. * Esirler, köleler.
gilt: Akdolunan pazarlığı bozmak.
gilzet: Kabalık, sertlik. * Kalınlık, galizlik.
gilzet-î mîzac: Huy ve mizac sertliği.
gimar •šƒœ: (Gamr. C.) Gaflet. Cehalet. şiddetler. çok su. Büyük denizler. * (Gımr. C.) çok susuzluk. * Kin tutma.
gimd: (C.: Agmâd) Kılıf, kın, mahfaza. * Bakla, bezelye, fasulya ve benzerleri gibi şeylerin kabuğu.
gina •›ƒ£: Zenginlik. Yeterlik. * Tok gözlülük. * Mülâki olmak. Bir kimseye dostluğunda devamlı olmak. * Bıkma, usanç. * şarkı söylemek. Teganni etmek.
gira: (Garrâ) Tutkal.
girajova ateşî: Tar: Eskiden kale müdafaalarında hücum edenlere karşı ve deniz savaşlarında düşman gemilerini tutuşturmak için kullanılan ve su ile sönmeyen bir cins ateş. Balmumu, kükürt, ispirto, kâfuru karmasından ibarettir. Bu ya doğrudan doğruya tutuşturulur veya buna batırılmış yuvarlak yün parçaları ateşlenerek atılırdı.
girandî dîreğî: Geminin ortasındaki en büyük direk. Bu yekpâre olmayıp üst üste dört direkten mürekkepti.
girar: Devenin sütünün azalması. * Az uyku. * Miktar. * Cihet, Misâl. * Yol. * Birbiri ardınca olmak. * Her nesnenin kenarı. * Büyük kıl çuval.
giras: Ağaç budağı. * Ağaç dikecek vakit.
girbal: (C.: Garâbil) îri delikleri olan elek, kalbur.
girban: (Gurâb. C.) Kargalar.
girbin: Selin getirdiği çamur.
girbîl: Havuzun dibinde kalan balçıklı su. * Bardak ve şişenin dibinde olan tortu.
girgira: (C.: Garâgır) Yaban tavuğu.
girizî: (Bak: Gariziye)
girîv: f. Bağırma, feryat etme, çığlık atma, bağrışma.
girk: çok, kesir.
girkî: Yumurta kabuğu.
girnevk: (C: Garânik-Garânika) Su kuşlarından boynu uzun bir kuş. Telli turna. Kuğu kuşu.
girr: îşten anlamayan ahmak kişi.
girre •œœ: Gaflet. Boş bir şeye aldanan. * Tevbeyi sonraya bırakıp, aldanan. övünen, gururlu. Gâfil. îşe yaramaz.
girs: (C: Egrâs) Dikilmiş ağaç. * çocukla birlikte anadan çıkan ince deri.
gislîn: Yara yıkandığında içinden çıkan irinli ve kanlı su. * Cehennem ehlinin etleri ve kanlarının yıkandığı nesne.
gişa •ƒ£: örtü, perde. * Zar. Deri. Kabuk. * üst tabaka. * Zarf. Mahfaza.
gişa-yi tablî: Tıb: Kulak zarı.
gişaş: Az, kalil. * Evmek, acele.
gişavet •ƒ : Göz kararmak. * Körlük yapan perde. Kabuk. * Baş örtüsü.
gişş: Hıyânet etmek, hâinlik yapmak. * Yaramaz olmak. * Saf olmayıp karışık olmak.
gişyan: Bürünmek, örtünmek. * Cimâdan kinâye olur.
gita •ƒ : örtü. örtünecek şey. Perde.
gita-yi basar: Göz perdesi.
gita-yi rakîk: înce örtü.
gitarres: (C: Gatâris) Zâlim, mütekebbir, kibirli kimse.
gitrîf: (C.: Gatârif) Başkan, reis. * Asil ve itibarlı kimse. Soylu kişi.
gitrîf: Mütekebbir, gururlu, kendini beğenmiş.
giyab •ÿƒ„: Görünmemek. Göz önünde olmamak. * Hazırda bulunmamak. * Bilinmeyen şeyler. * Arka. Arkasından.
giyabe: Derinlik, dip.
giyaben: Bulunmadığı halde. Mevcut ve hazır olmaksızın. * Mahkeme veya duruşmada olmadan.
giyabî •ÿƒ„ÿ: Arkasından olarak. Kendi hazır olmadığı halde arkasından. Gayba âit. Gayba mensup ve müteallik.
giyar: Keçe. * Ehl-i zimmetin nişanı.
giyas •ÿƒ†: Medetkâr. Yardımcı. Nusrete yetişen. * Meded. Yardım.
giyas-üd dîn: Dinin intişar etmesine yardımı dokunan kimse.
giyasa: Suya dalmak.
giybet •ÿ„…: Arkadan çekiştirmek. Hazır olmayan birisinin aleyhine konuşmak. Birisinin gıyabında hoşuna gitmeyen bir şeyi söylemek. (Gıybet odur ki: Gıybet edilen adam hazır olsa idi ve işitse idi, kerâhet edip darılacaktı. Eğer doğru dese; zâten gıybettir. Eğer yalan dese; hem gıybet, hem iftiradır. îki katlı çirkin bir günahtır. M.)(Gıybet, mahsus birkaç maddede câiz olabilir:Birisi: şekva suretinde bir vazifedar adama der, tâ yardım edip o münkeri, o kabahati ondan izale etsin ve hakkını ondan alsın.Birisi de: Bir adam onunla teşrik-i mesâi etmek ister. Senin ile meşveret eder. Sen de sırf maslahat için garazsız olarak, meşveretin hakkını edâ etmek için desen: "Onun ile teşrik-i mesâi etme. çünki zarar göreceksin."Birisi de: Maksadı, tahkir ve teşhir değil, belki maksadı, târif ve tanıttırmak için dese" "O topal ve serseri adam filân yere gitti."Birisi de: O gıybet edilen adam fâsık-ı mütecahirdir. Yâni fenalıktan sıkılmıyor, belki işlediği seyyiatla iftihar ediyor; zulmü ile telezzüz ediyor; sıkılmıyarak âşikâre bir surette işliyor.îşte bu mahsus maddelerde garazsız ve sırf hak ve maslahat için gıybet câiz olabilir. Yoksa gıybet, nasıl ateş odunu yer bitirir; gıybet dahi a'mâl-i sâlihayı yer bitirir.Eğer gıybet etti veyahut istiyerek dinledi; o vakit $ demeli, sonra gıybet edilen adam ne vakit rast gelse: "Beni helâl et." demeli... M.)
giyer: Halden hale dönmek.
giza •‹£: Gıda, besin. (Bak: Gıda)
gîl: (C: Guyul) Meşelik ve çalılık yer. * Arslan yatağı. Arslanların bulunduğu yer.
gîl: f. Su ile ıslanmış toprak, balçık. Lüleci çamuru, kil.
gîl-zar: f. çamurlu yer.
gîle: f. îki dağ arasındaki yol, vadi. * şikâyet. * üzüm tanesi.
gîle: Bir kimseyi aldatıp bir yere götürüp öldürmek.
gîlîger: f. Duvarcı, sıvacı. * çamurcu.
gîlle-mend: f. şikâyet eden, halinden memnun olmayan.
gîn ªÿ›: f. Türkçedeki "li, lu, lı" eklerinin karşılığıdır.
gîne: Leşten akan murdar sarı su.
gîr ªÿœ: f. (Giriften) "Tutmak, yakalamak" mastarının emir köküdür. Türkçedeki: yapan, tutan, tutucu, dağılan, yayılan gibi mânalara gelir. Kelimenin sonuna eklenir.
gîra: f. Müessir, te'sir eden, tutucu.
gîra-gîr: f. Tutan tutana.
gîramî: f. Muhterem, aziz, hürmete değer. * Ulu, büyük.
gîran ªÿœƒ›: f. Pahalı. Tartısı ağır olan. Ağır. Dolu. * Sert. Katı. * Bıktırıcı. Usandırıcı.
gîran-baha ªÿœƒ›‚„ƒœƒ: f. Kıymet ve pahası çok olan.
gîran-bar: f. Meyvesi çok olan ağaç. * Ağır yüklü. * Gebe insan veya hayvan. * Zengin, gani.
gîran-can: f. Ağır kanlı, ağır hareketli, can sıkıcı (adam).
gîran-canî: f. Can sıkıcılık.
gîran-dest: (C.: Girandestân) f. îşini ağır yapan kimse. Eli ağır kişi.
gîran-destmaye: f. Zengin, gani. Sermayesi ve malı mülkü çok olan. * Mârifetli, mahâretli, hünerli.
gîran-dud: f. Duman, sis. * Kara bulut.
gîran-guş: (C.: Giranguşân) f. Sağır, kulağı ağır işiten.
gîran-guşâne: f. Sağırcasına.
gîran-hab: f. Uykusu ağır olan adam.
gîran-har: f. Obur, çok yiyen.
gîran-hatir: f. Canı sıkılmış, gücenmiş.
gîran-huy: f. Fena mizaçlı. Kötü huylu.
gîran-kadr: f. Kadr u itibar sahibi. Hürmet edilen kimse.
gîran-kîse: f. Cimri, hasis, pinti.
gîran-maye: f. Kıymetli ve değerli olan şey.
gîran-rîkab: f. Ciddi ve vakur kimse. * Harpte düşmana saldıran, azimli kişi.
gîran-saye: f. Yüksek makam ve mevki sahibi. * Ordu kumandanı.
gîran-seng: f. Ağır başlı kişi. Ciddi ve vakar sahibi kimse. * Sabırlı, kanaatkâr.
gîran-ser: (C.: Giranserân) f. Mağrur, kibirli, gururlu, kendini beğenmiş.
gîran-serî: f. Kibirlilik, mağrurluk, enaniyetli oluş, kendini beğenmişlik.
gîran-seyr: (C.: Giranseyrân) f. Hareketleri ve yürüyüşü ağır olan.
gîran-sîrîşt: (C: Giransiriştân) f. Tembel, ağır tabiatlı, ağır kanlı.
gîranî: f. Ağırlık, sıklet.
gîrd: f. Yuvarlak.
gîrd-alud: f. Toz toprak içinde kalmış, toza bulanmış.
gîrd-gâr ªœšªƒœ: f. Allah.Yaratıcı. Kudret sahibi. (Bak: Kird-gâr)
gîrda-gîrd: f. Fırdolayı, çepeçevre.
gîrdab ªœšƒ„: f. Suların dönerek çukurlaştığı yer. * Tehlikeli yer. Mühlike. Tehlikeli yer ve zaman.
gîrdar: f. Meşgale, meşguliyet. * Tarz, âdet, yürüyüş.
gîrde: f. Yuvarlak, değirmi. * Evvelce yahudilerin, müslümanlardan ayırd edilebilmeleri için, omuzlarına diktikleri sarı renkte bir parça. * Açılmış yufka. * Yuvarlak yastık. * Gr: Bütün, hepsi, tamamı.
gîrdeban: f. Gözcü, gözetici.
gîrdîbad: (Gird-bâd) f. Kasırga. Yel çevrintisi. Tehlike. Girdap.
gîrdu: f. Ceviz.
gîre: (C: Guyer) Diyet.
gîrgîn: Her yere sokulan, herkesle görüşen, sokulgan. * Mensub, alâkalı, müteallik.
gîrîban: f. Elbise yakası.
gîrîban-çâk: f. Yakası yırtık. * Mc: Kederli, hüzünlü, üzüntülü. 
gîrîban-gîr: f. Yaka tutan.
gîrîbanî: f. Bir çeşit gömlek.
gîrîft ªœ–…: f. Yakalama, tutma. * Dolaşık. Birbiri içine girik. Girintili çıkıntılı, karışık. * Motifleri birbirine girik ve içiçe geçme olan tezyinat tarzı. Buna aynı zamanda arabesk de denilir. * Türk musikisinin nefesli sazlarından olup, bugün unutulmak üzeredir. Ney'e benzer. Girift çalana "Giriftzen" denilir.
gîrîftar ªœ–…ƒœ: f. Tutulmuş. Yakalanmış.
gîrîfte: f. Yakalanmış, tutulmuş. * Bir hastalığa mâruz kalmış, hastalığa yakalanmış. * Esir.
gîrîfte-dem: f. Nefesi tutulmuş.
gîrîfte-gî: f. Tutkunluk. * Hastalık hali. * Esirlik.
gîrîfte-hâtir: f. Gücenik, kırgın.
gîrîfte-leb: (C: Giriftelebân) f. Dudağı tutulmuş. * Mc: Sessiz, sakin (kimse).
gîrîfte-ser: f. Aklı fikri dağılmış kimse. Dalgın kişi.
gîrîfte-zeban: Kekeme, dili tutuk.
gîrîh: f. Bağ, düğüm.
gîrîh-bend: f. Bağcı, düğümcü. * Uçkur.
gîrîh-bür: f. "Düğüm kesen". Yankesici.
gîrîh-gîr: f. Düğümlü, dolaşık.
gîrîh-küşa: f. Düğüm açan, bağı çözen. * Mc: Müşkülâtları yenen, zorlukları halleden.
gîrîhçe: f. Küçük düğüm, düğümcük.
gîrîs(e): f. Oyun, hile, dalavere.
gîrîşme: f. îşve, naz, cilve. Gözle kaşla işaret.
gîrît madalyasi: Tar: Biri Sultan Aziz diğeri Sultan II.Abdülhamid devrinde olmak üzere ihdas olunan madalyalar. Her ikisinin de altun ve gümüş olmak üzere iki türlüsü vardı. Girit işinde hizmeti görünen devlet ricaline altun, ikinci derecedeki memurlarla halka, gümüş olanı verilirdi. (O.T.D.S.)
gîrîve ªœÿœ: (Girve) f. çıkmaz yol. çıkmaz sokak. * îçinden çıkılması müşkül olan durum.
gîrîzgâh ªœ˜ƒœ: (Bak: Gürizgâh)
gîrîzîye: (Bak: Gariziye) 
gîrudar: f. Savaş, muharebe, cenk, cidâl, kavga.
gîryan ªœÿƒ›: f. Gözyaşı döken. Ağlayan.
gîrye ªœÿœ: f. Gözyaşı.
gîrye-bar: f. Gözyaşı döken, ağlayan.
gîrye-dar: f. Ağlamış, göz yaşı dökmüş.
gîrye-engîz: f. Ağlatacak sebep, ağlamaya sebep olan.
gîrye-feşan: f. Acıklı acıklı ağlayan, gözyaşı saçan.
gîrye-feza: f. çok ağlatan, ağlamayı artıran.
gîrye-î şâdî: Sevinçten dolayı olan ağlama. Sevinç gözyaşı.
gîrye-künan: f. Gözyaşı dökerek, ağlayarak.
gîrye-meşhun: f. Gözyaşı ile dolu.
gîrye-nak: f. Ağlayan, gözyaşı döken. Ağlayıcı.
gîrye-nümud: f. Ağlar gibi görünen, ağlamışa benziyen.
gîrye-paş: f. Ağlayan, gözyaşı döken.
gîrye-perverd: f. Ağlatıcı, gözyaşı döktüren, ağlamayı getiren.
gîrye-rîz: f. Gözyaşı döken, ağlayan.
gîrye-zar: f. Oturup ağlanılan, gözyaşı dökülen yer.
gîryende: f. Ağlayan, gözyaşı döken.
gîsu: f. Uzun saç, omuza dökülen saç.
gîsu-bend: f. Saç örgüsü, saç bağı. * Altundan yapılmış kadın tarağı.
gîş: f. Kalb, yürek.
gîşe: Fr. Tren istasyonu, vapur iskelesi ve mağaza gibi yerlerde bilet veya paranın alınıp verildiği yer.
gîtî ª…ÿ: f. âlem, dünya.
gîtî-ban: f. Hükümdar, padişah.
gîtî-fürz: Dünyayı aydınlatan.
gîtî-neverd: f. Dünyayı gezen, dünyayı dolaşan.
gîtî-nüma: f. Dünyayı gösteren, cihanı gösteren.
gîtî-sîtan: f. Dünyayı zapteden, cihangir. 
gîya-zar: f. çayır, çimenlik, otluk.
gîya(h): f. Nebat, bitki.
gîyotîn: Fr. Eskiden Fransa'da idam cezalarının infazı için kullanılan, kafa kesmeye yarar âlet.
gîzlîk: f. Uzun saplı kalemtraş. * Bıçak, çakı, kılıç gibi şeylerin keskin olan tarafı.
gladyatör: Eskiden Roma sirklerinde vahşi hayvanlarla veya birbirleriyle boğuşan kimse.
golfstrîm: ing. Atlas Okyanusunda, Meksika Körfezinden başlayarak Norveç kıyılarından Avrupa Rusyası'nın kuzey kıyılarına kadar gelen ılık bir deniz akıntısı.
gonce •›ˆœ: f. Gonca. Tomurcuk. çiçeğin açılmamış durumu.
gonce-î âb: Yağmur yağarken suyun yüzünde meydana gelen kabarcık.
göden: Kalın barsağın son kısmı.
gökdelen: t. Yirmi veya daha çok katlı bina.
gön: Tabaklanmış deri, her çeşit meşin, sahtiyan vesaire.
gönder: Tar: Seferde ordunun ve ileri gelen vezir ve diğer devlet ricalinin atlarına bakmak ve sair zamanlarda ise has ahır ve çayır hizmetlerinde kullanılmak üzere gayr-ı müslimlerden ve hasseten Bulgarlardan tertip edilmiş bir sınıf olan voynukların her mıntıkada iki, üçü ve dördü hakkında kullanılır bir tâbirdir. * Ucuna birşey takılan uzun sopa veya sırık. Kullanış şekline göre isim alır: Bayrak, sancak gönderi. * çift sürerken öküzleri dürtmekte kullanılan ucu iğneli uzun sopa. * Sancak çekmek için geminin kıç tarafındaki direğe gönder denildiği gibi, mavnayı yürütmek için kıyıya veya suyun dibine dayatılan sırığa da gönder adı verilir.
götürü: Tartı veya ölçü ile olmayarak, toptan ve kesin olan.
göynük: Arpa torbası. * Ufak süt kabı. * Kıldan yapılmış yoğurt torbası.
göz boyamak: t. Mc: Aldatmak, hileye düşürmek.
gözdaği: t. Mc: Birini istenilen yola getirmek için samimi olmayan şiddet gösterişleriyle korkutmak ve tehdit etmek.
grafîk: yun. Bir hâdisenin gidişatını göstermek, birkaç şey arasında karşılaştırma yapmak için çizgi ve şekillerle yapılan rakamlı cetvel.
gramer •œƒšœ: Fr. Cümlelerin, kelimelerin, hecelerin ve harflerin hallerinden bahseden ilim. Dil bilgisi.
granît •œƒ›ÿ…: Fr. Jeo: Muhtelif renklerde çok sert bir çeşit taş.
grev: Fr. îşçilerin isteklerini işverene kabul ettirmek için, işlerini hep birlikte bırakmaları.îslâmiyette işçi hakları çok ciddi korunmakla beraber, grev ve benzeri hareketlere başvurulması istenmez. çünki grev, milli gelire zarar verdiği gibi, sosyal grupları doğurmakla boğuşmalarına ve dolayısıyla da milli huzura zarar getirir. Grev, daha çok kapitalist sistemlerin "Hak, kuvvettedir" şeklinde ifade edilen Avrupa'nın medeniyetindeki olumsuz düsturlarının bir sonucudur. Ve bir işçinin işverenle iktisadi müsabaka edemediğinden, işçiler birliği kurulmasıyla işverene karşı güçlü olmasına kapitalist sistem itiyor. Halbuki îslâmda kişi, kendi küçük gücüyle başbaşa bırakılmamıştır. çünki "hak kuvvettedir" kaidesinin yerine; îslâm, "kuvvet haktadır" der. îşçi haklı ise, devletin gücü işçinin yanında olur. Bununla beraber îslâm, müsbet müsabaka prensibini de kaldırmaz. Ancak taraflar arasında hukuk ve adaletle nezaret eder.
gubar •„ƒœ: Toz.
gubar-âlud: f. Tozlanmış, toza bulanmış. tozlu.
gubare: f. Sığır ağılı, mandıra. * Sığır sürüsü.
gubarî: Eski harflerle yazılan bir çeşit ince yazı. Bu isim Arapça toz demek olan gubardan alınmıştır. Yazı, toz gibi ince yazıldığı için bu adı almıştır. Eski Türk devletlerinde güvercin postalarıyla gönderilen mektuplar bu yazı ile yazılırdı. (O.T.D.S.)
gubbe: Tavşancıl kuşunun yavrusu.
gubeyra: Yaban iğdesi. * Habeş vilâyetinde darıdan yapılan bir cins şarap.
gubre: Toprak renkli olmak.
gubşe: Toprak renkli omak.
gucme: Kabın dibinde kalan su.
gudaf: (C.: Gudfân) Kuzgun.
gudat •‘ : Ayıp, zillet, noksanlık. * Ter u taze olmak.
gudde •šœ: Tıb: Bez. Vücudun muhtelif yerlerinde, hususan boyunda bir nevi vücuda lazım su çıkaran depocuk. şiş.
gudde-î arakiyye: Ter bezi.
gudde-î luâbîye: Tükrük bezi.
gudde-î mîdevîye: Mide bezi.
gudde-î nekfîyye: Tıb: Kulak memesinden çeneye kadar olan kısımda bazan ufak ufak meydana gelen bezler.
gudde-î taht-el lîsan: Dilaltı bezi.
gudek: f. çocuk, tıfl.
gudekâne: çocukçasına.
gudruf: (C.: Gadârıf) Kıkırdak, kıkırdak kemiği.
gudruf-u halkavî: Tıb: Kıkırdak halka.
gudüvv •š: Sabah vakti. * Sabahleyin bir şeye başlamak.
gudve: (C: Gudevât) Sabah namazı vakti ile güneşin doğuşu arası.
gufl: Belirsiz, işaretsiz.
gufr: (C: Egfâr) Dağ keçisinin oğlağı. * Hastanın iyi olduktan sonra yine üzülüp hasta olması.
gufran •–œƒ›: Cenab-ı Hakk'ın günahları affedip örtmesi, rahmeti.
guful: Dikkatsizlikten veya şaşırmaktan dolayı bir işte hata yapma.
gugîrd: f. Kükürt.
guh: f. Pislik, necâset.
guk: f. Kurbağa.
gul ª™: f. Safdil, ahmak, bön, sersem.
gul •™: Boş ve virane yerlerde bulunan ve helâk edici olan bir cin tâifesi. îfrit, hortlak. * ölüm. * Belâ.
gulam •™ƒš: Genç, delikanlı. Bıyığı henüz bitmemiş genç. * Esir, hizmetçi, köle.
gulame (gulme): Cima arzusu.
gulamîye: Tar: Cizye ve diğer vergileri tahsil edenlerin topladıkları paraların hazine veznesine teslim edilişi esnasında cizye veya vergi harç pusulalarının her biri için kendilerine verilen tahsil âidatı.
gulampare: Dost, sevgili, mahbup. (Halk ağzında kulampara şeklinde kullanılır.)
gulan: Tadı ekşi olan ilâçlar.
gulane: f. üstün bir gayretle. Yüksek bir himmetle.
gulat •™ƒ…: (Gali. C.) Dinde, mezhebte çok ileri salâbet gösterenler. * Galeyân edenler.
gulaz: Kalın, kaba.
gulet: Fr. îki direkli ve yan yelkenli gemi.
gulf •™–: (C.: Eglaf) Kılıf. Kışır, kabuk.
gulfe: Zekerin sünnet edilecek derisi.
gulgul(e): Bağrışıp çağrışma. şamata, gürültü. Velvele. * Ağız tarafı dar olan bir kabdan akan suyun çıkardığı ses.
gulgule-î etfal: çocukların gürültüsü, çocukların bağrışıp çağrışmaları.
gull •™: Kelepçe. Suçlunun boynuna veya ayaklarına takılan zincir, pranga.
gullet •™ : Sıcaklık. * Susuzluk harareti.
gulul •™™: Ganimet malında hıyanet etmek.(Gull, mâli ganimetten gizli birşey aşırmak, emanete hıyanet etmektir ki, ekseriyetle devlet mallarında su-i istimâl de bu türdendir. Resulullah, gululü kebairden saymıştır. E.T.)
gulumîyye: Cimaa şehveti olan kimse.
gulüf: (Gılâf. C.) Kınlar, mahfazalar, kılıflar.
gulüvv: Ayaklanma. Taşkınlık. * üşüşme. Hücum. Saldırış. * Edb: Mübalağanın son derecesi. üçe ayrılan mübalağanın diğer iki derecesinden biri tebliğ, öteki iğraktır. Aşağıdaki parçada mübalağa gulüv derecesindedir: Gökler gürüldese, şimşekler çaksa Volkanlar fışkırsa, lâvları aksa,Kıyısız denizler kabarsa, coşsa,Coşkun dalgaları birden tutuşsa, Yerden gökyüzüne alevler ağsa,Gökten yeryüzüne yıldızlar yağsa,Arzın içindeki ateş patlasa,Küreler yarılsa, feza çatlasa,Bir yürek bulunur, korkudan beri,Anladın mı kimdir o? Türk Askeri.
gulüvv-î âmm: Genel ayaklanma, umumi isyan.
gulv: Haddini tecavüz etmek, haddini aşmak. * Yiğitlik zamanının evveli ve sür'ati.
gulyabanî: însanı felâkete attığına itikad edilen vahşi bir mahluk ismi.
guma: Hava bulutlu olduğundan ayın görünmemesi.
gumgume: Nâra. * Avaz, ses.
gumme: Tasa, keder. * Kırba, tuluk gibi şeylerin derinliği. * Belirsiz mühim nesne.
gumr: (C: Agmâr) Bön, ahmak kişi. Gafil kimse.
gumre: Kadınların yüzlerine örttükleri kırmızı bez. * Küçük kadeh.
gumum: (Gamm. C.) Tasalar, kederler, dertler, kaygılar, hüzünler.
gumuz •š‘: Sözün kapalı ve karışık oluşu.
gun: f. Tarz, gidiş, sıfat. * Renk.
guna-gun ª›ƒ‚ª›: f. Türlü türlü, renk renk. Alaca.
gunc: Eda, naz, kırıtma, cilve.
gune: f. Tarz, gidiş, yol, tarz. Sıfat.
gune gune: f. Türlü türlü, çeşit çeşit, renk renk.
gunm: Bir şeye meşakkatsiz nâil olmak veya düşmandan doyumluk almak mânalarına gelir ve alınan doyumluğa da isim olarak ıtlak olunur ki ganimet de, her iki mânada böyledir. şeriatta ise ganimet, küffardan anveten, yani harben alınan maldır. Binaenaleyh, velevse harbin neticesi olsun bir sulh ve ahd ile alınan mallara ganimet denilmez. (E.T.)
gunne •›œ: Genizden söylemek, sesi burnundan çıkarır gibi okumak. Burundan gelen ses.(Tecvidde harfin vasıflarındandır) (Bak: îdgam)
gunya: f. Geometride kullanılan bir âlet. Gönye.
gunyan: Kimseye ihtiyacı olmayıp müstağni olmak.
gunyat: Kudret, zenginlik.
gunyet •›ÿ : Zenginlik.
gunz: Tasa, keder. * Zahmet, meşakkat.
gur: Kabir, mezar. * Meşhur pehlivan Rüstem-i îraninin lâkabı. * Yaban eşeği.
gur-hane: f. Türbe.
gur-ken: f. Mezarcı, mezar kazan.
gurab: (C: Garbân-Egribe) Karga.
gurab-ül beyn: Alaca karga.
gurabe: f. Kubbeli türbe.
guraf: Büyük ölçek.
gurbet •œ„ : Gariblik, yabancılık. Yabancı bir memleket. Yabancı yer. Yâd el.
gurbet-zede: f. Memleketinden başka yerde bulunan, gurbete düşmüş olan.
gureba •œ„ƒ£: (Garib. C.) Garibler.
gureba-î yemîn: îbrahim paşa, Galata ve Edirne saraylarından çıkanlarla, harpte fevkalâde yararlık gösteren yabancılar ve yeni Müslüman olmuşlardan teşkil olunan iki süvari bölüğünden birinin ismidir. Bu iki bölüğe birden "Gureba-i Yemin ve Yesar Bölükleri" denildiği gibi "Garip ve Yiğitler Bölükleri" veya "Aşağı Bölükler" de denilirdi. Gureba-i Yemin'in bayrakları sarı ile beyaz idi. (O.T.D.S.)
guref: (Gurfe. C.) Köşkler, kasırlar, çardaklar.
gurema •œšƒ£: (Gerim C.) Düşmanlar, adüvler, hasımlar, rakibler. * Alacaklılar.
gurer: Her ayın ilk üç gecesi.
gurfe •œ–œ: Yüksek, âli bina. * Yüksek derece. * Cennet köşkleri.
gurfe-î âlîye: Yüksek çardak. Yüksek köşk. * Balkon, cumba.
gurgure: Atın alnında olan beyazlık. * Ulu, şerif kimse.
gurîstan: f. Mezarlık, türbe. Kabristan.
gurl: Sünnet olmamış kimse.
gurle: Sünnet olunacak deri.
gurm •œš: Bir kimse üzerine eda edilmesi, yerine getirilmesi lâzımgelen şey. Borç ve diyet gibi. (Garâmet de olur)
gurmul: (C: Garâmil) Erkek eşek. * At zekeri.
gurr •œ: Beyaz leke.
gurran: f. Haykıran, gürleyen, homurdayan.
gurre •œœ: Parlaklık. Her şeyin başlangıcı. Bu cihetle, kameri ayların ilk günlerine gurre-i şehr denilmiştir. Köleye, cariyeye ve malların en güzidelerine, gurret-ül emval denir. Güzel parlak yüze, vech-i agarr; açık ve nurani alına, cebhe-i garra denir ki, aynı asıldan müştaktırlar. * Fık: îskat edilen (düşürülen) bir ceninden dolayı verilmesi icab eden mali bir tazminattır. Hanefilerce 500, şafiilerce 600 dirhem gümüştür.
gurre-î garra: Bir günlük hilâl.
gurre-î muharrem: Arabi aylardan olan Muharrem ayının birinci günü ve gecesi.
gurrende: f. Hiddetle bağıran, şiddetle gürliyen.
gurub •œ¨: Batma, batış. Batıda görünmez olma. Gözden kaybolmak. * Uzaklaşmak. Irak olmak.
gurub-u şems: Güneşin batması.
gurur •œœ: Kibir. Boş yere güvenmek. * Kıymetsiz şeylere güvenip mağrur olmak.(Evet, gurur ile insan maddi ve mânevi kemalât ve mehâsinden mahrum kalır. Eğer gurur saikasıyla başkaların kemalâtına tenezzül etmeyip, kendi kemâlâtını kâfi ve yüksek görürse, o insan nâkıstır. Böyle insanlar, malumat ve keşfiyatlarını daha yüksek görmekle, eslâf-ı izamın irşâdat ve keşfiyatlarından mahrum kalırlar. Ve evhama mâruz kalarak bütün bütün çizgiden çıkarlar. Halbuki eslâf-ı izâmın kırk günde yaptıkları bir keşfiyatı, bunlar kırk senede bulamazlar. M.N.)
gurve: Burnun ucundaki kıkırdaktan yapılmış yumuşak kısım.
gurz (gurza): (C: Guruz-Ağraz-Guraz) Su taksim olunan yer. * Eyer kolanı.
gurze: (C.: Guruz) Pamuklu elbisede kullanılan kaba dikiş.
gurzuf: Kıkırdak. * Yumuşak olan kemik.
gusa' •†ƒ£: Sel köpüklerine karışmış çürük ağaç yaprakları tortusu, köpüğü.
gusale: Yıkama suyu.
gusale: f. Dana, buzağı. Sığır yavrusu. * Kösele.
gusas: (Gussa. C.) Kederler, hüzünler, kaygılar, tasalar.
gusfend: f. Koyun. (Bak: Guspend)
gusl: (Bak: Gusül)
gusn •ž›: Saç örgüsü.
gusn •›: Ağaç dalı. Budak. * Tıb: Damar ve sinir gibi ayrılan bedenin cüzleri.
gusn-î meksur: Kırılmış dal.
gusn-î şecer: Ağaç dalı.
gusne: Tek dal.
guspend: f. Koyun, ganem.
guspend-güşân: f. Kurban bayramı.
gusre: Yeşile benzer bozrak renk.
guss: Leim, zayıf adam. * Bir şeyi beğenmeyip ayıplamak.
gussa •œ: Keder. Tasa. *Gam. * Boğaza takılan yemek. * Ağaç, diken.
gussadâr: f. Kederli, tasalı. Kaygılı. Gussalı.
gussanâk: f. Kederli, hüzünlü, tasalı, kaygılı.
gusun: (Gusn. C.) Filizler, ağaç dalları.
gusül •ž™: Boy abdesti. Temizlenmek. Maddi, manevi temizlik için şartları dahilinde yıkanmak. Taharet-i Kübrâ da denir.
gusv: Zulmet, karanlık.
guş: f. Kulak. * Mc: îşitmek.
guş-asb: f. Rüya. * îhtilam. Uyurken cenabet olmak.
guş-dar: f. "Kulak tutan." Sözü tam mânasıyla dinleyen, kulak veren.
guş-hurde: f. Kulağı bükülmüş, terbiye edilmiş.
guş-î can ª‚‡ƒ›: Can kulağı.
guş-î huş: Akıl kulağı. Can kulağı.
guş-î kabul-î can ª‚—„™‚‡ƒ›: Candan kabul ile dinlemek.
guş-var: f. Küpe, kadınların kulaklarına taktıkları mücevher.
guş-zed: f. Kulağa çarpan, işitilen.
guşab: f. Pekmez.
guşane: Düşürülmüş hurma. * Hurma ağacı altına düşüp toplanan hurma.
guşe: f. Köşe, kenar, bucak.
guşe-bend: f. Köşebent. * Ciltli kitaplarda kapağın dört köşesine yapılan süsleme.
guşe-gîr: f. Bir köşeye çekilen.
guşe-î dehan: Ağzın iki tarafı.
guşe-î uzlet: Tenha ve ıssız köşe.
guşe-nîşîn: f. Köşeye çekilen, münzevi, insanlardan uzaklaşan.
guşetmek ª‚ƒÿ…š˜: îşitmek. Dinlemek, kulak vermek, mesmu' olmak.
guşîş: f. çabalama, uğraşma, çalışma.
guşmal: f. Yola getirme, te'dib etme, kulak bükme, ihtar etme.
guşt: f. Et, lahm.
guştîn: f. Etten, etten ibâret, etten meydana gelmiş.
gutat: Sabahın erken saatleri.
gute: f. Su içine bir defa dalıp çıkma, suya dalma.
gute-hâr: (Gute-hor) f. Suya dalan.
gutguta: (C: Gatâgıt) Yeni doğmuş kuzu.
gutme: Pelteklik, kekemelik.
guvas: Feryâd edip, "imdat!" diye bağırmak.
guvat: (Gavi. C.) Azgınlar, sapkınlar.
guvl: (C: Agvâl-Gaylân) Cinden bir tâife.
guvr: Bir ölçek. (12 senc miktarıdır: Senc: 24 batmandır.)
guvta: şam diyarında suyu çok olan ağaçlık bir yer.GUY : f. Söyleyen, konuşan, söyleyici. * Kelâm, söz. Acemlere mahsus bir cins oyun topu. * Baykuş.
gu(y): "Diyen, söyleyen" mânâlarına gelir ve birleşik kelimeler yapılır. Meselâ: Rast-gu $ : Doğru söyleyen. Suhan-gu $ : Söz söyleyen, konuşan.
guyî: f. Söyleyiş, söyleme.
guyub •ÿ„: (Gayb. C.) Hazırda olmayanlar. Kayıplar.
guyum: (Gaym. C.) Bulutlar.
guyus: (Gays. C.) Yağmurlar.
guzame: Bir miktar süt.
guzat: (Gazi. C.) Din için harbedenler. Gaziler.
guzat •‘ƒ…: (Bak: Gudat)
guzbe: Tez gadaplanan, çabuk kızan.
guze: f. Koza.
guzn: (C.: Guzun) Derinin büklümü.
guzr: çokluk, kesret. * Devenin sütünün çok olması.
guzruf: (C.: Gazârif) Kulak kemiği. * Kıkırdak.
guzuza: Taze olmak.
guzz: Oğuz Türkleri.
gücük: Kuvvetsiz, zayıf, gevşek.
güdahte: f. Erimiş.
güdaz: f. Mahveden, yakan, eriten mânâlarına gelir ve birleşik kelimeler yapılır. Meselâ: Takat-güdaz $ : Takati mahveden.
güdazende: f. Eriten, eritici.
güdazîş: f. Yakılma, yanma.
güft ª–…: f. Dedi, söyledi. * Söz, kelâm.
güft ü gu ª–…‚ª: Dedi kodu. Kil ü kal.
güft ü şenîd ª–…‚›ÿš: îşitilen şeyler, duyulan şeyler.
güftar ª–…ƒœ: f. Sözler, lâkırdılar.
güfte ª–…œ: Her hangi bir makama göre bestelenen manzume. * Farsça "söylemek" demek olan "güften" mastarından gelen bu tabirin mânası, söylenmiş söz demektir.
güher-füruş: f. Mücevher satan.
güher-pare: f. Mücevher parçası.
güher-rîz: f. Cevher döken, cevher saçan.
güherçîle: Barut yapmaya yarıyan bir madde.
gül: f. Küçük ve dikenli bir ağaçta olup şeklinin ve kokusunun güzelliği ile meşhurdur. şairlere göre bülbülün sevgilisidir. Pek çok cinsi vardır.
gül-bağ: f. Gül bahçesi, gülistan.
gül-fâm: Gül renkli.
gül-î hamrâ ª™‚ˆšœÿ: Kırmızı gül.
gül-î ruhsar ª™‚œ‰žƒœ: f. Gül yanaklı. * Mc: Mânevi çok güzellik sahibi. çok sevilen.
gül-î zemîn: Meşveret meclisi.
gül-nîkab: f. Yüzü gülle örtülü, pembe yüzlü.
gül-ü muhammedî (a.s.m.): Kırmızı renkte bir gül çeşitidir. ("Keşfül Hafa" isimli hadis kitabının 1, cilt, 302. Sahifesinde, mezkur gül hakkındaki rivayetlerin sıhhatleri üzerinde durulmaktadır.)
gül-vend: f. En çok ceviz, incir, fıstık gibi şeylerden yapılan hediye, armağan.
gülab: Gülsuyu.
gülabdan: îçine gülsuyu konularak mevlüt gibi toplantılarda serpmeye mahsus kap. Bu, çiniden, gümüşten veya altundan yapılırdı. Buhurdanlar ile birlikte bir takım teşkil ederdi.
gülbank ª™„ƒ›˜: (Gülbang) f. Bir cemaat tarafından birlikte söylenen duâ, ilâhi, tekbir.
gülbank-î muhammedî (a.s.m.): Ezan.
gülbeden: f. Vücudu gül gibi nâzik ve lâtif olan.
gülbîz: Gül serpen.
gülbün: f. Gül yetişen yer, gül köşkü.
gülçe: (Gül-çe) f. Küçük gül, gülcük, çiçekçik.
gülçehre: çehresi gül gibi lâtif olan, çehresi gül gibi olan.
gülçîn: f. Gül devşiren, gül toplayan.
güldan: f. Vazo, içine çiçek konan kap, gül mahfazası.
güldehan: (Güldehen) f. Ağzı gül gibi güzel ve lâtif olan.
güldeste ª™‚šž…œ: çok güzel şeylerden bir tutam. * Gül demeti. * Müzikte makam adı.
güle: f. Zülüf. Bükülmüş ve kıvrılmış saç.
gülefşan: (Gül-efşân) f. Gül saçan.
gülendam: f. Güzel endâmlı, boyu gül gibi nâzik ve lâtif olan.
gülfam: f. Rengi gül gibi kırmızı olan, gül renkli.
gülfeşan: f. Gül saçan, gül dağıtan.
gülgeşt: (Gül-geşt) f. Gül gezintisi, gül seyri.
gülgonce ª™‚•›‡œ: f. Henüz açılmamış gül.
gülgun: f. Pembe, açık kırmızı. Gül renkli.
gülgune: f. Gül renkli. * Gül yanaklı. * Kadınların kullandıkları gül rengindeki düzgün.
gülhane: îstanbulda Sarayburnu'ndan Topkapı Sarayı'nın duvarlarına ve bir taraftan çizme Kapısı hizasına kadar devam eden saha. Bunun deniz tarafında, şimdiki hat boyunun batısında vaktiyle sıra ile gül bahçeleri bulunduğundan bu isim verilmiştir.
gülhane hatt-i hümayunu: Tar: Gülhanede okunan hatt-ı hümayun münasebetiyle meydana gelmiş bir tabirdir. Osmanlı împaratorluğu'nun bir zamanlar dünyayı titreten kuvvet ve kudreti, çeşitli sebep ve te'sirlerle büyük bir zaafa uğramış ve en nihâyet devlet, bir vilâyet hükmünde olan Mısır'ın idaresini ele geçiren Mehmed Ali Paşa'nın elinde zebun olacak bir dereceye düşmüştü. Memleketin bu halini gören ve Avrupa'da elçiliklerde bulunması itibariyle Avrupa devletlerinin memleket hakkındaki fikirleriyle zamanın cereyanlarını yakından müşahede eden Sadrazam Mustafa Reşit Paşa, memleketin selâmeti ancak idare usulünün ıslahında ve tebaaya salâhiyet ve hukuk verilip mes'uliyet esasının te'sisinde olduğunu iddia ederek yeni padişah olan Abdülmecid'e 3 Kasım 1839 Pazar gününde bir hatt-ı hümayun sudur ettirdi. Reşit Paşa'nın bu hat'la açtığı devir, tarihte Tanzimat namıyla anılmaktadır. Bu fermana göre memlekette bundan sonra herkes mal, can ve ırz emniyetine sahib olacak, vergiler ve asker toplanması belirli nizamlara bağlanacak, memuriyetlere lâyık olanlar getirilecek ve memurlara muayyen bir maaş tâyin olunacak, rüşvet alınmayacak, bir mahkeme kararı olmadan kimse mahkum edilmeyecek, bütün Osmanlı tebaası aynı kanuni ve hukuki haklara sahip olacaklardı. Bu ferman, bilhassa Hristiyan tebaa için te'min ettiği eşit haklar yüzünden Avrupa'da çok iyi karşılanmıştır. (O.T.D.S.)
gülhîz: f. Gül yetiştiren.
gülî ª™ÿ: f. Gül renkli. Gül gibi.
gülîstan: (Gülsitân) Gülyeri, gül bahçesi.
gülîzar ª™”‹ƒœ: f. Gül yanaklı, alyanaklı.
güllabîcî: Tar: Akıl hastahanelerindeki gardiyanlar. Bunlar ellerinde kamçı olduğu halde deliler arasında dolaşıp azgın delileri döverek uslandırmak vazifesiyle mükellef olduklarından, dışarda bu türlü tavır takınanlara da mecaz yoliyle güllâbici denilirdi.
gülle: Top mermisi. (Vaktiyle demirden veya taştan yuvarlak olarak yapılırdı. şimdi çelikten, silindir biçiminde ve ucu sivri olarak yapılmaktadır.)
gülnahl: f. Gül fidanı.
gülnak: f. Hisar ve kale.
gülnar ª™›ƒœ: f. Narçiçeği.
gülnefesî: f. Lâtif ve hoş sözlülük. * Güzel kokulu olmak.
gülnîhal: f. Gül fidanı.
gülpuş: f. Gül örtülü, pembe yüzlü.
gülreng: (Gül-reng) f. Gül renkli, pembe renkli.
gülrîz: f. Gül serpen, gül saçan. * Meşhur bir cins lâle.
gülruh: (Gül-ruhsar) f. Güzel yanaklı güzel, yanakları pembe olan güzel.
gülru(y): f. Yüzü gül gibi güzel ve kızıl renkli olan. Al yanaklı.
gülsîtan: (Bak: Gülistan) 
gülşen ª™›: f. Gül bahçesi. Güllük.
gülşen-ârâ: f. Gül bahçesini süsleyen.
gülşen-gâh: f. Gül bahçesi.
gülten: f. Gül gibi lâtif ve nâzik vücutlu.
gülu: f. însan veya hayvan boğazı.
gülubend: f. Boyna sarılan sargı, boğaz sargısı.
gülugîr: f. Boğazda kalan, boğazdan zor geçen (şey). * Ahlat armudu.
gülve: f. Fırın bacası.
gülzar ª™‚ƒœ: f. Gül bahçesi. Gül tarlası.
güm: f. Yitik, kayıp, zâyi.
güman ªšƒ›: f. Zan. Tahmin. Sanmak. şüphe.
gümaşte: (C.: Gümaştegân) f. Vekil, vezir.
gümgeşt: f. Kaybolmuş, yitirilmiş.
gümkerde: (Gümkerdepey) f. îzi kalmamış, adı sanı kaybolmuş, unutulmuş. * Yaptığı işi kimseye sezdirmeyen.
gümnam: f. Eseri kalmamış, adı sanı kaybolmuş, unutulmuş.
gümrah ªšœƒœ: f. Yolunu şaşırmış. Doğru yoldan sapmış. * Bol, gür.
gümrahî: f. Sapıtma, doğru yoldan çıkmış olma.
gümşüde: f. Telef olmuş, zâyi olmuş, kaybolmuş.
gümüş kozak: Tar: Eskiden hükümdarlara gönderilen nâme-i hümayunların konulduğu mahfaza. Nameler atlas keseye konur, sonra da kozaya geçirilirdi. Kozakların gümüşten yapılmış olanları olduğu gibi altundan, şimşirden de yapılanları vardı. Altundan olanlar imparatorlara, gümüşten olanlar da küçük devlet reislerine gönderilen nâme-i hümayunlara mahsustu. (O.T.D.S.)
güna gn ª›ƒ‚ª›: f. Türlü. çeşitli nevilerde olan. çeşit çeşit. Renk renk.
günah ª›ƒœ: f. Cezayı gerektiren amel. Dine aykırı iş. Allah'ın emirlerine uymayan hareket. (Bak: Kebâir-Cünha)(Evet günah kalbe işleyip siyahlandıra siyahlandıra tâ nur-u imanı çıkarıncaya kadar katılaştırıyor. Her bir günah içinde küfre gidecek bir yol var. O günah istiğfar ile çabuk imha edilmezse kurt değil belki küçük bir manevi yılan olarak kalbi ısırıyor. Meselâ: Utandıracak bir günahı gizli işliyen bir adam, başkasının ıttılaından çok hicab ettiği zaman melâike ve ruhaniyatın vücudu ona çok ağır geliyor. Küçük bir emare ile onları inkâr etmek arzu ediyor. L.)
günahkâr: f. Günah işleyen, günahlı.
günahkârî: f. Günahkârlık.
günahpîşe: (C: Günahpişegân) Günah işlemeyi âdet haline getiren.
günahpîşegân: f. Günah işlemeyi âdet haline getirenler.
günaşiri: t. îki günde bir. Bir gün olup ertesi gün olmayarak ve böylece sürüp giderek.
günbed: f. Kümbet, kubbe, üst tarafı yuvarlak şekilde olan bina veya çıkıntı.
günbed-î âb: Su kabarcığı.
günbed-î azrak: Gökyüzü.
günbed-î ekvar: Gökyüzü.
günbed-î hadra: Yeşil kubbe. * Mc: Gökyüzü, sema.
günc ª›‡: f. Hazine. Köşe. Zâviye.
güncayîş: f. Sığışma, sığma.
güncîde ª›‡ÿšœ: f. Bir şey veya zarf içine sığmış olan. Sıkıştırılmış.
güncîden ª›‡ÿš›: f. Sığmak, girmek.
güncîşk: f. Serçe kuşu, usfur.
güng: Dilsiz.
güngörmek: Mc: îkbal, refah, saadet, mutlu olarak yaşamak.
güngörmüş: Tecrübeli, iyi günler yaşamış.
güraz: f. Azgın erkek domuz.
gürbe: f. Kedi.
gürbe-î deştî: Yaban kedisi.
gürbüz: f. Yaşından fazla gösterişli, serpilmiş, vücutlu, genç irisi. * Cerbezeli. * Anlayışlı. îdrakli. * Kahraman, yiğit.
gürcü (gürcî): Güney Kafkasya'nın Gürcistan ahalisinden olan ve Gürcüce konuşan kimse.
gürd ªœš: f. Cesur, kahraman, yiğit, bahadır.
gürdas: f. Gaddar, zalim.
gürde: f. Böbrek.
gürg: (C.: Gürgân) f. Canavar, kurt, zi'b.
gürgzade: f. Kurt yavrusu.
gürîhte: f. Kaçkın, kaçmış, kaçak.
gürîsne: (C.: Gürisnegân) f. Aç, fukara, fakir.
gürîsne-gân: (Gürisne. C.) f. Açlar, fakirler, yoksullar.
gürîsneçeşm: f. Pinti, cimri, hasis. Aç gözlü.
gürîsnegî: f. Açlık, sefalet.
gürîz ªœÿ: f. Kaçma. * Kaçan. * Edb: Kasidelerde mevzuya girmeden evvel söylenen beyit.
gürîzan: f. Kaçan, kaçıcı.
gürîzende: (C: Gürizendegân) f. Kaçan, kaçıcı.
gürîzgâh ªœÿªƒœ: (Girizgâh) f. Kaçacak yer. * Edb: Bir bahisten diğer bahse, mukaddimeden maksada intikal için bir münasebet te'sis eden söz. Nedim'in:Bu şehr-i stanbul ki, bimisl ü behadırBir sengine yekpâre Acem mülkü fedadırmatla'lı kasidesindeki:îstanbul'un evsafını mümkün mü beyan hiç Maksad hemen sadr-ı keremkâre duadır.Beyti gibi. * Kast olunan şeye münasebet peyda eden söz.
gürmîh: f. çivi. * Hayvan bağlanan büyük kazık.
gürs: f. Kir, leke, pas. Açlık, sefâlet. * Zülf, kâhkül.
güruh ªœœ: f. Bölük. Cemaat. Takım. Kısım. * Fevc.
güruh-î eşkîya: Eşkiya takımı, haydut güruhu.
gürz: Silâhın icadından evvel kullanılan bir harp âleti. Gürz, yekpare veya yalnız baş tarafı demir ve bakırdan, sapı ise ağaç ve demirden olan bir nevi topuzdur. Gürzün Türkçesi "bozdoğan" dır. Bozdoğan bir cins yırtıcı kuştur. Gürz, bozdoğanın kafasına benzediği için bu adla anılmıştır. Gürzün baş kısmı çivili veya düz olurdu. Altı yüzlü olanlara "şeşper" denilirdi.
güsar: f. Yiyen, yiyici. îçen, içici manalarına birleşik kelimeler yapılır. Meselâ: Gam-güsar $ : Dert ortağı, arkadaş.
güsîste: f. Kopmuş, kırılmış. * Sökülmüş, çözülmüş, gevşemiş.
güsîste-mehar: (Güsisteinan) Yuları kopmuş. * Mc: Kayıtsız, mes'uliyetsiz, başıboş.
güsn(e): f. Açlık, sefalet.
güstah: f. Arsız, edepsiz, küstah, saygısız.
güsterde: f. Döşenmiş, yayılmış.
güşa: f. Açıcı, açan mânâsına gelir ve birleşik kelimeler yapılır. Meselâ: Dil-güşa $ : Gönüle ferahlık veren. Gönül açan.
güşad: f. Açılış, açılma, açma. * Bir cins ok atma şekli.
güşad-i dîl: Gönül açılması. Gönlün refaha kavuşması.
güşade: f. Ferah, şen, Açılmış, açık.
güşade-dest: (C: Güşadedestân) f. Civanmert, cömert, eli açık.
güşade-destân: (Güşadedest. C.) f. Cömertler, civanmertler, eli açıklar.
güşade-dîl: f. Gönlü şen.
güşade-ebru: f. Güler yüzlü. Mütebessim. şen.
güşade-hatir: f. Gönlü rahat.
güşadname: f. Padişah fermanı. * Boşanma vesikası.
güşayende: f. Açan, açıcı.
güşayîş: f. Açıklık, açılış, açılma.
güşayîş-î hâtir: Gönül ferahlığı, iç açıklığı.
güşayîş-î hevâ: Havanın açıklığı.
güşta: f. Cennet, firdevs.
güşude: f. Açılmış.
güva: f. şahit, delil.
güvah ªƒœ: f. şahit. Gören. Bilen. Tanıyan.
güvahî ªƒœÿ: f. şahitlik. şahitlik etmek.
güvar (güvara) ªƒœ: Hazmı kolay olan ve zaikaya hoş gelen, nefsin meylettiği şey.
güvaraî ªƒœƒ¡ÿ: Tatlılık, hoşa gitme.
güvarende: f. Hazmedilmesi kolay.
güvarîş: f. Sindirime yarıyan şeyler, hazme yardımı olan şeyler.
güvaş(e): f. Boya, renk.
güveç: Yemek pişirmeye mahsus toprak kap.
güverte: Geminin anbar veya kamaralarının üstü, gezilecek kısmı.
güya ªÿƒ: f. Sanki. Ke-ennehu. Söyle. Tut. Farzet. * Söyleyen.
güyan ªÿƒ›: f. Söyleyen.
güyem ªÿš: f. Söylerim (mânâsına fiil).
güyende ªÿ›šœ: f. Söyleyici. Söyleyen. Kail olan.
güz: Sonbahar.
güzaf ªƒ–: f. Boş, bihude. Lüzumsuz.
güzar: f. Geçiş, geçme. * Beceren, halleden, yapan. * Geçiren, geçirici mânâlarına gelir ve birleşik kelimeler yapılır. Meselâ: Dem-güzar $ : Zaman geçiren, vakit öldüren.
güzar-i bâ-şîtab: Hızla geçiş.
güzare: f. Rüyâ tâbir etme, düş yorma.
güzarende: f. Geçen, geçici. Geçiren, geçirici.
güzarîş: f. Rüya tâbir etme.
güzarîş: f. Geçiş, geçme.
güzaşte: f. Geçmiş, geçmiş olan.
güzer: Geçiş, geçme. * Geçici, geçen.
güzeran ªœƒ›: f. Geçen, geçici. * Geçme. Geçiş.
güzergâh ªœªƒœ: f. Geçit yeri. Geçilecek yer.
güzername: f. Geçiş tezkeresi.
güzeşt: f. Geçme, geçiş. Geçen. 
güzeşte ª…œ: f. Geçen. Geçmiş. Geçmiş olan.
güzeşte-gân: (Güzeşte. C.) önden gelmiş olanlar, geçmişler.
güzîde ªÿšœ‚ó‚ªÿ›: (Güzin) f. Seçilmiş. întihab edilmiş. Beğenilmiş.
güzîde-gân: (Güzide. C.) f. Seçkinler, beğenilmişler, seçilmiş olanlar.
güzîde-suhen: f. Beğenilmiş söz söyleyen, seçkin sözler konuşan.
güzîden ªÿš›: f. Seçmek. întihab etmek. 
güzîn: (Bak: Güzide)
güzînîş: f. Seçiş, seçme. 
güzîr: f. Derman, çare, deva.