j: Osmanlı alfabesinin ondördüncü harfi olup, ebced hesabında "" harfi gibi, 7 sayısına tekabül eder.
jaje ©ƒ©œ: f. Bâtıl, edebsizce olan söz. 
jajha: f. Saçma sapan söyliyen. Mânâsız ve boş konuşan.
jajhayan: f. Saçma sapan söz söyleyenler. Mânâsız ve boş konuşanlar.
jajhayî: f. Mânâsız söyleyicilik.
jajhor: f. Mânâsız ve mâlâyani şeyler konuşan.
jajî ©ƒ©ÿ: f. Tereyağı ile karışık peynirin tuluma konan şekli.
jaketatay: Fr. Arkası yırtmaçlı, etekleri uzun ve ön köşeleri yuvarlakça kesilmiş olan resmi ceket.
jale ©ƒ™œ: f. çiğ. Kırağı. (Bak: şebnem)
jale-î eşk: Gözyaşı jâlesi. Kırağı tânesine benziyen gözyaşı.
jaledar: f. üzerine çiğ düşmüş, kırağılanmış.
jalerîz: f. çiğ saçan, kırağı saçan.
jandarma ©ƒ›šƒœšœ: Fr. Yurt içinde asayişi sağlamak gayesiyle meydana getirilen ve orduya mensup silâhlı kuvvet. Ve bu kuvvette yer alan asker.
jar: Zaif, takatsiz, bitkin.
jardînîyer: Fr. Salonlara süs için konulan ve içine çiçek ekilmek üzere bir sandığı bulunan bir mobilya.
jartîyer ©ƒœ…ÿœ‚œ: Fr. çorap bağı.
jean: Dev. Gayet büyük. Dev cüsseli.
jegale: f. çığlık, nâra. * Darı ekmeği.
jegand: f. Sağlamlık, metanet. * Vahşi ve yırtıcı hayvanların korkunç sesi.
jegar: f. Küf, kir, pas. * Yüksek ses, nâra.
jeh: f. Siğil, sivilce.
jelatîn ©™ƒ…ÿ›: Fr. Tıbda ve fotoğrafçılıkta kullanılan şeffaf, renksiz ve kokusuz bir cisim. Hayvanların kemik ve kıkırdak gibi kısımlarından elde edilir. * Bir cins kâğıt.
jende ©›šœ: f. Yamalı, eski. * Eski-püskü. Pejmürde.
jendepuş: f. Yamalı hırka giyen kimse. Fakir.
jeng ©›ª: f. Pas, küf, kir.
jeng-âlud ©›˜‚¥™š: Paslı.
jeng-bar: f. Pas saçan.
jeng-beste: f. Paslı, kirli, küflü, pas tutmuş.
jeng-dar: f. Küflü, paslı, kirli.
jeng-pezîr ©›˜‚¨œÿœ: Paslı, küflü, kirli.
jeng-yab: f. Paslı, küflü, kirli.
jengar: f. Kir, küf, pas. * Bakır pası.
jengarî: f. Bakır yeşili. Bakır pası renginde olan boya.
jengdan: f. çan. çıngırak. 
jengele: f. çatal tırnaklı hayvan. * Hayvanda bulunan çatal tırnak.
jenk: Yüzde hâsıl olan buruşukluk.
jeoloğ ©œ‚ƒ™•: yun. Yer (Arz) ilmi ile uğraşan.
jeolojî ©œ‚ƒ‚™©ÿ: yun. Yerin (Arzın) yapı kütlelerini inceleyen ilim kolu.
jerd: f. çok yiyen, obur.
jerf (jerfa) ©œ–ó‚©œ–ƒ: f. Derin. Suyun derin yeri.
jerfbîn: f. Dikkat sâhibi, dikkatli.
jerfî: f. Derinlik.
jerfîn: f. Kapı sürmesi. Kapının ardına konulan dayak.
jest ©ž…: Fr. çalım. Mânâlı ve gösterişli hareket.
jeton: Fr. Para yerine kullanılan marka. * Telefonlarda veya garsonların kasa ile hasaplaşmasında kullanılır.
jey ©ÿ: f. Göl. * Irmak.
jiyan: f. Kükremiş, kızgın. (Ey yâreli şir-i jiyan, bu hâb-ı gafletten uyan.)
jîk ©ÿ˜: f. Yağmur damlası. * Kirpi.
jîkase: f. Kirpi.
jîle: Yelek.
jîmnastîk: (Bak: Cimnastik)
jîmnaz: Bazı memleketlerde orta tahsil müesseselerine verilen isim. îdadi mektebi.
jîr: f. Göl. Havuz.
jîrnet: Fırıldak. Rüzgârın istikametini gösteren âlet.
jîve: f. Civa.
jîyan ©ÿƒ›: f. Kızgın, kükremiş, hışımlı. (Bu tabir, ekseriyetle arslanlar hakkında kullanılır.)
jön türk ©›‚…œ˜: Fr. Genç Türk. 1868'den sonra, Avrupa'daki gibi, güya yenilik ve terakki isteyen Genç Osmanlılara Avrupalılarca takılan isim.
jun: f. Sanem, put.
jurnal ©œ›ƒ™: Fr. îlk önce gazete ve rapor mânasına kullanılırken sonradan "hükümete ihbar" gibi olan hâdiselere denilmeğe başlandı. îhbar, şikâyet, polis raporu. însanı kötüleyerek verilen haber veya rapor.
jügal: f. Kömür. Maden kömürü.
jülîde ©™ÿšœ: f. Dağınık, perişan, karma karışık.
jürî ©œÿ: ing. Herhangi bir mes'ele için hüküm vermek üzere toplanan hey'et, cemaat.: ƒk: Osmanlı alfabesinin yirmidördüncü harfi olan kaf ile, yirmibeşinci harfi olan kef harfini karşılar.