na ›ƒ: Arabçada "Biz" mânasına gelen zamirdir. Meselâ: Kitabünâ $ : "Kitabımız" misalinde olduğu gibi, kelimenin veya fiilin sonuna eklenen bitişik zamirdir.
na ›ƒ: Farsçada nefy edatıdır. Müsbet mânâyı menfi yapar. Kelimenin başına getirilir. Meselâ: Nâ-ehil $ : Ehliyetsiz, ehil olmayan.
na-aşna: f. Bilinmeyen, yabancı.
na-balîg: f. Henüz büluğa ermemiş, daha bâliğ olmamış. * Erişmemiş, yetişmemiş.
na-bayeste: f. Lüzumsuz, gereksiz. Uygun ve münasib olmıyan.
na-beca: f. Yersiz, uygunsuz, münasebetsiz.
na-bedîd: (Bak: Nâ-bercâ)
na-behencar: f. Usulsüz, kuralsız, yolsuz, kaidesiz.
na-behengâm: f. Vakitsiz, mevsimsiz, zamansız. 
na-behre: f. Azim, ulu. * Karışık. * Soysuz.
na-bekaîde: f. Kural ve kaideye uymayan. Kaidesiz, kuralsız, nizamsız.
na-bekâr ›ƒ„˜ƒœ: îşsiz, işe yaramaz. 
na-bemahal ›ƒ„šˆƒ™: f. Yerinde olmadan. Mahallinde olmayan. * Münasebetsiz. Yersiz.
na-berca: (Nâ-bedid) Belirsiz, görünmez olan.
na-besî: f. Yokluk, adem.
na-besud: f. El dokunulmamış, el değmemiş, yeni şey.
na-bîna: (C.: Na-binayan) Kör, a'mâ, gözleri görmez. Anadan doğma kör.
na-bînayan: (Na-bina. C.) Gözü görmeyenler, a'mâlar, körler.
na-bînayî: f. Körlük, a'mâlık. 
na-budmend: f. Yoksul, fakir.
na-caîz: f. Yapılmaz, câiz değil.
na-cîns: f. Aynı cinsten olmayan. * Cinsi bozuk.
na-cunban: f. Kımıldamaz. Yerinde durur. Sağlam.
na-çar ›ƒˆƒœ: f. çaresiz, elinden iş gelmeyen. Mecbur kalmış olan.
na-çarî: f. çaresizlik.
na-çespan: f. Uygun ve yakışık olmıyan.
na-çîzî: f. Naçizlik, ehemmiyetsizlik, kıymetsizlik, değersizlik.
na-dan ›ƒšƒ›: f. Cahil, bilmez, haddini bilmez.
nâ-danî ›ƒšƒ›ÿ: f. Terbiyesizlik, haddini bilmezlik. * Cahillik.
nâ-danîst: (Nâ-dâniste) f. Câhil, bilmez.
na-darî ›ƒšƒœÿ: f. Olmamazlık, bulunmayış.
na-daşt: f. Hayâsız, utanmaz.
na-demsaz: f. Uymayan, uygun olmayan, âhenksiz.
na-derîde: f. Delinmemiş, delik açılmamış.
na-dîde ›ƒšÿšœ: f. Az bulunur, çok değerli. Az görülen, görülmemiş.
na-dürüst: f. Doğru olmayan. Eğri. * Sağlam, dürüst ve gerçek olmayan. * Yanlış, haksız.
na-dürüstî: f. Gerçek olmama, doğru olmama.
na-ehîl ›ƒƒœ™: f. Ehliyetsiz, beceriksiz. Ehil olmayan.
na-endam: f. Muntazam olmıyan. Biçimsiz, gayr-ı muntazam.
na-endîş: f. Uzun uzadıya düşünmeğe değmez. Açık, muhakkak.
na-endîşîde: f. Düşünülmemiş.
nâ-evs: f. Manastır, kilise.
na-fercam ›ƒ–œ‡ƒš: f. Asıl ve esastan âri olan, akibetsiz olan. Faydasız.
na-gehan: f. Birdenbire, ansızın, âniden.
na-güşade: f. Kapalı, açılmamış.
na-güvar: (Nâ-güvâre) f. Midede zor hazmolunan şey. Sindirimi zor. * Yenilmesi veya içilmesi acı olan şey.
na-hah: f. îstemeyerek, râzı olmayarak. Zoraki.
na-hak ›ƒˆ—: f. Haksız, beyhude, boş.
na-hande: f. Câhil, ümmi, okumamış.
na-hast: f. Kötürüm.
na-hast: f. îsteksiz. îstenilmemiş. îstemeden.
na-hemta: f. Denk ve eşit olmayan. Müsavi olmayan.
na-hemvar: f. Eğri, düz olmayan. * Uymayan, mutabık gelmeyen. * Uygunsuz.
na-hencar: f. Doğru olmayan.
na-hoş ›ƒ‰: f. Hoş olmayan, hoşa gitmeyen.
na-hoş-güvar: f. Hazmı zor, sindirimi güç. Tatsız.
na-hoşî: f. Nahoşluk, fenalık, iğrençlik. Hoşa gitmemeklik.
na-hoşnud: f. Razı ve hoşnud olmayan. Gayr-i memnun.
na-huda: f. Allah'tan korkmaz. * Gemi kaptanı.
na-însaf: f. însafsız. însafı bulunmayan.
na-ka'ryab: f. Dibi bulunmayan, dipsiz.
na-kabîl ›ƒ—ƒ„™: f. Mümkün olmayan. Kabil olmayan. * Câhil, kabiliyetsiz.
na-kabul: f. Kabiliyetsiz, istidatsız.
na-kâfî ›ƒ˜ƒ–ÿ: f. Kâfi olmayan. Yetersiz, kâfi değil.
na-kâm ›ƒ˜ƒš: f. Muradına eremeyen, tali'siz. Arzusuna kavuşamayan.
nâ-kâmî: f. Mahrumiyet, bahtsızlık. isteğine kavuşamama.
na-kâre: f. Bir işe yaramaz olan.
na-kaste: f. Eksiksiz, noksansız. Tamam.
na-kerde: f. Yapılmamış, olmamış.
na-kes ›ƒ˜ž: f. Hasis olan. * Zelil, insaniyetsiz, alçak, deni.
na-kesan: (Nâ-kes. C.) Alçaklar, âdi insanlar, insaniyetsiz kimseler. * Cimriler, tamahkârlar, pintiler, hasis kişiler.
na-kesâne: f. Alçakçasına. * Cimrilik ve tamahkârlıkla.
na-layik ›ƒ™ƒÿ—: f. Lâyık olmayan.
na-ma'dud ›ƒš”šš: f. Sayılmaz, çok. Sayısız.
na-ma'kul: f. Akla uygun gelmeyen. Akıl almayan. Mâkul olmıyan.
na-ma'lum: f. Bilinmiyen, bilinmemiş, ma'lum olmayan.
na-ma'ruf: f. Tanınmayan, bilinmeyen, ma'ruf olmayan.
na-mağlub ›ƒš•™„: f. Yenilmez, mağlub edilmez. 
na-mahdud: f. Hudutsuz, sınırsız, sonsuz.
na-mahrem ›ƒšˆœš: f. Aralarında evlenmeğe mâni olacak kadar yakınlık bulunmayan. şer'an evlenmeğe mâni akrabalığı olmayan erkek veya kadın. * Yabancı.
na-mahremîyet: f. Namahremlik.
na-mahsur ›ƒšˆœ: f. Sonu olmayan, sınırlanmamış, sonsuz.
na-makbul ›ƒš—„™: f. Makbule geçmez, kabul olmayan. Kabul edilmeyen.
na-marzî: f. Beğenilmeyen, arzu ve isteğe uygun olmayan.
na-matbu: f. Basılmamış, tab edilmemiş yazı.
na-me'mul ›ƒš¤š™: f. Umulmadık, beklenmedik anda.
na-mefhum: f. Anlamsız, mânasız, anlaşılmaz.
na-mer'î: f. Görülmez. Mer'i olmayan.
na-merbut: f. Rabıtasız, mânâsız, anlamsız, saçma sapan.
na-merd ›ƒšœš: f. Korkak. * însaniyetsiz, sözünde durmayan. Alçak, insanlık hislerinden habersiz.
nâ-merdâne: f. Namerdcesine, alçakçasına.
nâ-merdî: f. Namerdlik, alçaklık, zillet. * Korkaklık.
na-mergub: f. Beğenilmeyen, rağbet olunmayan.
na-mes'ud: f. Mes'ud ve mübârek olmayan. Uğursuz. 
na-mesbuk: f. Benzeri hiç olmamış, geçmemiş.
na-mesmu': f. îşitilmeğe değmez. * îşitilmemiş, duyulmamış.
na-mestur: f. Açık, meydanda, âşikâr. * örtülmemiş.
na-meşhud ›ƒšœš: f. Gözle görülmemiş, şâhit olunmamış.
na-meşru ›ƒšœ”: f. Meşru olmayan, şeriat harici. * Kanunsuz, uygunsuz. * Günah olan şeyler.
na-mevzun: f. Ahenksiz, ölçüsüz, vezinsiz, orantısız. * Edb: Vezni bozuk veya hiç olmayan manzume.
na-meysur: f. Ele geçirememiş. Elde edememiş. * îşi kolaylaştırılmış.
na-mîhr-ban: f. Vefasız, sevgisiz, muhabbetsiz.
na-mîhr-banî: f. Vefasızlık, sevgisizlik, muhabbetsizlik.
na-mîzac: f. Keyifsiz, rahatsız, hasta.
na-mîzacî: f. Keyifsizlik, rahatsızlık, hastalık.
na-murad ›ƒšœƒš: f. Mahrum kalan, muradına eremeyen.
na-mutasavver: f. Hatır ve hayale gelmez.
na-muvafik: f. Muvafık gelmeyen, uygun olmayan.
na-mübarek: f. Uğursuz, meymenetsiz.
na-mühezzeb: f. Terbiye görmemiş, ıslah edilmemiş.
na-mülayîm: f. Uygun olmayan. * çetin, sert.
na-münasîb: f. Münâsebetsiz, yakışıksız, uygunsuz, uygun olmayan.
na-müsaîd ›ƒšžƒ”š: f. Elverişsiz. Müsaid olmayan.
na-müstaîd ›ƒšž…”š: f. Müstaid olmayan. Olgunlaşma kabiliyeti olmayan. îstidatsız.
na-mütenahî ›ƒš…›ƒœÿ: f. Sonsuz, ucu bucağı olmayan. Nihâyetsiz.
na-müvecceh: f. Yöneltilmemiş, tevcih edilmemiş.
na-müyesser: f. Elden gelmeyen, müyesser olmayan.
na-pâk ›ƒ¨ƒ˜: f. Temiz olmayan, pis, kirli.
na-pâkân: (Nâpâk. C.) Murdarlar, pisler.
nâ-pâkî: f. Pislik, murdarlık. 
na-paydar: f. Süreksiz, geçici. Sebatsız, kararsız, durmaz.
na-perva: f. Pervasız, korkusuz, aldırışsız, çekinmez. * Sersem.
na-pesend: f. Beğenilmez.
na-peyda ›ƒ¨ÿšƒ: f. Görünmeyen, açıkta değil, belirsiz.
na-pezîr ›ƒ¨ÿœ: f. Olmaz, olamaz, kabul etmez.
na-puhte: f. Ham, çiğ, pişmemiş. * Mc: Acemi, tecrübesiz, toy.
na-rast: f. Eğri. Doğru olmayan.
na-refte: f. Gidilmemiş, geçilmemiş. Kimsenin gidip geçmediği yer.
na-resa: f. Yetişmemiş, ham. * Uygun ve münasib olmayan.
na-resayî: f. Uygunsuzluk, münasebetsizlik. * Hamlık.
na-resîde ›ƒ‚œžÿšœ: Yetişmemiş, körpe. * Büluğa ermemiş.
na-reşîd: f. Kemâle ermemiş, olgunlaşmamış.
na-reva ›ƒœƒ: Yakışıksız, reva olmayan. Münâsib ve lâyık olmayan.
na-saf: f. Saf ve hâlis olmayan. Saf olmayıp karışık olan.
na-savab: f. Doğru olmayan, yanlış.
na-saz: f. Münasebetsiz. uygunsuz, uymaz.
na-sazî: f. Uygunsuzluk, münasebetsizlik, uymazlık.
na-sazkâr: f. Uygun görmeyen, muhâlif. * Beklenmemiş, işitilmemiş. * Münâsebetsiz işle uğraşan.
na-sazkârî: f. Uygunsuz iş yapma, münâsebetsiz iş görme. * Zıtlık, uygunsuzluk.
na-sencîde: f. ölçülmemiş, tartılmamış. * îyi düşünülmemiş. * Değerlenmemiş.
na-seza ›ƒžƒ: f. Münasib olmayan, lâyık olmayan.
na-sîpas: f. Nankör. şükretmeyen.
na-sude: f. Dinlenmemiş, istirahat etmemiş.
na-süfte: f. Delinmemiş, deliksiz.
na-şad ›ƒƒš: f. Sevinçli olmayan, mahzun, tasalı, kederli.
na-şadî: f. Hüzünlü ve kederli oluş, gamlılık.
na-şayeste: f. Lâyık olmayan. Lâyık değil.
na-şîkîb: f. Sabırsız.
na-şîkîbâne: f. Sabırsızlıkla.
na-şîkîbânî: f. Sabırsızlık.
na-şîkîbî: f. Sabırsızlık.
na-şînas: f. Bilmez, câhil. * Tanımaz olan, tanımayan.
na-şînîde: f. Duyulmamış, işitilmemiş.
na-şîta: f. Sabahtan beri hiç bir şey yememiş olma.
na-şüküfte: f. Açılmamış, taze.
na-şüste: f. Yıkanmamış. 
na-tamam ›ƒ…šƒš: f. Tamamlanmamış, bitmemiş, yarı kalmış.
na-tamamî: f. Eksiklik, noksanlık.
na-teraş: Mc: Terbiye görmemiş, kaba saba. Yontulmamış.
na-tevan ›ƒ…ƒ›: f. (Bak: Na-tuvan)
na-tiraş: f. Yontulmamış, tıraş olmamış, terbiye görmemiş. Ham, kaba.
na-tuvan ›ƒ…ƒ›: (Nâtüvân) f. îktidarsız, zayıf, halsiz, kudretsiz, çâresiz.
na-tuvanî: f. Güçsüzlük, zayıflık, kuvvetsizlik.
na-ümîd: f. ümidsiz. ümidi kırılmış.
na-ümîdî: f. ümit kırıklığı, ümitsizlik, me'yusiyet.
na-üstüvar: f. Dayanıksız, sağlam olmıyan. * Münasebetsiz.
na-yab: f. Bulunmaz. * Benzeri olmaz. Nâdir. Ender.
na-yeste: f. Lâyık olmıyan.
na-zad: (Na-zade) f. Doğmamış. * Olmayacak.
na'ab: Aceleci. Hızlı yürüyen, tez giden kişi.
na'al: Nalbant. Nalin yapan.
naam ›”š: (Bak: Neam)
na'ar: Fesad ve fitneye çalışan. * Kanı kaçmış olup sâbit olmayan damar.
naat ›”…: (Bak: Na't)
na'b ›”„: Karga veya horoz ibiği.
nab ›ƒ„: (C.: Enyâb) Azı dişi. * Yaşlı deve.
nab ›ƒ„: f. Katıksız, hâlis, saf. * Oluk. * Berrak.
nabazan: Nabız atması, damar vurması.
nabiz ›„‘: Atar damarın vuruşu. şah damarının atması. Kırmızı kan damarının oynaması hali.
nâbiz ›ƒ„‘: Hareket eden.
nabiz-âşnâ: f. Nabızdan anlayan. Mizaç bilen. Karşısındakinin zayıf taraflarını bilen.
nabiz-gîr: f. Her mizaç ve tabiata göre davranıp muamele etmesini bilen.
nâbiza: (C.: Nevâbız) Nabız damarı.
nabî ›ƒ„ÿ: Haber veren, haberci. * Urfa'lı kıymetli bir şâirin ismi. (Mi: 1626- 1712)
nabî ›ƒ„ÿ: Yüksek, yüce.
nabî': (Nâbia) (Nebean. dan) Yerden fışkıran, kaynayan, akan.
nabîga ›ƒ„•œ: (C.: Nevabig) şanı, şöhreti büyük adam. ulu, şerefli kimse. * Sonradan şâir olan. * üstün zekâlı hârika ve çok fasih kimse.
nabîgat-ül ca'dî ›ƒ„• ‚ƒ™‡”šÿ: Resül-i Ekrem Aleyhissalâtü Vesselâm'ın duasına mazhar olmuş mühim bir Arab şâiridir. îran'ın fethinde bulundu. Rivayete göre Mi: 684'de îsfehan'da Rahmet-i Rahman'a kavuştu.
nabîgat-üz zübyanî ›ƒ„• ‚ƒ™„ÿƒ›ÿ: Câhiliyet devrinde meşhur ve Suk-ı Ukaz'da hakemlik yapmış Arab şâirlerindendir. Tahminen Mi: 535-604'de yaşamıştır.
nabîl: Ok yapan. * üstad, hâzık kimse. * Irgaç.
nabît ›ƒ„…: Ağaç ve nebat gibi yerden bitip büyüyen.
nabîte: Bir kabilede yeni çıkan küçük çocuk.
nabîz: Savaşçı, muharip, savaşan.
nabud ›ƒ„š: (Nâ-bud) f. Mâdum, yok olan, bulunmayan. * îflas etmiş. Perişan olmuş. * Sonradan yok olan.
na'büdü ›”„š: "Biz ibadet ederiz" mânâsında fiil. ( Bak: Nun-u na'büdü)
nabz: (Bak: Nabız)
nabz-aşna: f. Nabızdan anlayan, mizac bilen.
nabz-gîr: f. Mizaca göre hareket etmesinden anlıyan, nabza göre davranmasını bilen.
nabza: Damarın bir defa atması.
nabzî: Damarın atmasıyla ilgili.
na'c: (C: Niâc-Neacât) Koyun.
nacak: Bir ağaç sapa geçirilen, ağzı keskin, genişçe demir âlet. Balta.
na'cat: (Na'ce. C.) Dişi koyunlar.
na'ce: (C.: Niâc-Na'cât) Dişi koyun. * Dişi sülün. * Kadına da istiare ile söylenir.
nacî ›ƒ‡ÿ: Kurtulan. Necat bulan. * (Mi: 1849-1892) Muallim Naci diye meşhur olan bir îstanbul'lu şâir. Lügat-ı Naci'yi "Fetva" kelimesine kadar hazırlamıştır.
nacî' ›ƒ‡”: Hazmı kolay olan yiyecek.
nacîl ›ƒ‡™: Nesli kerim, şerefli olan, soyu temiz.
nacîleyn ›ƒ‡™ÿ›: Ana ve baba, ecdad ve evlâd, dedeler ve babalar.
nacîr: Ağaçlarda yaprak saplarının dibindeki filiz.
nacîs: îyileşmez hastalık.
nacîş: Avı ürküterek avcının tarafına kovalayan adam.
nacî(ye) ›ƒ‡ÿœ: Kurtulmuş, necat bulmuş. Cennetlik olan.
nacîye ›ƒ‡ÿœ: (C.: Nâciyât) Sür'atli deve.
nacîz ›ƒ‡‹: Azı dişi.
nacîz: Hâzır.
nacu: f. çam ağacı.
nacud: f. Büyük kadeh.
nacur: Sırça tabak.
nacüv: f. çam ağacı.
na'çe: f. Yumuşak yer.
naçîz ›ƒ§ÿ: (Nâ-çiz) f. çok küçük, ehemmiyetsiz şey, değersiz, hükümsüz.
naçîzane ›ƒ§ƒ›œ: f. çok ehemmiyetsiz olarak. Pek ufak olarak.
nadar: (Nadâret) Altun.
nadas: Tarlayı temizleyip otlarını kurutmak için önceden sürüp hazırlama.
nadc ›‘‡: Kıvam. Büluğa erme. Pişme.
nadd: Azık, rızık.
naddahatan ›‘ƒ‰…ƒ›: Püsküren çifte pınarlar.
nadh ›‘ˆ: Su serpmek, sulamak. Su içip kanmak. * Musallat olanı defetmek. * Suyun feveran etmesi, püskürmesi.
nadic: (C.: Nevadıc) Olgunlaşmış, olmuş, kıvama gelmiş.
nadî ›ƒšÿ: Nidâ eden, haykıran, çağıran. * Halkın, meşveret gibi, birşey konuşmak üzere bir yere toplanmaları. Nitekim îslâmdan evvel Mekke'de Kureyş'in toplandığı meclis binasına "Darünnedve" denilirdi. Nâdi; orada ve o gibi yerlerde toplanan heyettir ki; bezm, meclis, mahfil, kongre tâbirleri gibidir. (E.T.)
nadîb: Geçmiş. * Hafif adam. * Yas tutan.
nadîc: Olgun meyve. * îyi pişmiş et.
nadîd ›‘ÿš: Salkımları sık olan üzüm veya muz. * îçi doldurulmuş yastık, minder, şilte gibi şeyler.
nadîm ›ƒšš: Nedamet etmiş, pişman.
nadîmâne: f. Pişmanlıkla, pişman olarak, nedamet duyarak.
nadîmîyet: Pişmanlık, nedamet.
nadîrât: Az bulunan şeyler.
nadîr(e) ›ƒšœ: Az bulunan. Seyrek.
nadîre-perdâz: f. Güzel söz söyleyen.
nadîre-senc: f. Nükteli konuşan, güzel fıkralar anlatan, zarif kimse.
nadîredân: f. Zarif, âlim.
nadîrekâr: f. Nâdir işler ve san'atlar yapan.
nadîren: Nâdir ve az olarak. çok aralıklı. Pek az bulunur.
nadîret ›‘œ : Güzellik, parlaklık, tazelik. * Hoş ve lâtif.
nadîye: Sudan uzak olan hurma ağacı.
na'f ›”–: Sütü çok olan deve.
nâf ›ƒ–: f. Göbek. * Mc: Orta.
nâf-i âlem: Mekke-i Mükerreme.
nâf-i şeb: Gece yarısı.
nâf-i zemîn: Zeminin ortası. Mekke-i Mükerreme.
nafaka ›–—œ: Yiyecek parası. Geçim için lüzumlu olan şey. * Geçindirmeğe mecbur olduğu kimselere veya çocuklarına mahkeme karariyle verilen iaşe parası.
nafaka-î îddet: Fık: Kadının iddeti içinde muhtaç olduğu nafaka. Koca, boşadığı karısını iddeti bitinceye kadar infakla mükellef olduğu için bu müddet zarfındaki nafaka hakkında bu tâbir meydana gelmiştir.
nafaka-î makzîyye: Fık: Hâkim tarafından takdir olunan nafaka. 
nafakat: (Nafaka. C.) Nafakalar.
nafata: Vücutta çıkan sivilce veya kabarcık.
nafe: f. Derisi kürk yapımında kullanılan hayvanların postlarının karnı altındaki deri kısmı.
nafe-rîz: f. Koku saçan. * Göbek düşüren.
nafia: Bayındırlık işleri.
nafik ›ƒ–—: Geçer para. Geçer akçe.
nafika: (C.: Nevâfık- Nüfeka) Arab tavşanının (diğer adı; tarla fâresi dedikleri hayvanın) iki yuvasından gizli olanın adıdır. Bu hayvan, bunun tavanını yeryüzüne çok yakın yapar. Belirli olan kasia dedikleri yuvasında tehlike hissederse hemen nâfıkanın tavanını delerek kaçar. Münafıklar buna benzediği için nifak, münafık kelimeleri bu kelimeden gelmiştir. (Kamus).
nafiz ›ƒ–‘: çok titreten. Sıtma.
nafî ›ƒ–ÿ: (Nefiy. den) Giderici, yok eden, nefyeden, menfi yapan. 
nafî' ›ƒ–”: Menfaatli. Faydalı. Yarar. şifalı. * Esma-i Hüsnâdan bir isim.
nafîa ›ƒ–”œ: înşaat işleri. * Faydalı işler. Menfaatli olanlar.
nafîc: (C.: Nevâfic) Kaburga kemiklerinin sonu.
nafîce: (C.: Enfice) Misk göbeği.
nafîh: (Nefh. den) üfürücü, üfleyici.
nafîka ›ƒ–—ƒ£: (Nüfeka) (C.: Nevâfık) Keler yuvalarından biri.
nafîle ›ƒ–™œ: Fık: Farz ve vâcibden gayrı mecburiyet olmadığı hâlde yapılan ibadet. Fazladan yapılan iş. * Menfaatli olmayan. Ziyâdeden olan. * Torun. * Ganimet malı. Bahşiş. Atiyye.
nafîr ›ƒ–œ: Nefret eden. ürken, korkan. Sevmeyen. * Galip olan. * öksürüp burnundan sümüğü saçılan koyun.
nafîs: (Nefs. den) Gözü nazar değer olan kimse. * Açan ve ferahlandıran.
nafîs: Okuyup üfüren.
nafîs-ül kerb ›ƒ–ž‚ƒ™˜œ„: Sıkıntı ve belâlara, göz değmesine, nazara te'sir edip kaldıran.
nafîz ›ƒ–‹: îçe işleyen. Delip geçen. îçeri giren. * Sözü geçen, kendine itaat edilen. Te'sirli, nüfuzlu.
nafîz ›ƒ–‘: çok fazla titreten sıtma.
nafîz-ül emr: Emri geçip sözü dinlenilen. * Kendisine itaat edip boyun eğilen.
nafîz-ül kelîm: Sözü geçen.
nafîze: Karından vurulup arkaya çıkmış olan yara.
nafîzîyet: Sözü geçerlik, nâfizlik.
nafur: (Nâfure) Fıskıye, fevvâre.
nagâh ›ƒªƒœ: f. Birdenbire, ansızın, hemen. (Nâgeh, nâgehan, nagehâne, nagehâni)
nagam: (Nağme. C.) Nağmeler, âhenkler, türküler.
nagam-kâr: f. Nağmeler söyleyen, ezgici.
nagam-perver: (C.: Nagamperverân) f. Türkü söyleyen, nağmeci. Nağme seven.
nagamât: Nağmeler, âhenkler, güzel sesler.
nagaşan: Iztırab, acı.
nagfa: Ceviz ağacına benzer bir ağacın adıdır ve Beyrut dağlarında olur; dut gibi yemiş verir.
nagiz: şaşırdığında başını sallayan kimse. * Kürek başında olan kıkırdak.
nagk: (C.: Nuguk) Karga çağırmak.
nagl: çürük sahtiyan.
nagm: Gizli kelâm, gizli söz.
nağme ›•šœ: (C.: Nağamât) Ahenk, güzel ses, âvaz, ezgi, teganni.
nağme-ger: f. Türkü söyleyen, öten.
nağme-hân: f. Türkü söyleyen, şarkı söyleyen.
nağme-hânî: f. Türkü söyleyicilik, nağme söyleyicilik.
nağme-hîz ›•šœ‚‰ÿ: f. Nağme uyandıran. Türkü, şarkı söyleyen.
nağme-keş: f. Türkü söyleyen, şarkı söyleyen.
nağme-perdaz: f. Türkü söyleyen, şarkı söyleyen.
nağme-saz ›•šœ‚žƒ: f. Ahenkle söyleyen, terennüm eden.
nağme-sera: f. Türkü okuyan, şarkı söyleyen.
nağme-zen: f. Türkü söyleyen, şarkı söyleyen.
nagr: Gadap etmek, hiddetlenmek, kızmak. * Kin tutmak. * çömlek kaynamak.
nags ›•: Kederli, gamlı olmak.
nagz: f. Güzel, iyi. Göze hoş ve güzel görünen.
nagz: Devekuşunun erkeği. *Başını sallayıp depretmek. * Bulutun koyu ve kesif olması.
nah ›ƒˆ: f. Göbek.
nah ›‰: f. îp, ince ip. * Tel. * Halı, kilim. 
nah' ›‰”: Kesme, boğazlama.
naha': Boyun kemiğindeki beyaz iliğe varana kadar kesmek. * Yemen taifesinden bir kavim. * Hâlis etmek. * Uzaklık, ıraklık.
nahabe: (C.: Nuhab) Geçit ağzı. * çokluk asker. * Her nesnenin iyisi.
nahafet: Zayıflık, arıklık, cılızlık.
nahafet: Aksırma.
naharîr: (Nihrir. C.) Bilgili, akıllı ve âlim kimseler. Fâzıl ve mâhir kişiler.
nahaset: Esircilik. * Canbazlık.
nahb: çekip çıkarma.
nahb: Yüksek sesle ağlama. * önemli iş, mühim iş. Nezretmek, adamak. * Seri seyr. * Vakit, müddet. Ecel, ölüm, mevt.
nahçîr: f. Av hayvanı. Sayd. * Av yeri. * Yaban keçisi.
nahçîr-gâh: f. Av yeri.
nahçîr-gîr: f. Avcı, sayyad.
nahçîr-vân: f. Avcı.
nahf: Aksırmak. Nefes almak.
nahh: Davar sürmek. * îplik. * Zeyli denilen döşek. * Güç seyr. * Deve çökertmek için söylenen söz.
nahham: Tamahkâr, cimri, hasis, pinti. * Boğazını temizlemek için fazlaca soluyup balgam çıkaran adam.
nahhas: Esirci, esir ticareti yapan kimse. * Hayvan alıp satan kişi.
nahhas: Bakırcı.
nahhat: Marangoz. Doğramacı. Ağaç oymacısı. Taş yontucusu.
nahhat: Gururlu, kibirli.
nahi': âlim.
nahî ›ƒœÿ: (Nehy. den) Nehyeden, yasak eden, önleyen.
nahîb ›ƒœ„: (Nehb. den) Yağma eden, talan eden, önleyen.
nahîb ›ƒœ„: Korkak, cebin.
nahîb: Avaz avaz ağlamak, feryad ile ağlamak.
nahîde ›ƒœšœ: Yeni yetişmiş kız. * Zühre (Venüs) yıldızı.
nahîf ›‰ÿ–: Sümkürdüğünde genizden gelen ses.
nahîf ›ˆÿ–: çelimsiz, zayıf, ince. Arık.
nahîk: (Nehak. dan) Eşek gibi anıran, eşek sesli.
nahîka: (C.: Nevâhik) Dudaklı hayvanların göz pınarı.
nahîl ›ƒˆ™: (Nâhile) Zayıf, arık, ince.
nahîl ›‰ÿ™: Hurma ağaçları, hurmalık. * Hurma ağacı. * Balmumundan yapılan ağaç, yapraklı dal ve yemiş taklidi işlere denir ki, sathı altın ve gümüş yapraklarla süslenerek, eskiden gelin giderken önünde alayla götürülür ve gelin odalarına süs olarak konurdu. (O.T.D.S.) 
nahîl ›ƒ‰™: Kalburcu.
nahîl ›ƒœ™: Susayan kimse. * Suya kanmış kimse.
nahîle: Huy, tabiat, mizac.
nahîr: (Nahr. dan) Kesilmiş, boğazlanmış.
nahîr: Burundan hırıltı çıkarma. 
nahîr: çürümüş kemik. * îçine rüzgâr girip çıkmakla öten kemik.
nahîran: Atın göğsünde olan iki damar.
nahîre ›‰œœ: Ufalanmış. * çürümüş. * Rüzgârla savrulur, yel estikçe ses verir, delik deşik olmuş kemik.
nahîre: Ayın birinci günü. * Ayın son gecesi.
nahîs: Kıtlık yılı.
nahîs: Kıtlık. * Yümünsüz, uğursuz.
nahîs: Dönmekten dolayı genişlemiş olan makara deliği.
nahîs: Vuran, vurucu. * Devenin kuyruğunda veya göğsünde olan uyuz.
nahîse: Koyun sütüyle karışık keçi sütü.
nahît: (Nahite) înilti.
nahîye ›ƒˆÿœ: Yan taraf, kenar, civar, çevre. * Küçük yer, bölge. îdari taksimatta, kazadan küçük, köyden büyük olan yerleşme merkezi.
nahîz ›ˆÿ‘: Eti çok olan.
nahîz: f. Pusu.
nahîz: Uçmaya hazırlanmış ve kanatları bitmiş olan kuş. * Tavşancıl yavrusu.
nahîzgâh: f. Pusu yeri. 
nahl: Hurma ağacı. * Gelinler için yapılan süs ağacı. * Un elemek.
nahl ›ˆ™: Bal arısı. * Bedelsiz bir şey vermek veya bedelsiz verilen şey. * Sövmek, iftira etmek.
nahl suresî: Kur'an-ı Kerim'de 16. Suredir. Mekkidir.
nahl-bend: f. Ağaçları budayıp tanzim eden kişi. * Balmumundan taklid süs ağacı yapan, balmumcu.
nahle ›‰™œ: Tek hurma fidanı. * Bir fidan.
nahle: Bir tek arı.
nahlîstan: f. Hurma fidanlığı, hurmalık. * Ağaçlık, fidanlık.
nahlîye ›‰™ÿœ: Hurmalar.
nahme: Göğüsten çıkan ses.
nahnaha: Hırıltı ile soluma. * öksürük.
nahnaha: Deveyi çökertmek.
nahnu ›ˆ›: Biz.
nahr ›ˆœ: Boğazlamak. Bir hayvanın göğsü üstünden bıçak vurup boğaz damarını kesmek. * îki şeyin birbirine göğüs göğüse olması. * Boyun. Boğaz çukuru. * Sadır. * Gündüzün evveli. * Namazda kıyamda iken sağ eli sol elin üstüne koymak.
nahr: Eskimek. * çürümek. * Parçalamak.
nahr-ün nehar ›ˆœ‚ƒ™›œƒœ: Gündüzün evveli.
nahr-üş şehr ›ˆœ‚ƒ™œœ: Ayın evveli.
nahs ›ˆž: Uğursuzluk, yümünsüzlük. * Bahtsız, uğursuz.
nahs: Vurmak.
nahş: Zayıflamak.
naht: Ağacı yontmak suretiyle kabartma şekiller yapma san'atı. * Yontma, oyma.
naht: Sümkürmek.
nahu ›‰: (Kürdçe) öyle ise şöyle ki, işte.
nâhun: f. Tırnak.
nâhun-be-dendân: f. Hayretten veya kederden dolayı parmağını ısırmış olan.
nâhun-bürâ(y): f. Tırnak makası, tırnak çakısı.
nâhun-tiraş: f. Tırnak makası, tırnak çakısı.
nâhunbür: f. Tırnak makası.
nahv ›ˆ: (Nahiv) Yol, cihet. Etraf, yön. * Misâl. * Miktar. * Kasd ve azmeylemek. * Gr: Kelimelerin birbirine rabt, izafet ve amel eylemeleriyle ilgili olan kaideleri içine alan ilim. Nahiv ilmi ile Arapça kelimelerin yeri ve usulü bilinir, yani cümle tahlili yapılır.
nahve: çörek otu.
nahvet: Kibir, gurur. Kibirlenme, büyüklenme, böbürlenme.
nahvetfüruş: f. Böbürlenen, gururlanan.
nahvî ›ˆÿ: Nahiv ilmine ait. Arapça gramere ait. Nahiv ilmini iyice bilen.
nahvî lîsan ›ˆÿ‚™žƒ›: Kaidelere bağlı olan çok tertibli, ince ve geniş mânâlı lisan.
nahvîyyun ›ˆÿ›: Kelime dizimi ve nahiv ilminin ehli olan âlimler. Arapça dil âlimleri, gramerciler.
nahz: Bir şeyle dürtme.
nahz: Kemiğin etini ayıklama.
nahza: Et parçası.
nait: Dağ. * Hemeden kabilelerinden bir kabile.
naî: Kötü haber veren.
naîb: Karga gibi çirkin sesli kuşların ötüşü.
naîb-î fâîl: Meçhul fiilin mevzuu olan kelime ki, harekesi merfu olur. (Küsirel kalemü: "Kalem kırıldı" cümlesinde " kalem", "Naib-i fâil" olmuş ve fâilin yerine geçmiştir.)
naîb-ül âm ›ƒ¡„‚ƒ™”ƒš: Cumhuriyet müddei-i umumisi. Cumhuriyet savcısı.
naîb(e): (Nevb. den) Vekil, birinin yerine geçen. * şeriat hâkimi olan kadı vekili. * Nöbet bekleyen.
naîce: Yumuşak yer.
naîf: Zayıf, cılız.
naîk ›”ÿ—: Karga ötüşü veya horoz sesi. * çobanın koyuna bağırması.
naîkan: Cevzâ burcundan iki yıldız.
naîl(e) ›ƒ¡™: Muradına eren, nâil olan, ele geçiren. Erişmiş.
naîlîyet ›ƒ¡™ÿ…: Ele geçirmek, murada ermek, elde etmek.
naîm ›”ÿš: Bolluk ve bahtiyarlık içinde yaşayış. Nizam-ü hal ve mal. * Cennet'in sekiz kısmından dördüncü tabakası.
naîm ›ƒ”š: Taze, körpe. * Kılçıksız, yumuşak, kemiksiz. * Etli sebze.
naîm ›ƒ¡š: Uyuyan, uykuda olan.
naîmâne ›ƒ¡šƒ›œ: f. Uyur gibi, uyuklayarak, uyurcasına.
naîme ›ƒ”šœ: Rahatlık içinde nazlı büyütülmüş kadın. * Yumuşak yapılı hayvancıklar.
naîmîn: (Nâim. C.) Uyuyanlar, uykuda bulunanlar.
naîr: Haykıran, nâra atan. * Uzak. Irak, baid.
naîr: Parlak, parlayan. * Düşmanlık, adavet.
naîre: (C.: Nevâir) Alev, ateş. * Hararet, sıcaklık.
naîye ›ƒ”ÿœ: ölüm haberi götüren, kötü haber veren.
naîz: Kuvvetlendiren. Kaldıran.
na'k ›”—: Karga avazı. * çobanın koyuna haykırıp çağırması. 
nak ›ƒ˜: f. Nisbet edatı olarak kelimelere eklenir, sıfat meydana getirilir. Meselâ: Gam-nâk $ : Gamlı, kederli.
nak' ›—”: (C: Nuk'-Enku) Su saklayacak yer. * Kuyu içinde olan su. * Deve kuşu avazı. * Feryâd etmek, bağırıp çağırmak. * Susuzluğu teskin etmek, susuzluğu gidermek. * Sıcak suda haşlama. * îlâç olarak çıkarılan su. * Suda ıslanma. * Toz.
naka ›—ƒ: (C.: Enkâ) Kumdan meydana gelmiş tepe.
nâka ›ƒ—œ: Dişi deve. * Bir yıldızın ismi. * Sivilce.
naka' ›—ƒ£: Temiz olma.
nâka-î sâlîh: Salih Peygamber'in (A.S.) bir mu'cizesi olarak kayadan çıkan devesi. (Bak: Sâlih A.S.)
nakaîs ›—ƒ¡ž: (Noksan. C.) Eksiklikler. Noksanlar.
nakaka: Kurbağaların çağrışıp ötmeleri. * Tavuğun yumurtladığında ötüp gıdaklaması.
nakal: Bir yerden naklolunduğunda bâki kalan ufak taşlar. * Devenin tabanına ârız olur bir hastalık.
nakale: (Nâkıl. C.) Haberciler, nakledenler.
nakarat ›—œƒ…: (Nakra. C.) Durmadan tekrarlanan usandırıcı şeyler. * Edb: şarkının belli yerlerinde tekrarlanan bestesi değişmeyen parça.
nakare: f. Davul, kös. Dümbelek.
nakave: Temizlik.
nakb: (C.: Enkâb) Delmek, delik açmak. * Girmek. * Dağ içindeki yol.
nakba: Tabanı aşınmış deve.
nakd ›—š: (C?: Nukûd) Madeni para, akçe. * Bir şeyin bedelini peşinen ödemek. * Para olarak bulunan servet. * Vezin ve ayarı tamam olan para. * Bir şeye hırsızlamasına bakma. * Seçmek. * Saymak.
nakd-î cân: En kıymetli olan şey.
nakd-î mevcud: Mevcud olan para, elde bulunan para.
nakden ›—šøƒ: Para olarak, peşin, elden.
nakdî ›—šÿ: Paraca, peşin para ile. Para ile alâkalı ve paraya müteallik.
nakdîne: Hazır ve peşin para. * Kıymetli ve değerli mal.
nakdîne-î hayat: Hayatın kıymeti.
nakf: (C: Nuküf-Enkâf) Başı dimağından yarmak. * Bakış, nazar.
nakh: Başı dimağından yarmak.
nakh: Teftiş etmek, kontrol etmek.
nakibe: (C.: Nukab) Kişinin yan tarafında çıkan çıban.
nakid: Bir şeyin iyisini kötüsünden veya bozuğundan ayıran. * Tenkidci, ayarcı. Paranın kalbını anlayan. * Dinar, dirhem.
nakif: Kırıcı, kıran. * Bakan, nâzır.
nakih: (C.: Nukuh) Tam olarak iyileşip hastalıktan kurtulmayan.
nakil: îleten, taşıyan, aktaran, nakleden. * Tercüme eden. * îşittiğini anlatan.
nakil-i ahbar: Haberler nakleden.
nakile: Nakleden. * Cereyan geçiren.
nakilmeclîs: Söz taşıyan. Dedikoduculuk yapan. Gammaz.
nakir: Nişana isabet eden ok.
nakis ›ƒ—ž: Noksan, eksik. Tamam olmayan. Gr: Yalnız son harfi harf-i illet olan kelime $ gibi. * Mat: Eksi. Negatif. (Bak: Kâmil)
nakis ›ƒ—ž: Ekşi şarap.
nakis-ul îyar: Ayarı bozuk.
nakisat: (Nâkıs. C.) Nâkıslar. Noksanı olanlar. Eksiği bulunanlar.
nakisat-ül akl: Aklı kısa. * Mc: Kadın.
nakiyy: Pak, temiz, nazif.
nakiz: (Nakz. dan) Bozan, bozucu.
nakî ›—ÿ‚‚›ƒ—ÿœ‚: (Nakiye) Temiz, pâk. * çok takvalı, temiz insan. * Has undan yapılmış beyaz ekmek. 
nakî': Tâze. * şifâlı devâ.
nakî' ›—ÿ”: (C.: Enkia) Kuru üzümü su içinde ıslatarak yapılan şarap. * îçinde hurma ıslatılan havuz. * Suyu çok olan kuyu. * Kandıran, kandırıcı.
nakîa: (C.: Nekâyi') Seferden gelen kimse için hazırlanan yemek. * Yağma edilen hayvanlardan taksimattan önce boğazladıkları deve ve koyun. * Damat için hazırlanan yemek. * Ziyafet.
nakîb ›—ÿ„: Vekil. Bir kavim veya kabilenin reisi veya vekili. Halkın hayırlısı. * En eski derviş veya dede. * Müfettiş.
nakîbe ›—ÿ„œ: Akıl. Nefs. * însan ruhu.
nakîd: (Bak: Nakd)
nakîh: (Nekahet. den) Hastalıktan yeni kurtulmuş olup henüz zayıf olan kimse.
nakîhe: Nikâhlı kadın eş.
nakîk: Kurbağa, akrep ve tavuk sesleri.
nakîl ›ƒ˜™: Vazgeçen, cayan, dönen. * çekinen, kaçınan. 
nakîl ›ƒ—™: Nakleden, işittiğini anlatan.
nakîl ›—ÿ™: Yol, tarik. * Bir yürüme çeşidi.
nakîle: (C.: Nekâyil) Ayakkabıya yapılan yama.
nakîme: Asıl, cevher. Kendi, nefis. * Nefsi mübarek olan.
nakîr ›—ÿœ: Bir insanın hem cins ve aslı. * Gayet fakir. * Bir nevi kara sinek. * Ağzı dar olan küçük kab. * Hurma çekirdeğinin arkasındaki beyaz çukur. * Kıymetsiz şey.
nakîr: Gadaplı, kızgın.
nakîs ›ƒ˜ž: Bayağı, alçak. * Başını daima öne eğen adam.
nakîs ›—ÿ: (Noksan. dan) Eksik. Tamam olmayan.
nakîs ›ƒ˜†: Bozan, çözen, üzen veya dağıtan. * Rücu eden. Dönen.
nakîse ›—ÿœ: Kusur, ayıb, eksiklik, kabahat, noksanlık. * Gıybet.
nakîsedâr: f. Eksiği bulunan. Kusuru olan. Kusurlu.
nakîş: Parça parça ve dağınık olan eşyaların bir yerde veya bir çuval içinde toplanması. * Benzer, misil.
nakît: Dişi keklik.
nakîza: Dağ içindeki yol.
nakîz(e) ›—ÿ‘œ: (Nakz. dan) Zıt, karşı. Birbirine karşı, zıt olan şey veya iş. * Man: Bir şeyin, bir kaziyenin hükmüne, mânasına muhalif olan veya ondan başka kaziye. Bir şeyi ref'eden şey. (Meselâ: "Her insan hayvandır. Bazı insan hayvan değildir." kaziyeleri birbirinin nakizidir. Nakiz ile zıd beyninde fark vardır. Nakizeyn; ne cem' olurlar, ne de ma'dum. Zıddeyn; cem' olmazlar, ikisi de bir arada olmazlar, ma'dum olurlar. * Eyer ve semerden çıkan ses.
nakîzeyn ›ƒ—‘ÿ›: Karşılıklı iki zıt şey.
nakka': Yanında olmayan şey için mübalağa yapan kimse.
nakkab: (Nakb. dan) Delici, delik açıcı.
nakkad ›—ƒš: (Bak: Nekkad) Nakd eden. Paranın kalbını, sağlamını ayıran. * Tenkidci, bir şeyin iyisini kötüsünü ayıran. * îmam, hatib.
nakkaf: Temkinli kimse, iyi niyet sâhibi olan kişi.
nakkal: (Nakl. dan) Nakledici. * Hikâyeci. Hikâye anlatan.
nakkar: Müzik, çalgı. * Gagalıyan. * Ağaç, taş ve madeni eşyayı oyarak ve çukurlaştırıp kabartarak ona mücessem şekiller veren sanatkârlar.
nakkare: (Bak: Nakare)
nakkaş ›—ƒ: Nakış yapan. Duvar nakışları yapan usta. Süsleme san'atkârı.
nakkaş-i ezelî ›—ƒ‚¤™ÿ: Ezeli Nakkaş. Ezeli olup her şeyin nakşını yapan. Allah (C.C.)
nakkaşe ›—ƒœ: Nakış yapan kadın. Nakışçı.
nakl ›—™: Bir şeyi başka bir yere götürmek, taşımak, yer değiştirmek. * Anlatmak, duyduğu bir şeyi başkasına hikâye etmek, rivâyet etmek. * Bir dilden başka dile çevirmek, terceme etmek. * Eski mest ve çizme. * Yırtık elbiseyi yamamak.
nakl-bend: f. Hikâyeci. Masal uyduran.
nakl-î hadîs: Hadis-i şeriflerin nakledilmesi.
nakl-î sahîh ›—™‚ˆÿˆ: Doğru, şüphesiz gelen haber nakli.
nakl-üd dem: Kan aktarma.
naklen ›—™ƒø: Nakil yoluyla. Anlatmak veya hikâye etmek suretiyle.
naklî: Nakliye ile, taşıma ile ilgili. * Akla değil de nakle dayanan, yani söylenen hakikat.
naklî delîl: şer'i hükümler için nakli delil esastır. Yalnız akıl ile din namına hüküm getirilmez ve böyle bir hükmün dinle alâkası olmaz. Dini meselelerde aklın ve ilmin vazifesi; dini hükümlerdeki hikmetleri ve hakkaniyet delillerini görüp izhar etmektir. Kur'anın bazı âyetlerinde yapılan akla havaleler ve Kur'andan herkesin istifade etmesine ait hususlar ise: Tefekkür, faziletler ve havf ü rica ve bilhassa, ahkâm-ı diniyenin hikmetlerini ve hakkaniyet delillerini görmek gibi ibret derslerine ait olup, ahkâm-ı şer'iyeye ait değildir. (Bak: Edille-i erbaa, Fetva)
naklîyat ›—™ÿƒ…: Nakil işleri, taşıma işleri. * Anlatılanlardan öğrenilenler. * Nakiller.
naklîyat-i askerîye: Askeri kıt'aların; top, tüfek, cephane, teçhizat ve levazımatı ve her türlü seferi ihtiyaçlarıyla birlikte bir yerden kaldırıp başka bir yere gönderilmesi, nakledilmesi. Askeri nakliyat.
naklîye: (C.: Nakliyat) Eşya taşıma işi. * Taşıma parası.
nakm ›—š‚‚›—šœ‚: (Nakmet) întikam, öç alma. Eza vererek cezalandırma.
naknaka: (C.: Nekanık) Kurbağanın ötmesi. Tavuğun gıdaklaması. * Ses.
nakr: Oymak, kazmak. Taş oymak. * Kuşun yem toplaması. * Vurmak. * Sıklık vermek. * Ağaç üstüne nakşetmek. * Tanbur çalmak. * üflemek. * Dille ıslık çalmak. * Parmak çıtlatmak.
nakra: Hususi dâvet, özel dâvet.
nakreşe: Gizli his.
naks ›—: Eksiklik, noksan, kusur. * Azaltma, eksiltme. (Bak: Nâkıs)
naks ›—ž: Nakletmek. * îfsad etmek, bozmak. * Evmek. Acele etmek. * Kimseye lâkap takmak. * Ayıplamak. * Kilise çanını çalmak. çan çalmak, çana vurmak.
nakş ›—: Bir şeyi çeşitli renklerle boyamak. * Resim. * Tezyin etmek. * Bedene batmış dikeni çıkarmak. * Bir şeyin esasını araştırmak. * Yaymak. * Suda ıslanmış hurma. * îpekle, sırma ile işleme. * Mc: Hile.
nakş-bend ›—‚„›š: f. Kumaşların nakışlarını bağlayarak ipek tellerle tezgâhı hazırlayan. Nakış işleyen. * Ressam.
nakş-bendî ›—‚„›šÿ: f. Kalbde zikir yoluyla, tefekkür ile îlâhi sevgiyi, uyanıklığı nakşa çalışan mânâsiyle, şeyh Bahâüddin Nakş-bendi nâmındaki azim bir velinin kurduğu ve en ziyade hafi zikre dayanan tarikata mensub olan.(Silsile-i Nakşi'nin kahramanı ve bir güneşi olan îmam-ı Rabbani (R.A.) Mektubat'ında demiş ki: "Hakaik-ı imaniyeden bir mes'elenin inkişafını, binler ezvak ve mevaâcid ve keramata tercih ederim."Hem demiş ki: "Bütün tariklerin nokta-i müntehası, hakaik-ı imaniyenin vuzuh ve inkişafıdır.Hem demiş ki: "Velâyet üç kısımdır: Biri velâyet-i suğra ki, meşhur velâyettir. Biri velâyet-i vusta, biri velâyet-i kübradır. Velâyet-i kübra ise; veraset-i nübüvvet yoluyla, tasavvuf berzahına girmeden, doğrudan doğruya hakikata yol açmaktır."Hem demiş ki: "Tarik-ı Nakşide iki kanad ile sülûk edilir." Yâni: Hakaik-ı imaniyeye sağlam bir surette itikad etmek ve feraiz-i diniyeyi imtisal etmekle olur. Bu iki cenahta kusur varsa, o yolda gidilmez.
nakş-i dîl-fîrîb: Gönül aldatıcı suret.
nakş-i kadem: Ayak izi.
nakş-i kîlkî ›—‚˜™˜ÿ: Kalemle yapılan nakış.
nakş-perdaz: f. Nakış yapan ressam.
nakş-perdazî: f. Ressamlık.
nakş-tiraz: f. Süslü işlemeler.
nakt: çıkarmak.
nakur ›ƒ—œ: Sur gibi ağızla üflenerek çalınan boruya denir. Nakr; vurmak ve didiklemek mânalarına geldiği gibi, boru çalmak mânasına da gelir. çünkü boru çalındığı zaman, içinden hava tazyiki ile didiklenmiş olacağı gibi, dışından da o ses, çarptığı kulakları didikleyeceği cihetle boruya "minkar" mânasıyla alâkadar olarak "nâkur" denilmiştir. Boru çalınmak, askerin seferi için hareket kumandası demek olduğu gibi, borusu ötmek de emir ve kumandasının nüfuzundan kinaye olur. E.T.)
nakus ›ƒ—ž: Kiliselerde asılı bir vaziyette durup belirli vakitlerde çalınan çan. Kilisenin büyük çanı.
nakvet: Bir şeyin seçkini.
nakz: Bozmak. çözmek. Kırmak. * Bir sözleşmeyi yok saymak. * Kalın bir şeridi çözüp dağıtmak. * Parmaklarda veya âzâda oynak yerler. * Kiriş. * Palan. Deri.
nakz ›—: (Nakazân) (C.: Nevâkız) Sıçramak. * Talep etmek, istemek.
nakz ›—‹: Halâs olmak, kurtulmak.
nakz-i ahd ›—‘‚ƒœš: Anlaşmayı bozma, muâhede hükümlerini bozma. Verilen sözde durmama. (Nebz-i ahd da denir)
nakzan: (Nakzen) Bozarak, hükmü bozulmuş olarak.
nakzeyn: îki zıt, zıtlar. Birbirine muhalif iki şey.
na'l ›”™: Nal. Ayağa giyilen tahta ayakkabı veya hayvanların ayağına çakılan demir. * Oturulacak yerlerin en aşağısı.
na'l-bur: f. Nal, çivi vs. satan veya yapan kimse. Nalbur.
na'l-tiraş: f. Ağaç ayakkabı yapan kimse. * Nalıncı.
nalan ›ƒ™ƒ›: f. înleyen, sızlayan, figân eden.
nalbant: (Na'l-bend) f. Nal takan.
nalçe: Küçük nal. * Yemeni, çizme gibi ayakkabılara vurulan hafif demir parçaları. (O.T.D.S.)
nal(e) ›ƒ™œ: f. înilti, figân. * Kamış kalem. * Kamış düdük. * şeker kamışı.
nale ›ƒ™œ: (Bak: Nâl)
nalekâr ›ƒ™œ‚˜ƒœ: f. înleyen, figân eden, feryad eden.
nalekünan: (Nâle-künân) f. Feryad ederek, inleyerek.
nalende: f. înleyen, feryad eden, inleyici.
nalesenc: f. înleyen, inildiyen.
nalesencî: f. înleyicilik, feryad edicilik.
na'leyn: Bir çift ayakkabı. * Bir çift nalın.
nalezen: (Nâle-zen) f. înleyen. înildeyen.
nalezenan: f. înildiyerek, inleyerek.
na'lî: Nal biçiminde olan.
nalîş: f. înleme, inilti, inleyiş.
nalîşkâr: (Nâlişker) f. înleyen, inildiyen.
nalîşzen: f. înleyen.
nam ›ƒš: f. îsim, ad. Lâkab. ün. şan. * Vekillik. * Adres.
nam-aver: (C.: Nam-âverân) f. ünlü, meşhur, ad salmış.
nam-âverân: (Nam-âver. C.) Namlı kişiler, ad salmış kimseler, ünlüler, meşhurlar.
nam-i müstear ›ƒš‚šž…”ƒœ: Takma isim.
nam-i şerîf: Mübarek isim, şerefli ad.
na'ma ›”š¥£: Rahatlık, nimet. Minnet, ihsan ve atiyye. îyi halde bulunmak.
na'man: Tâif yolunda Arafata çıkar bir derenin adı.
naman: (Nam. C.) f. îsimler, adlar. 
namaz ›šƒ: f. îslâmın beş şartından birisidir. * Duâ. * Zikir. * Kur'an. * Kunut. * Rüku. * Salât. * şükür. * Tesbih. * Secde. * Hamd. (Bak: Salât - Târik-üs salât)(Arkadaş! Namaz, kul ile Allah arasında yüksek bir nisbet ve ulvi bir münasebet ve nezih bir hizmettir ki, her ruhu celb ve cezbetmek namazın şe'nindendir. Namazın erkânı, "Fütühat-ı Mekkiye"nin şerhettiği gibi, öyle esrarı hâvidir ki, her vicdanın muhabbetini celbetmek, namazın şe'nindendir. Namaz, Hâlik-ı Zülcelâl tarafından her yirmidört saat zarfında tayin edilen vakitlerde mânevi huzuruna yapılan bir davettir. Bu davetin şe'nindendir ki, her kalb, kemal-i şevk ve iştiyakla icabet etsin. Ve mi'racvari olan o yüksek münâcâta mazhar olsun.Namaz; kalblerde azamet-i îlâhiyyeyi tesbit ve idame.. ve akılları ona tevcih ettirmekle adalet-i îlâhiyyenin kanununa itaat.. ve nizam-ı Rabbâniye imtisal ettirmek için yegâne îlâhi bir vesiledir. Zaten insan, medeni olduğu cihetle, şahsi ve içtimai hayatını kurtarmak için, o kanun-u îlâhiye muhtaçtır. O vesileye müracaat etmeyen veya tenbellikle namazı terkeden veyahut kıymetini bilmeyen; ne kadar câhil, ne derece hâsir, ne kadar zararlı olduğunu bilâhare anlar, ama iş işten geçer. î.î.)
namazgâh ›šƒ‚ªƒœ: Namaz kılınan yer. îbadetgâh. Eskiden şehir dışında, kırda ve sed üzerinde mihrab konulmak suretiyle namaz kılınmak için yapılan yere verilen addır. * Bir kasabanın bütün halkını bir arada bulunduran geniş sahaya da bu ad verilirdi. Bayramlarda ve fevkalâde günlerde kasaba ve civar köyler halkı hep birden orada toplanırlardı.
namazgüzar: f. Namazlarını kılan, namazlarını eda eden.
namberdar: f. şanlı, ünlü, ad salmış, meşhur.
namcu(y): (C.: Namcuyân) f. Nam arayan. * Yiğit.
namcuyân: (Namcu. C.) f. ün arayanlar, nam arayanlar. * Yiğitler, kahramanlar.
namdar ›ƒššƒœ: f. ünlü, şöhretli, meşhur.
namdarân: (Namdar. C.) ünlüler, namlılar, meşhurlar.
namdarî: f. Namdarlık, ünlülük, meşhur olma.
na'me ›”šœ: Derinin nazik olması. * Hoş dirlikli olmak.
name ›ƒšœ: f. Mektub. Risale. Kitap.
name-î hîcran: Hicrân mektubu. Ayrılık, mektubu.
name-î hümayun: Tar: Osmanlı Padişahları tarafından îslâm ve Hristiyan Hükümdarlarla Osmanlı Devletine tâbi imtiyazlı olar Mekke şerifine, Kırım Hanına, Eflâk ve Boğdan Voyvodalarına, Erdel Kralına, Gürcü ve Dağıstan Hanlarına gönderilen mektublara verilen addır.
name-î nur ›ƒšœ£‚›œ: Nurun mektubu. Saadet verici mânâlar yazılı kâğıt.
name-res: f. Mektup ulaştıran, mektup eriştiren.
nameaver: (Name-âver) f. Mektup götüren.
nameber: f. Mektup götüren, nameâver.
namik ›ƒš—: Kâtib, yazıcı. 
namik kemal ›ƒš—‚˜šƒ™: (Mi: 1840 - 1888) Tekirdağ'lı olup îslâm mücahidlerindendir. Yeni Osmanlılık hareketine vatan mefhumunu sokmuş, "Firâki, hapsi, nefyi kadr-i nâmusumla gördüm hep" diye haklı olduğunu dâima müdâfaa etmiştir. Ehl-i kemâl bir zat olduğu, davasının istikameti ve samimiyetinden anlaşılır.Hayatının sonlarına doğru Osmanlı împaratorluğunun ve îslâm dünyasının kurtuluşunu "ittihad-ı îslâm" da görmüş ve bu uğurda gayret göstermiştir. Bu emelini, yazdığı " Celâleddin-i Harzemşah, Salahaddin-i Eyyubi, Yavuz Sultan Selim ve Fâtih Sultan Mehmed" isimli eserlerinde ortaya koymuştur. Mezarı Bolayır'dadır.
namîsa: (C.: Namisât) Kadınları süsleyip yüzlerinin kılını yolan kadın.
namî(ye) ›ƒšÿœ: Büyüyen, artan, ürmee kuvveti olan. Nebat ve hayvandaki büyüyüp gelişme kuvveti. * Farsçada: Namlı, şöhretli, ünlü.
namîye ›ƒšÿœ: (Bak: Nami)
namîyeber: f. Hayat verici.
namus ›ƒšž: Irz, iffet, edeb, hayâ. * şeriat. * Melâike. * îrade-i îlâhiyenin tecellisi. * Nizam. * Emniyet ve istikamet gibi faziletlerin muhassalası olan pek kıymetli haslet. * Bir kimsenin mahrem, gizli esrarı olup işleri ve hallerinin iç yüzüne vakıf ve muttali kimseye denir. * Hayırlara ait gizli hâllerin hâmil ve vâkıfı olan. Bu mânada Cebrâil Aleyhisselâm'a ıtlak olunur. Sair melâikenin vâkıf olmadıkları vahyin sırlarına vakıf ve mahrem olması cihetiyle ona namus-u ekber denilmiştir. * Hâzık. * Mahir. * Av ve tuzak. * Nemmam mânâsiyle fitneci ve koğucu. * Birisinin hilesine siper ettiği şeye ve arslan yatağına da bu mâna verilmiştir. * Temizlik, doğruluk. ( Bak: Desâtir)
namus-u mücessem ›ƒšž‚š‡žš: çok namuslu olan.
namusîyye: Yatan kimselerin başkaları tarafından görülmemeleri için, yatağın etrafına çekilen perde.
namuskâr: f. Namuslu. * Doğru adam.
namusperver: f. Namuslu. 
namver: (C.: Namverân) Namlı, adlı, meşhur, ünlü.
namzed ›ƒšš: (Nâm-zed) f. îsteyen veya istenilen kimse. * Sözlü. Nişanlı. * Bir vazifeye tayin edilmesini isteyen veya istenilen kişi. Aday.
nan ›ƒ›: f. Ekmek.
na'na: (C.: Neâni-Ne'nâ') Nâne. * Uzun boylu adam.
na'naa: Irak etmek, uzaklaştırmak. * Hızlı konuşmak, tez tez söylemek. * Katı deprenmek. * Yemeğe nane koymak.
nancu: (Nâncuy) f. Ekmek arayan. Dilenci.
nane molla: Mc: Beceriksiz, işe yaramaz, ağır hareketli mânalarında kullanılan bir tâbirdir.
nanhah: Ekmek isteyen. Dilenci.
nanhor: f. Dilenci.
nankör ›ƒ›˜œ: f. Gördüğü iyiliği unutan, nimeti inkâr eden. Nimetin şükrünü eda etmeyen, gafil.
nanpare: f. Ekmek parçası. Bir lokma ekmek. * Geçime yarayan iş.
nanpüz: f. Ekmekçi, ekmek pişiren.
nanü: f. Ninni.
na'r ›”œ: çağırmak. * Haykırmak. * Burun içinden çıkan ses. * Gitmek. * Firar, kaçmak. * Galeyan.
nar ›ƒœ: (C.: Niran, envar, niyere, niyâr) Ateş. Cehennem. * Bir meyve adı. * Mc: Allahın gadabı. * Yakıcı, azab verici her şey. şer. Dalâlet. Sefâhet.
nar-i beyza ›ƒœ‚„ÿ‘ƒ£: "Akkor, beyaz ateş" mânâsında olan bu tâbir fizikte: 1800 derece kadar olan hararette erimeyen cismin sıcaklık hâli demektir. * Bir meyve adı.(Hikmet-i tabiiyede nâr-ı beyza hâlinde ateşin bir derecesi var ki; harareti etrafına neşretmiyor ve etrafındaki harareti kendine celbettiği için, şu tarz bürudetle, etrafındaki su gibi mâyi şeyleri incimad ettirip, mânen bürudetiyle ihrak eder. îşte zemherir, bürudetiyle ihrak eden bir sınıf ateştir. öyle ise, ateşin bütün derecâtına ve umum envâına câmi olan Cehennem içinde, elbette zemherir'in bulunması zaruridir. S.)
nar-i hayat ›ƒœ‚ˆÿƒ…: Canlıya lüzumlu bulunan sıcaklık. Vücudun harareti. (Bak: Hararet-i gariziye)
na'ra ›”œœ: (C.: Na'rât) Yüksek sesle uzun uzun bağırma. * Tar: Eskiden yangına giderken ve dönerken kalabalık caddelerde, geçitlerde, dönemeçlerde, meydanlarda tulumbacıların içlerinden "naracı" adı verilen birinin bağırması yerinde kullanılır bir tâbirdir. Nâra atmakla yangın münasebetiyle sokağa fırlayan halkı çiğnenmekten kurtarmak için insani bir maksad tâkib edilmekle beraber, daha ziyade caka satılırdı. (O.T.D.S.)
na'rat ›”œƒ…: (Bak: Na'ra)
narbac: Nar aşı.
narbün: f. Nar ağacı.
narcîl: Hindistan cevizi.
narcîs: Nergis.
narcîstan: Nergislik.
narçîl: f. Hindistan cevizi. Ceviz-i Hindi.
narda: f. Lâyık değil.
nardan: f. Gözyaşı damlaları. * Nar tâneleri. * Mangal.
nardenk: f. Erik, nar, elma, kızılcık gibi meyvelerden çıkarılan ekşimsi pekmez.
nardeşîr: Tavla oyunu.
na're: Nâra. Yüksek sesle uzun uzun bağırma. çağırma. Haykırma. * Burun içinden çıkan ses.
na're-endâz: f. Nâra atan. Yüksek sesle uzun uzun bağıran.
narenc: f. Portakal. * Turunç.
narencî: Turunç renginde.
narencîye: Turunçgiller. (Mandalina, portakal, limon gibi meyveler.)
narenec: (Nârnic) Hindistan'da yetişen ve turunç ağacına benzeyen bir ağaç.
na'rezen: f. Nâra atan. Yüksek sesle uzun uzun bağıran.
nargîl: f. Hindistan cevizi.
narh ›œ‰: (Aslı "Nirh" dir) Yiyecek maddelerine belediyenin koyduğu fiat.
narî: (Bak: Nariyye)
narîn ›ƒœÿ›: f. înce, zayıf, nazik. * îç oda.
narîs: f. Ham meyva.
narîyye ›ƒœÿœ: Nar ile alâkalı, nara mensub. Ateşten, yanıp tutuşur, patlar olan şey.
narkotîk: yun. Afyon, morfin gibi uyuşturucu maddelerin genel adı.
na's ›”ž: Uykusu gelmek. Uyku bastırmak. 
nas ›ƒž: f. însanlar.
nas ›ƒ†: Iraklık, uzaklık.
nas suresî: Kur'an-ı Kerim'de 114. Sure. (Bak: Muavvezetân)
nasa: Kaldırmak. * Engel olmak, men'etmek.
nasab: Dert. * Zahmet, meşakkat.
nasaf: Hizmetçi, uşak.
nasafe: Hizmet etmek.
nasaha: öğüt vermek, nasihat etmek.
nasaîb: (Nasibe. C.) Dikili taşlar.
nasal: Temrenci.
na'san: Uykusu gelmiş olan adam.
nasara ›ƒœÿ: Hristiyanlar. Nasraniler. Hz. îsa'ya (A.S.) ilk önceleri Nâsıra Karyesindeki ahali yardım ettiklerinden, onlara "Nasara" ismi verilmiştir.
nasayîh ›ƒÿ‰: (Nasihat. C.) Nasihatlar. öğütler.
nasb ›„: Dikme. Bir rütbe alma. Bir memurluğa tayin edilme. * Gr: Arapçada kelimenin i'rabının mensub ( üstün) olması, yani; (e, a) diye okunuşu.
nasb-ül ayn ›„‚ƒ™”ÿ›: Göz dikilmesi. Bir şeye hırsla ve şiddetli arzu ile bakmak, göz dikmek.
nasba: Doğru boynuzlu koyun ve keçi.
nasbetmek: Kelimenin son harfinin harekesini (E) diye okutmak. * Tâyin etmek.
na'sel: Erkek sırtlan. * Uzun sakallı bir kimsenin adı.
na'sele: Yaşlıların yürüyüşü.
nasere: f. Ayarı bozuk para.
nasfet ›–…: (Nasafet) însaf. Haklılık. Bir şeyin yarısını almak. Hakkaniyet. însanları, kanunların şümulüne girmeyen hakları te'min ve ifasına zorlayan fotri adâlet hissi.
nasi': Her nesnenin hâlisi. * şiddetli beyaz olan.
nasibe: (Bk: Nasibe) 
nasif: Geo: Açıyı iki eşit parçaya bölen doğru. Açı ortayı.
nasife: (C.: Nevâsıf) Su mecrası, su yolu.
nasih ›ÿˆ: (Bak: Nâsih) 
nasir ›ƒœ: Yardımcı, yardım eden, nusret veren. Resül-i Ekrem'in (A.S.M.) bir ismi.
nasirîn: (Nâsır. C.) Yardım edenler, yardımcılar.
nasî ›ƒžÿ: Unutan, nisyan eden.
nasîb ›ƒ„: Nasbeden, bir şeyi bir şeye diken. * Gr: Harfi (e) diye üstün okutan.
nasîb ›ÿ„: Pay, hisse, kısmet. * Bir kimsenin elde edebildiği şey.
nasîbdar: f. Nasibi olan. Hissedar.
nasîbdaş: f. Hissede beraber, nasipte eş olan.
nasîbe ›ƒ„œ: Müfrit Haricilerden ve Emevilerden ve Hz. Ali'ye (R.A.) çok muhalif olan zümrenin adı.
nasîbe ›ÿ„œ: (C.: Nesâib) Yollara dikilen işaret taşı. Bir yere dikilen taş.
nasîc: (Nesc. den) Dokuyan, nesceden. * Düzenleyen, tertib eden, sıralayan.
nasîf: Baş örtüsü.
nasîh ›ƒž‰: (Nesh. den) Battal eden, hükümsüz bırakan. * Kitabın kopyasını çıkaran.
nasîh ›ÿˆ: Nasihat eden, öğüt veren. * îçi temiz adam.
nasîh ›ƒˆ: (Nâsiha) (Nush. dan) öğüt veren, nasihat eden.(...Hastalık ise birden gözünü açtırır. Vücuduna ve cesedine der ki: "Lâyemut değilsin, başıboş değilsin, bir vazifen var. Gururu bırak, seni yaradanı düşün. Kabre gireceğini bil, öyle hazırlan." îşte hastalık bu nokta-i nazardan hiç aldatmaz bir nâsih ve ikaz edici bir mürşiddir. Ondan şekva değil, belki bu cihette ona teşekkür etmek; eğer fazla ağır gelse sabır istemek gerektir. L.)
nasîhâne: f. öğüt vererek, nasihat ederek.
nasîhat ›ÿˆ…: îbret verici ders, tavsiye, ihtar, öğüt.
nasîhat-âmîz: f. îçinden öğüt alınacak söz.
nasîhat-nâpezîr: f. Nasihat dinlemez, öğüt tutmaz.
nasîhatger: f. Nasihat eden, öğüt veren.
nasîhatkâr: f. Nasihat eden, öğüt veren.
nasîhatpezîr: f. Nasihat tutar, öğüt tutar, öğüt dinler.
nasîk: (Nesak. dan) Düzenleyen, tertib eden.
nasîk: Allah yolunda ibâdet eden, dine bağlı, zâhid.
nasîl: çenelerin altından boyun ile başın kavuştuğu yerde olan mafsal.
nasîl: Kıl dökücü ilâç.
nasîr ›ƒ†œ: Nesir yazan. * Saçan, yayan.
nasîr: Nusret eden, zafer veren. Yardımcı. Muin.
nasîye ›ƒÿœ: çehrenin gösterişi, alın, yüz.
nasîye-pîra: f. Alnı süsleyen.
nasîye-sâzî: f. Alnını yere sürme.
nasîyesâ: f. Alnını yere süren.
nasîyy: Yaş ot.
nasîyye ›ÿœ: Nass oluş. Kat'ilik, şüphesizlik, kesinlik. (Bak: Nass)
nasl ›™: Okun ucundaki sivri demir. okun uçmasına yardım eden kanatlar.
nasnaa: Depretmek. * Devenin, kalkarken dizi üstünde çok eğlenmesi.
nasr ›œ: Yardım, üstünlük, yenme, galip kılma. * Yağmurun her yeri sulaması.
nasr suresî: Kur'an-ı Kerim'deki 110. Sure. îza-câe veya Tevdi' Suresi de denir.
nasranî ›œƒ›ÿ: Hristiyanlıkla alâkalı ve ona mensub olan. Hristiyanlardan olan. (Bak: Nasara)
nasranîyet ›œƒ›ÿ : Hristiyanlık.(Nasraniyet, ya intifa veya ıstıfa edip îslâmiyete karşı terk-i silâh edecektir. Nasraniyet, bir kaç defa yırtıldı, protestanlığa geldi. Protestanlık da yırtıldı, tevhide yaklaştı. Tekrar yırtılmağa hazırlanıyor, ya intifa bulup sönecek veya hakiki Nasraniyetin esasını câmi' olan Hakaik-ı îslâmiyeyi karşısında görecek, teslim olacaktır.îşte bu sırr-ı azime Hz. Peygamber (A.S.M.) işaret etmiştir ki; "Hz. îsa nâzil olup gelecek, ümmetimden olacak, şeriatımla amel edecektir." M.)
nasreddîn: (Nasr-üd din) Dine yardımı dokunan.
nasreddîn hoca ›œ‚ƒ™šÿ›‚‰ƒ‡œ: (Mi: 1208 -1284) Mizahlı, güldürücü sözleri ile meşhur bir zâttır. Akşehir, Sivrihisar Medreselerinde okumuş, Selçuklular zamanında yaşamıştır.
nasrullah: Allah'ın yardımı.
nass ›: Kat'ilik, kesinlik, açıklık. Te'vile ihtimali olmayan söz veya delil. * Kur'ân-ı Kerim veya Hadis-i şerifde bir iş ve mes'ele hakkında olan açıklık ve bu şekilde açık olan kelâm ve âyet. Akide. * Bir haberi kimden aldığını söyleyerek, en nihayet o haberi ilk söyleyene kadar nakledilişi isbat etmek.Bazılarınca istihraç ve izhar mânâlarından me'huzdur. Bir şeyin belâğ ve nihayetine denir. Bundan başka: Delil, haber, seyr-i şedid, ref', hüccet, bürhan, zuhur mânalarına da gelir.
nass-i hadîs ›‚ˆšÿ†: Hadisin açık, gerçek ifadesi. Muhtemeli olmayan sağlam mânaya delâlet eden lâfız. Delil mânâsına olan "Nass-ül fukaha" bundan alınmıştır.
nass-i kati': Mânâsı açık olan Kur'an âyetlerinden delil olarak gösterilen âyet.
nassah: Terzi, hayyat.
nassî ›ÿ: Nass'a ait. Her türlü şübhe ve tereddüdün ve tenkidin üstünde tutulacak şekilde olan kesinlik, kat'ilik, açıklık. Bedahet. * âyet ve hadisle doğruluğu sâbit olan.
nassîye: (yun: Dogmatizm) Fls: Bir görüşün doğruluğuna peşin olarak inanan ve bu inanışlarını tenkide tabi tutmayanların düşünüş tarzı. Son heceleri .. izm ile biten görüşler, taraftarlarınca peşin olarak kabul edildiklerinden birer dogmatik görüş örneğidir. Meselâ; komünizm, materyalizm, darvinizim, birer dogmatizm mâhiyetindedirler. îslâmda zorlama yoktur, inanç için bilgi ve tefekkür esastır. Hakiki düşünce hürriyeti îslâmda vardır. îslâm dışında ...izmle biten görüşler önderlerini tartışılmaz otorite olarak kabul eder ve karşı görüşte olanlara her türlü baskı ve zulmü reva görürler.
nast ›…: Sükut. Konuşurken dinlemek için susmak.
nasuh ›ˆ: Hâlis. Temiz. Kesin, kat'i. * çok nasihat eden.
nasuhî: (Nasuhiyye) Bozulmaz şekilde tövbe eden.
nasur: Göz pınarında, mak'at havâlisinde ve diş etlerinde olur bir hastalık.
nasus ›: (Bak: Nass)
nasut ›ƒž…: însanlık. însanlar ve onlarla alâkalı şeyler.
nasutî: Dünya ile ilgili, insanlığa ait, insanlıkla ilgili.
nasutîyân: însanlar.
nasye: Her nesnenin iyisi.
na'ş ›”: Kefene sarılıp tabuta konmuş ölü. * Cansız vücud. 
naşit: Büyük yoldan ayrılan küçük yol. * Vahşi sığır. Bir burçtan başka burca varan yıldız. * Neşeli ve şen adam.
naşî ›ƒÿ: Neş'et eden, yeniden vücuda gelen, yetişen, yetişmiş. * Delil, dolayı, ötürü, sebebiyle. * Geceleyin meydana gelip zâhir olan şey. * Yetişmiş oğlan veya kız.
naşîb: Hâfız. * Ok sahibi. îçine girip yapışan nesne.
naşîd(e): (Neşide. den) şiir söyleyen, şiir okuyan, şiir yazan.
naşîe ›ƒ¡œ: Delil. Zuhur. * Gündüz veya gecenin evvelki saati. * Uykudan sonra kalkmak hali ve uyanık olduğumuz hal.
naşîle: Eti az olan.
naşîr ›ƒœ: Neşreden, yayan. * Bir müellifin eserini bastırıp çıkartan. Editör.
naşîre: (C.: Nevâşir) Kolu açan adale. * Kuruyup yağmurdan yeşeren ot.
naşîtat ›ƒ’ƒ…: Meleklerden bir tâife.
naşîz: Karısına karşı çok zâlim olan koca. * (Kalb) heyecanla coşma. * Kalkmış, kabarmış, atan (damar).
naşîze ›ƒœ: Kocasının hanesinden, izni olmaksızın çıkıp kendisini kocasından haksız yere men'eden kadın. Bu çıkış hakikaten olabileceği gibi, hükmen de olabilir. * Kabarmış, şişmiş.
na't ›”…: Medih ve senâ ederek, vasıflarını göstererek bir şeyi anlatmak. * Peygamberimiz Aleyhissalâtü Vesselâmı medhederek yazılan kaside.
nat' (nata'-nit'): (C.: Nütu'-Entâ') Sahtiyan döşek. * Zahir olmak, âşikâre olmak, görünmek.
nat'-i zemîn: Yer yüzü. Sath-ı Arz.
natafan: Suyun seyelân etmesi, akması.
natafe: (C.: Nutuf) Küpe.
natakte ›’—…: Söyledin. (mânasına karşısındakine hitabdır)
natef: Bulaşmak. * Fâsid olmak, bozulmak.
nates: (C.: Entâs) üstad, âlim.
natfe: (Nıtfe) : Kabarcık. * Ufacık sivilce.
nath ›’ˆ: Süsmek. Hayvanın, başı ile saldırması.
natif: Beyaz kaba helva.
natih: (C.: Nevâtıh) Boynuzuyla vuran, süsen hayvan. * Keder, sıkıntı, elem, mihnet.
natik ›ƒ’—: Konuşan. Söz eden, söyleyen, beyan eden. îdrak eden. Bildiren. Fikir ederek düşünen. * Altın ve gümüş gibi olan mal.
natika ›ƒ’—œ: (Nutk. dan) Düşünüp söylemek hassası. Fesahat ve belâgatta söyleme kuvveti. Talâkat-ı lisan, güzel konuşabilme kabiliyeti.
natika-î cemîyet: Cemiyetin nâtıkası, yâni: Söz söyleme kudreti.
natikaperdaz: f. Düzgün ve te'sirli söz söyleyen.
natikiyyet: Konuşmaklık, söz söylemeklik.
natir ›ƒ’œ: (Nâtur) Bekçi. Bağ ve bostan bekçisi.
natis: Bilgili, faziletli adam.
natîh: (Nâtıh) : (C: Nevâtıh) Sana karşı gelen hayvan. * şiddetli emir.
natîha: (C.: Netâyıh) Başka davar tarafından boynuzlanıp öldürülmüş olan davar.
natîş: Kuvvet ve hareket.
natm: Ulaştırmak, vardırmak.
natnat: (C.: Netânıt) çok konuşan uzun boylu, akılsız kimse.
natnata: çok söylemek, çok konuşmak. * çekmek.
nats: Nadas.
natş: şiddet. Kuvvet.
natşan: Susuz kalmış kişi.
natuh: çok süsen hayvan.
natuk: (Nutk. dan) Güzel ve düzgün söz söyliyen.
natul: îlaçlarla kaynatıp mâlül kişinin az az başına dökülen su.
natura ›ƒ’œœ: Lât. Her canlının yapılış hususiyeti, bünye, yaratılış hali.
natüralîzm: (Osm: Tabiiye) Fls: Kâinatta hâdiselerin ve varlıkların meydana gelişinde tabiat kuvvetleri dışında hiçbir sebep ve müessir kuvvet ve yaratıcı kabul etmeyen inkârcı, maddeci görüş.
natv: Iraklık, uzaklık, bu'd.
naur: Kanı durmayan damar. * Değirmen kanadı. * Döndükçe gıcırdayan dolap.
naure: (C.: Nevâir) Bostan dolabı.
naus: f. Manastır, kilise.
naus: Yüksek yer.
nav: f. Küçük gemi. Sandal, kayık. * îçi oyuk şey.
navdân: f. Oluk.
nave: f. Hamur teknesi.
navek: f. Ok.
navek-endaz: f. Okçu. Ok atıcı.
navek-î kalbî: îçten, kalbden çekilen âh.
naver: f. (C.: Naverân) Olabilir, mümkün, kabil.
naverân: (Naver. C.) Olabilir şeyler, mümkün olan şeyler.
naverd: f. Savaş, harb, dövüş, ceng.
naverdgâh: f. Savaş alanı, harb sahası, muharebe meydanı.
naverdhâh: f. Savaş isteyen, muharebe arzulayan.
navî: f. üç direkli gemi. * îçi oyuk olan şey.
navîce: f. Murdar, pis, habis, mülevves.
navus: (C.: Nevâyis) Kâfirlerin ve Mecusilerin mevtalarını koydukları yer.
na'y ›”ÿ: ölüm haberi getirmek.
nay ›ƒÿ: Ney. Kamış düdük. (Bak: Ney)
nay-çe: f. Küçük ney.
nayban: f. Ney çalan.
na'ye: Birisinin öldüğünü bildiren söz. * Bir adamın zünub ve kabahatini izhar ve işaa eden söz.
nayî: Uzak.
nayî: f. Ney çalan.
nayî': Susuz. * Mâil, eğik.
nayîbe: (C.: Nâibat-Nevâib) Musibet, belâ. * Zahmet, meşakkat. * şiddet.
nayîha: Yas tutan kadın.
nayîl: Atâ, bahşiş, hediye. 
nayîn: f. Kamıştan yapılmış, sazdan yapılmış.
nayveş: f. Ney gibi.
nayzen: f. Ney çalan.
na'z ›”“: Münteşir olmak, yayılmak. * Kıvama gelmek.
naz ›ƒ: f. Bir şeyi beğenmeyiş, şımarıklık. * Beğendirmek maksadiyle kendini ağır satmak. * Celb-i muhabbet için edilen nezâket, letâfet ve zarafet. * Yalvarma, rica.(îşte ubudiyetin esası olan, acz ve fakr ve kusur ve naksını bilmek ve niyaz ile dergâh-ı Uluhiyete karşı secde etmeğe bedel, naz ve fahr suretinde gidenler; zerrecik kalbini arşa müsavi tutar, katre gibi makamını deniz gibi evliyanın makamatı ile iltibas eder; kendini o büyük makamata yakıştırmak ve o makamda kendini muhafaza etmek için tasannuata, tekellüfata, mânâsız hodfüruşluğa ve birçok müşkülâta düşer. L.)
naz-perdar: f. Birinin nazını çeken.
naz-perdarî: f. Naz çekme.
naz-perverd: (Nâzperverde) f. Naz içinde büyümüş, nazlı.
nazad: (C.: Enzâd) şeref. * üzerine herhangi bir şey konulan yüksekçe yer.
nazafet: Pâklık, temizlik.
nazah: (C.: Enzâh) Havuz.
nazaîf ›“ƒ¡–: (Nazif. C.) Nazifler. Nazafetli, temiz kimseler.
nazaîr ›“ƒ¡œ: Nazire. Nazireler. Benzerler, örnekler.
nazan ›ƒƒ›: f. Nazlı. Nazdar.
nazar ›‘œ: (Nazaret) Altın. * Tazelik.
nazar ›“œ: Göz atmak. Mülahaza, düşünmek, bakmak, imrenerek bakmak, düşünce. Yan bakış, kötü bakış. Bir türlü kabul etmek. * Gözdeğmesi. * îltifat. * îtibar.
nazar-bâz: f. Neşe ile bakan.
nazar-endaz ›“œ‚¤›šƒ: f. Göz atmak. Göz atan, bakan, nazar eden.
nazar-fîrîb: f. Göz aldatan.
nazar-gâh ›“œªƒœ: f. Bakılan yer. Nazar edilen yer.
nazar-i haram: Haram nazar. Nâmahremlere bakmak. (Bir genç hâfız, pek çok adamların dedikleri gibi dedi: "Bende unutkanlık hastalığı tezayüd ediyor, ne yapayım?" Dedim: Mümkün oldukça nâmahreme nazar etme. çünki rivayet var. îmam-ı şafii'nin (R.A.) dediği gibi: Haram nazar, nisyan verir. Evet, ehl-i îslâmda, nazar-ı haram ziyadeleştikçe, hevesat-ı nefsaniye heyecana gelip, vücudunda su'-i istimalât ile israfa girer. Haftada bir kaç def'a gusle mecbur olur. Ondan, tıbben kuvve-i hâfızasına zaaf gelir.Evet, bu asırda açık saçıklık yüzünden, hususan bu memalik-i harrede o su'-i nazardan su'-i istimalât, umumi bir unutkanlık hastalığını netice vermeğe başlıyor. Herkes, cüz'i külli o şekvadadır. îşte, bu umumi hastalığın tezayüdiyle, hadis-i şerifin verdiği müthiş bir haberin te'vili ucunda görünüyor. Ferman etmiş ki: "âhirzamanda, hâfızların göğsünden Kur'an nez'ediliyor, çıkıyor, unutuluyor." Demek bu hastalık dehşetlenecek bazılarda o su'-i nazarla hıfz-ı Kur'an'a sed çekilecek; o hadisin te'vilini gösterecek. $ K.L.)
nazar-i san'at-perverane: San'atkârane bakış.
nazar-i şârî': îlâhi nazar.
nazar-i şuhud ›“œ‚œš: şâhidlerin, şehâdet edenlerin görmesi ve tetkikleri.
nazar-i takdîr: Kıymet biçme bakışı, takdir bakışı.
nazar-rübâ: f. Göz çeken.
nazaran: Nisbeten, nisbetle kıyaslıyarak. * Bakarak, görerek.
nazarî (nazarîye): Nazara ve düşünceye ait. Yalnız görüş ve düşünce hâlinde bulunan ve tatbik edilmemiş hâlde olan bilgi.
nazarîyyât ›“œÿƒ…: (Nazariye. C.) Görüşler. Düşünceler. Doğruluğu isbat edilmemiş ilmi görüşler.
nazbalîn: f. Yastık.
nazbalîş: f. Yastık.
nazc: Olgunluk, olma, pişme, kıvam bulma. Yetişme. * Büluğa erme. Bâliğ olma.
nazc-i kabl-el vakt: Zamanından önce büluğa erme.
nazd: Her şeyi yerli yerine koymak.
nazdar ›ƒšƒœ: f. Nazlı. Naz yapan. şımarık. * Meşhur bir cins lâle.
nazekî: Nâziklik, incelik.
nazende: f. Nazlı, naz edici, naz yapan.
nazenîn ›ƒ›ÿ›: f. înce, nazlı, zayıf, lâtif, hoş eda olan, nazlı yetişmiş, şımarık. Oynak. Nazik endamlı
nazh: Su çekme. Herhangi bir yer, çukur veya kuyudan bir şeyler çıkarma.
nazh: Su serpmek, su saçmak. * Suyun çok olması. * Suyun, pınarından çıkıp akması. * Defetmek, kovmak.
nazh: Bulaşmak.
nazha: Yağmur.
nazic: Olgun, pişmiş, kıvama gelmiş, yetişmiş.
nazih: (C.: Nevâzıh) Deve ile su çekilen kuyu.
nazim ›ƒ“š: Nizamlayan, nazmeden. Manzume yazan, düzenleyen.
nazimâne: f. Nazım olana yakışır surette.
nazimîn: (Nâzım. C.) Tanzim edenler, düzenleyenler, nizama koyanlar.
nazir ›ƒ“œ: (C.: Nüzzâr) Nazar eden, bakan. * Bir idarenin veya dairenin umur ve işlerine bakan en büyük memur. Bir işin idaresine memur reis. * Kabine azalarından herbiri. Nâzır. Vekil. Bakan. * Vâsinin yapacağı tasarruflara nezarette bulunmak üzere musi veya hâkim tarafından tayin olunan zat. (Ist. Fık. K.)(Bir noktayı tam yerinde icad etmek için, bütün kâinatı icad edecek bir kudret-i gayr-ı mütenahi lâzımdır. Zira, şu kitab-ı kebir-i kâinatın herbir harfinin, bâhusus zihayat herbir harfinin, herbir cümlesine müteveccih birer yüzü, nâzır birer gözü vardır. M.)
nazir ›ƒ‘œ: Taze, tazeleşen.
nazira: Nazar eden, nezaret eden, bakan. * Göz.
nazira-hân: f. Bakarak taklid eden.
naziyy: (C.: Enzâ) Boğaz.
nazî': çekici kimse. * Husumet eden, düşmanlık eden.
nazîat ›ƒ”ƒ…: Hz. Azrâil'in (A.S.) avenesi olan bir taife melâike ki; şerli ve kötü ruhlu insanların canlarını şiddetle alırlar. * Nez'edenler. çekip koparanlar.
nazîat suresî: Kur'an-ı Kerim'in 79. Suresidir. Sâhire ve Tâmme Suresi de denir.
nazîc: Pişmiş, yetişmiş, olgunlaşmış, kıvamına ermiş.
nazîd: (Nazide) Tertibli, nizamlı, yerli yerinde. * Minder yastık vs. gibi ev eşyası.
nazîf(e): Temiz, pâk, nazik.
nâzîk ›ƒ˜: f. Nezaketli. Terbiyeli. Zarif. înce, dayanıksız. * Ehemmiyet verilmesi icab eden. * Tehlikeli husus.
nâzîk-beden: f. Vücudu, bedeni nâzik olan.
nâzîk-edâ ›ƒ˜‚¤šƒ: f. Nâzik tavırlı, kibar.
nâzîk-endâm: f. Lâtif ve güzel vücutlu. Nâzik endamlı.
nâzîk-güzîn: f. çok nâzik. Seçkin, nâzik.
nâzîk-hulk: Yaradılışı ve tabiatı nâzik olan.
nâzîk-ten: f. Nâzik vücudlu.
nâzîk-ter: f. çok nâzik.
nâzîk-terîn: f. En nâzik, daha nâzik.
nâzîkâne ›ƒ˜ƒ›œ: f. Nazik kimseye yakışır şekilde, kibarlıkla, terbiyelice.
nâzîkî: f. Nâziklik. Nezaket.
nâzîl ›ƒ™: (Nüzul. dan) Nüzul eden, inen, yukardan aşağıya inen, bir yere konan. Bir yerde konaklayan.
nâzîle ›ƒ™œ: Belâ, sıkıntı. * înme, nüzul. * Nezle hastalığı.
nazîm: Sıra sıra, dizi dizi olan şey.
nazîr ›ƒ‘œ: Tâze. * Altın.
nazîr(e) ›“ÿœœ: Bir şeye benzemek üzere yapılan şey. Denk, eş, örnek. Benzeyen. * Edb: Bir şairin manzumesine, başka bir şair tarafından aynı vezin ve kafiyede olmak üzere yapılan benzer.
nazîre ›“œœ: Mühlet vermek, tehir etmek.
nazîreg: f. Nazire söyliyen.
nazîye: Kenarı az olan çanak.
nazîz: (C: Nizâz-Nezâyız) Az miktar su. * Az yağmur. * Az az akmak.
nazl: Ok atmak.
nazm ›“š: Sıra, tertib. * Kafiyeli, vezinli, söz, şiir. * Dizili olan şey. * Kur'an âyetleri.
nazm-i celîl ›“š‚‡™ÿ™: Pek büyük kıymetli nazm edilmiş güzel söz. * Kur'an-ı Kerim'in bir vasfı. * Celil olan Cenab-ı Hakk'ın nazmı.
nazm-i lafz: Kelâmın, lâfız esas alınarak düzenlenmesi.
nazmen ›“šøƒ: Nazım olarak, manzume halinde. Sıralı ve tertibli olarak.
nazmîyyat: (Nazm. C.) Manzum yazılar.
naznaza: Yılanın dilini çıkarıp hareket ettirmesi.
nazperver: f. Naz eden, naz yapan.
nazr: (Nazir) : (C.: Enzur) Altın.
nazra: (Bir tek) bakış.
nazragâh: f. Gözle bakılan yer, bakış yeri. Göz önü.
nazrakünân: f. Seyrederek, bakarak.
nazre: Cin gözü. * Nazarı değen adam.
nazret: Tazelik, tarâvet.
nazume: Bir cins renkli kumaş.
nazur: (C.: Nevâzır) Gece bekçisi.
nazükî: f. Nâziklik, incelik.
nazz: (Nâzz) : Dirhemler ve dinarlar.
nazzam ›“ƒš: En çok nazmedici, en güzel nazmedici, en güzel tanzim eden.
nazzare: Bir şeye bakan kavim.
ne ›œ: f. "Değil, yok," mânasına nefy edâtıdır.
ne-şebem ›œ‚„š: f. Ben karanlık gece gibi nursuz değilim (meâlinde.)
ne-şebperestem: Karanlık ve zulümatı seven ve isteyen değilim.
ne-şüküfte: f. Açılmamış.
neab: Karga yavrusu. * Horoz veya karga gibi ötme.
neaîm: (Neâme. C.) Deve kuşları.
ne'al: Nalbant.
neam ›”š: "Evet, olur" mânâsında cevap edâtıdır. * Pek iyi, âferin mânâlarında tasdik ve tahsin kelimesidir. * At, deve, sığır, koyun gibi dört ayaklı hayvana da denir.
neam-la: Evet, hayır. " Doğru fakat, mes'elenin içinde senin hatırına gelmeyen şu da var." mânâsınadır.
neama' ›”šƒ£: Nimetler. îhsan, atiyye. * Rahatlık. Refah-ı hâle sebep olan şey.
neamat: (Neâme. C.) Deve kuşları.
neame: (C: Neâm-Neamât) Deve kuşu. * Cemaat. * Gölgelik, gölgelenecek yer.
ne'ar: Baş kaldıran, âsi, kafa tutan, serkeş.
neayîm: Menazil-i kamerden dört nurlu yıldızın adı.
ne'b ›ýƒ„: (C: Niyeb) Sâfi nesne. * Yaşlı dişi deve.
neb' ›„ýƒ: Gizli ses.
neb' ›„”: Suyun çıkıp akması. * Bir ağaç cinsidir ve yay yaparlar, budaklarından da ok yapılır.
neb'a ›„”œ: Yay yapacak yer.
neba' ›„”: Kaynak olmak, pınardan su çıkarmak, su akması. * Akçaağaç.
nebaa: Oturacak yer, kıç, mak'at.
nebac: Sesi yüksek olan. 
nebagat: Meydana çıkma.
nebah ›„ƒˆ: (Nibâh-Nübâh) Köpek havlaması. * Yılan seslenişi. * Keçi ve geyik inleyişi.
nebahe(t): (Nebahat) şeref, şan, onur, itibar. * şan, şeref ve itibar sâhibi.
nebaîl: (Nebile. C.) Yüceler, ulular, yüksekler.
nebaîr: (Nebire. C.) Torunlar.
nebale(t) ›„ƒ™ : Zekâ, fazilet ve neciblik sâhibi olmak. * Büyüklük, azamet. * îyi olmak. * Cömertlik, elaçıklık. * Okçu, ok yapıp satan. Okçuluk.
nebat ›„’: Acem fellahlarından bir kabile.
nebat ›„ƒ…: (C: Nebatât) Topraktan yetişen, biten her çeşit şey. Bitki. * Yemen diyarında bir kabile adı.
nebatât: (Nebât. C.) Nebâtlar, bitkiler.
nebatî ›„ƒ…ÿ: Nebat cinsinden, nebata mensup ve nebata ait, yerden biten cinsinden olan.
nebatîyyun: Botanik bilginleri, botanik âlimleri.
nebbac: Sesi sert olan.
nebbah: Havlayıcı.
nebbal: Ok yapıp satan kimse. Okçu.
nebbar: Fasih dilli, güzel konuşan adam.
nebbaş: Mezar soyucu, kefen soyucu.
ne'be ›ýƒ„œ: (C: Nâibat) Musibet, belâ.
nebe' ›„ƒ£: Haber. (Peygam)
nebe' suresî: Kur'an-ı Kerim'de 78. Suredir. Amme Suresi de denir.
nebe'-aver: f. Haber getiren.
nebean ›„”ƒ›: Kaynayıp yerden çıkmak. Pınar suyunun çıkışı. Fışkırmak.(Demek ki şu enharın nebeanları, âdi ve tabii ve tesadüfi bir iş değildir. Belki pek hârika bir surette Fâtır-ı Zülcelâl onları sırf hazine-i gaybdan akıttırıyor. S.)
nebehrece: Geçmez bakırlı para. Sahte akçe. * Her nesnenin kötüsü.
nebeke: (C: Nübük-Nebâk) Tepe.
neberd: f. Muhârebe, savaş, harb, ceng.
neberd-azmâ: f. çok muhârebelerde bulunmuş tecrübeli kimse.
neberd-pîşe: f. Harb etmeyi sanat edinmiş kimse. Savaşçı.
neberde: f. Savaşçı, muhârib.
neberdgâh: f. Savaş yeri, muharebe sahası.
nebevî ›„ÿ: Nebiye ait. Peygambere dâir. Peygamberle alâkalı.
nebez: (C: Enbâz) Lâkab.
nebg: Un öğütülürken tozan un. * Görünmek, zâhir olmak.
nebh: (C: Nevâbih) Kabarcık. * Toprak.
nebh: Köpeğin ürüyüp uluması.
nebh: Bir şeyi tenbih etmek, unuttuğunu hatırlatmak. * Ansızın bulunan. Yitik. * Ansızın yitirmek. * Uykudan uyanmak. * şerefli olmak. * Meşhur olmak, ün salmak.
nebha: Yüksek, beyaz yer. 
nebî ›„ÿ: Haber getiren. Peygamber. Yeni bir kitap ve şeriatla gelmeyip kendinden evvelki Resülün getirdiği kitap ve şeriatı devam ettiren Peygamber. (Bak: Resül)
nebî-yî efham: En büyük, en kıymetli olan Hz. Peygamber (A.S.M.)
nebîb: (C: Enbüb) Boğum, kamış boğumu.
nebîh: (Nebihe) Namlı, şanlı şerefli.
nebîh: ît avazı, köpek uluması.
nebîk: (C: Nebâyık) Sedir ağacının yemişi.
nebîl: (Nebile) Akıllı, anlayışlı, zekâ sahibi. * Yüksek meziyet sahibi. Güzel huylu. * Bilgili ve faziletli kimse.
nebîle: Büyük, iri. (Bak: Nebil)
nebîr: (Nebire) Torun. 
nebîse: Kız torun.
nebîse: Kuyu toprağı. Irmak toprağı.
nebît: Muhkem, sağlam, katı.
nebîyy: Yükseklik. * Yol.
nebîyyü-l haram ›„ÿ‚ƒ™ˆœƒš: Mescid-i Haram Nebisi meâlinde. Resül-i Ekremin (A.S.M.) bir ismi.
nebîyyü-r rahmet ›„ÿ‚ƒ™œˆš : Bütün âlemler için Rahmete vesile olduğundan peygamber Efendimiz için söylenmiş bir isimdir.
nebîyyü-t tevbe ›„ÿ‚ƒ™…„œ: Resül-i Ekremin (A.S.M.) bir ismi. (ümmetinin tevbelerinin kabul edileceğine işâreten bu isim verilmiştir.)
nebîz: (C: Enbize) Hurma şarabı. * Yola bırakılıp atılan çocuk.
nebk: Yazmak. * Husumet etmek, düşmanlık yapmak. * Düz etmek, düzleştirmek.
nebl ›„™: Ok. Ok hazırlamak.
nebr: (Nibr) : (C: Enbâr - Nibâr) Keneye benzer bir küçük böcek. * Yukarı kaldırmak, yükseltmek.
nebras ›„ƒœž: (Nibrâs) (C.: Nebâris) (Süryânice) Kandil. çıra. Lâmba. * Mc: Nur merkezi.
nebre: Demir parçası.
nebs ›„†: Yeri kazma, toprağı kazma. * Eser, nişan.
nebs: Söylemek.
nebş: Gömülü bir şeyi yerden çıkarma. * Bir şeyi diğer bir şey vasıtasıyla meydana çıkarma.
nebt: Bitme, yerden çıkma. Meydana gelme. * Ot.
nebt: Suyun yerden çıkıp akması.
nebta: Yanları beyaz olan dişi koyun.
nebv: Sakız.
nebve ›„œ: Uzaklaşmak. * Ok hedefe varamamak. * Bir yerin havasının mizaca uygun olmaması. * Kılıncın vurulan şeye saplanmayıp geri sıçraması. * Pek çirkin ve kötü suretten gözün kaçması.
nebve: (Nebâve) Yüksek yer. * Yükseklik.
nebz ›„‹: Bırakmak. * Az miktar, cüz'i.
nebz ›„: Bir kimseyi ayıplamak. Kötü lâkabı takmak, istihzâ etmek. * îhtiyarlık işareti belirmek.
nebz ›„‘: (Nebezân) : Damarın hareket etmesi.
nebz-î ahd: Muâhedeyi feshetme.
nebze ›„‹œ: Az miktar, cüz'i, bir şeyin artığı.
neca ›‡ƒ: Göz değmek.
neca ›‡ƒ£: Evmek. Acele etmek. * Halâs olmak, kurtulmak.
necabet ›‡ƒ„…: Neciblik, temiz soyluluk. Huy temizliği.
necadet: Kahramanlık, efelik, yiğitlik.
necah ›‡ƒˆ: Zafer bulmak, murâda ermek, ihtiyaçlarını te'mine muvaffak olmak.
necah: Ses, sadâ.
necaîb ›‡ƒ¡„: (Necib. C.) şerefli, necib, asil, temiz kimseler.
necare: Dülgerlik, neccarlık.
necaset ›‡ƒž…: Pislik, kazurat, murdarlık. (Bak: Habes)
necaset-î galîza ›‡ƒž…‚•™ÿ“œ: Pisliği hakkında şer'i bir delil mevcut olup hilâfına başka bir delil bulunmayan necasettir. ( Lâşe gibi) 
necaset-î gayr-î mer'îye ›‡ƒž…‚•ÿœ‚šœ¡ÿœ: Câmid, bir hacmi olmayan veya bulaştığı yerde görülmeyen herhangi bir pis maddedir. Görünmez halde olan pisliktir. (îdrar gibi)
necaset-î hafîfe ›‡ƒž…‚‰–ÿ–œ: Hanefi mezhebine göre pis olduğuna dair şer'i bir delil mevcud olan şeydir. Diğer bir tabire göre murdar olmadığı rivayet edilen şeydir. (Eti yenen hayvanların bevilleri gibi.) Bedenin veya elbisenin dörtte birinden az miktarı namaza mani olmaz.
necaset-î kalîle ›‡ƒž…‚—™ÿ™œ: Katı şeylerden ise miskalden; sıvı ise el ayası sahasından geniş olan necaset, namaza mânidir. Bu miktardan fazlası necaset-i galizadır.
necaset-î mer'îye ›‡ƒž…‚šœ¡ÿœ: Hacmi olan veya kuruduktan sonra görünen herhangi bir pis maddedir. (Akmış kan gibi)
necasetten taharet: Pislikten temizlenmek. (Bak: Taharet)
necaşe: Süratle yürümek, hızlı yürümek.
necaşî (nîcâşî) ›‡ƒÿ: Habeş Meliki olan "Eshame" nin lâkabıdır. Kamus şârihinin dediğine göre, mutlaka bu isim, Habeş Meliklerinin has isimleridir.
necat ›‡ƒ…: Kurtuluş, selâmet. * Hırs ve hased. * Yüksek mekân. * Ağaç budağı. * Mantar.
necatî: Kurtulmaya ait, kurtulmakla ilgili.
necb: Ağaç kabuğunu soymak.
neccad: Yorgancı. Yatak, yastık, yorgan gibi şeyler yapan.
neccah: Yorgancı.
neccar: Doğramacı. Marangoz. * Dülger. 
neccaş: Hayvan sürücüsü.
neccîna ›‡›ƒ: Bizi kurtar, bize selâmet ver, bizi hıfzeyle (meâlinde dua).
necd ›‡š: Açık ve işlek yol. * Yüksek yer. * Minder, döşeme gibi oturacak şeyler. * Ağaçsız mekân. * Hâzık ve mâhir kılavuz. * Yiğitlik hâli. Gamlılık, gussa. * Hasma galip gelmek. * çok terlemek. * Meme. * Suudi Arabistan'ın doğu mıntıkası.
necdet ›‡š : Yiğitlik, şecaat, kahramanlık. * Harp ve kıtal. *Yeis, korku.
nec'e: şiddetli nazar. şiddetli bakış.
neceb: Ağaç kabuğu.
necef: (Necefe) : (C: Nicâf-Encâf) üzerine su çıkmayan yer. Tümsek yer, yüksek, tepe, sırt. * Irakta bir şehrin adı.
necefe: Büyük askı kandil.
necel: Büyük gözlülük. îri gözü olmak.
necer: Koyun ve devenin suyu içip kanmaması.
neces: Murdarlık, pislik, necâset.
neceş: Değeri artırmak için almak. * Bir kumaşın pahasını artırmak. * Dağılmış şeyleri bir yere toplamak. * örtmek, setretmek.
nech: Men' ve reddetmek.
necîb ›‡„: Cömert, kerim kişi.
necîb ›‡ÿ„: Soyu ve nesli temiz, aslı kerim olan. Cömert. Asilzâde. Güzel huylu ve ahlâklı.
necîbe: Soyu sopu temiz kimse. Cömert. Asilzâde.
necîd ›‡š: Kahraman, bahadır. * Arabistan'da bir memleket ismi. * Münbit yer. Fitne ve nifak yeri olan memleket. * Arslan.
necîf: (C: Nicef) Geniş temrenli olan ok. 
necîh ›‡ÿˆ: Galip ve muzaffer. * Sabırlı. * Sağlam rey.
necîh: Su sesi.
necîl: (Necile) Soyu temiz. Soylu. * Ağaç yaprağından bir cins.
necîre: Bulamaç aşı.* Kızgın taş ile kızdırılmış su. * Kârgir duvar. * Tahtadan veya ağaçtan olan sofa. * çulhaların beze sürdükleri haşil.
necîs: Temiz olmayan. Pis.
necîs ›‡ž: Pis, necasetli, murdar. * şifa bulmaz dert. (Bak: Habes)
necîs ›‡ÿ†: Yavaş hareketli insan veya hayvan. * Gizli olan şeyi halk içinde ifşa etmek. * Gizlenen sır, nişan. * Bir nevi yeşillik.
necîs-ül ayn ›‡ÿž‚ƒ™”ÿ›: Pisliğin ta kendisi.
necîse: Kuyudan çıkardıkları toprak.
necîy ›‡ÿ: Sırdaş, sır saklayan.
necîyya ›‡ÿøƒ: (Münâcât. dan) Gizli yalvararak, gizli söyleyerek.
necîyyullah ›‡ÿ‚ƒ™™õœ: Resül-i Ekrem'in (A.S.M.) bir ismi. (Devamlı Cenab-ı Hakk'a karşı teveccühle meşgul ve münacatla, îlâhi feyizlerle inşirah bulan meâlindedir.)
necl: (C: Encâl) Oğul, evlât, çocuk. * Kuşak, nesil, sülâle. * Atmak. * Ayak ucuyla vurmak. * îstihrac etmek, meydana çıkarmak. * Yerden çıkan su.
necl-î necîb: Soyu temiz çocuk.
necm ›‡š: (Necim) Yıldız, ahter, kevkeb. ülker yıldızına da denir. ülker, onbir yıldızdır. Altısı görünür, gözü kuvvetli olan yedinciyi de görebilir. (Peygamberimiz (A.S.M.) hepsini de görür idi.) * Belirli olan vakit. (Araplar, vakti yıldızlarla tahdit ederlerdi) * Kabak ve hıyar gibi yayvan nebat.* Belirli vakitte yapılan vazife. * Kur'an-ı Kerim. * Ceste ceste, kısım kısım oluş. * Kur'an-ı Kerim'in her defa inzal edildiği kısım. * Huk: Bir borcun taksitlerini ödemek için hulül eden muayyen borç.
necm suresî: Kur'an-ı Kerim'in 53. Suresidir. Vennecmi Suresi de denir. Mekkidir.
necm ü hîlâl ›‡š‚‚ˆ™ƒ™: Yıldız ve ay.
necm-î dirahşan: Parlayan yıldız.
necm-î sâkib ›‡š‚†ƒ—„: Karanlığı delerek geçen parlak yıldız.
necm-üd dîn ›‡š‚ƒ™šÿ›: (Bizde daha çok Necmeddin şeklinde telâffuz olunur) Dinin necmi, yıldızı meâlindedir.
necmeddîn: (Bak: Necm-üd din)
necmeddîn-î kübra ›‡š‚ƒ™šÿ›‚˜„œƒÿ: (Mi: 540 - 618) îran Mutasavvıflarının en mühim şahsiyetlerindendir. Kübreviyye veya Zehebiyye ismi ile anılan tarikatın kurucusu sayılır. îsmi: Ahmed bin ömer Eb-ul Cenab Necmeddin Kübra el-Hivaki el-Harzemi.Münazara ve mübaheseyi çok sevdiği ve her münazarada hasımlarını yendiği için kendisine "Ettâmmet-ül Kübra" lâkabı verilmiş, sonradan sadece "Kübra" denilmiştir. Moğolların Harzem'i istilâsında şehri terk etmeyerek, onlara karşı kahramanca çarpışarak şehid düşmüştür. (K.S.)
necmî ›‡šÿ: Yıldıza dair, yıldızlarla alâkalı.
necnece: Geriye döndürmek. * Engel olmak, men'etmek. Bir nesneyi aşağı getirmek. * Zayıf etmek, zayıflatmak.
necr: Ağaç yonmak. * şiddetli sevk. * Asıl. * Renk. * Halâs, kurtuluş.
necran: Susuz. * Kapı ökçesi. ("süve" denir). * Yemen diyarında bir yerin adı.
necs ›‡ž: (Neces) Pis ve murdar olan, habes. şer'an pis olup gözle görülen şey.
necs: Yerden define çıkarmak. * Kuyuyu ayıklamak.
necş: Avı yatağından çıkarma. * Dağılmış parçaları toplamak.
necv: (C: Nicâ) Yüzmek. * îki kişi arasında olan sır. * Karından çıkan necis.
necva ›‡ƒ: Gizli fısıltı. îki kişi arasında fısıldamak. * Ağız koklamak. * îki kişi arasındaki sır.
necve: Tümsek, yüksek yer.
necz: Bitip tükenmek. * îhtiyaç bitirmek. * Vâdeyi yerine getirmek.
ned': Dikkat etmek.
neda ›šÿ: Rutubet, çiğ, nem.
nedaîd: (Nedid ve Nedide C.) Emsâller, akranlar, eşler.
nedalet: Kir, pislik. * çalma, sirkat etme, aşırma.
nedamet ›šƒš…: (Nedm. den) Pişmanlık, nedâmet etmek.
nedametgâh: f. Pişmanlık yeri.
nedametkâr: f. Nedamet eden. Pişman olan.
nedametkârî: f. Pişmanlık, nâdim oluş.
nedan: f. Bilmeyen, bilmez.
nedaret: Tazelik, parlaklık, letafet, taravet.
nedavet: Yaşlık, ıslaklık, nemlik, rutubet.
nedb: Dua etmek.
nedbe: (Bak: Nedebe)
nedd: Gitmek. * Kaçmak.
neddaf: Hallâç. Pamuk atan kimse.
nedebe: Yara izi.
nedem: Pişman olma, nedamet, pişmanlık.
nedf: Pamuk ditme, pamuk atma.
nedg: Kılıçla veya sözle taan etmek, çekiştirmek.
nedh: Geniş yer.
nedh: Men'etmek, engel olmak.
nedhe: (Nüdhe) : çokluk, fazlalık.
nedî': Ateş veya kül içinde pişmiş olan.
nedîb: Yara izi kalan âzâ.
nedîd(e): (C.: Nedâid) Emsâl, akran, eş.
nedîf: Atılmış, hallaçlanmış pamuk. Yün.
nedîm: (C.: Nedmân - Nüdemâ) Sohbet arkadaşı, meclis arkadaşı. * Tatlı konuşan. Güzel hikâye anlatan. * Büyük kişileri hikâye ve fıkralarıyla eğlendiren.
nedîme: Kadın nedim. * Zengin veya şerefli, itibarlı bir kadının arkadaşı.
nedîs: Akıllı kişi.
nedl: Kir. * Hırsızlık.
nedm: Pişman olmak.
nedman: Pişmanlık, nedâmet. Pişman olma. Pişmanlık duyma.
nedret ›šœ…: Azlık, seyreklik, az bulunmak.
neds: Akıllılık. * Taan etmek, çekiştirmek.
neds: Huruç etmek, çıkmak.
nedş: Her nesneyi eritip sormak. * Pamuk atmak.
nedve: Yaşlık, nemlilik. * Meşveret etmek. Bir işi hakkında görüşmek. * Konuşmak.
neec: Yel esmek, rüzgâr esmek. * Yalvarmak, tazarru etmek.
need: Belâ, musibet. Zahmet, meşakkat.
nef' ›–”: Fayda, yararlılık. * Fls: Faydacılık. Yani: Bir şeyin doğru olup olmadığını, o şeyin faidesine göre değerlendiren yanlış bir nazariyedir. Kudsi dinimiz olan îslâmiyette ise: Bir şeyin doğru veya yanlış; iyi ve kötü olması, Allahın emir ve nehyine tâbidir.
nef u zarar ›–”‚‘œƒœ: Kâr ve zarar.
nefad ›–ƒš: (Nefed) Bitip tükenmek, yok olmak.
nefaîs: (Nefise. C.) Değerli, güzel ve beğenilir şeyler.
nefaîs-perest: f. Nefis şeyleri beğenenen, güzel şeyleri seven.
nefak: (C.: Enfâk) îki kapılı ev.
nefaset ›–ƒž…: Beğenilir olmak, kıymetlilik, değerlilik, çok güzellik, pek iyilik. Nefis ve mergub olmak.
nefaz: Ağaçtan kendi düşen yemiş ve yaprak.
nefaz: Geçme, işleyip öte tarafa geçme. * Sözü geçme, sözü dinlenme.
nefc ›–‡: çıkmak, huruc etmek.
nefd: Tükenmek, bitmek. * Geçici ve fâni olmak.
nefean ›–”øƒ: Faydalı olarak.
nefean lî-l-umum ›–”øƒ‚™™”šš: Herkes için faydalı oluş.
nefed: Bitirme, tükenme, bitirilme.
nefehat: (Nefha. C.) Esintiler. üfürmeler.
nefel: Düşmandan alınan mal, ganimet. * Ulü-l emrden müsaade almadan düşmana karşı çıkan az sayıda bir cemaat.
nefer ›–œ: Bir kişi, tek kişi. * Asker, er. (Bazılarınca insan cemaati. Ona kadar olan adam topluluğuna denir. üçten ona kadar olan kişilere "Reht" denir.)
neferât: (Nefer. C.) Neferler, askerler, erler.
nefes ›–ž: Soluk, üfürülen hava. Soluma, soluk verip alma. * Uzun söz. * Bolluk. * Hased etmek. *Edb: Bektaşi tekkelerinde okunan manzum söz.
nefeza (nefza): (C: Nefâyız) Düşmanın ahvâlini bilmek için dolaşan kavim.
nefezan: Sıçramak.
neffa': (Nef'. den) çıkarı çok olan kimse.
neffac ›–ƒ‡: Mütekebbir. Kendini beğenen. Mağrur. * şişkin.
neffah: Hayır sâhibi ve iyiliksever kimse. * Kokusu çok.
neffas ›–ƒž: Sihir yapan, üfüren, üfürükçü.
neffasât: (Neffâse. C.) Neffâseler, büyücü kadınlar.
neffase: (C: Neffâsât) Büyücü kadın.
neffata: Neft yağı çıkan pınar.
nefh ›–ˆ: Rüzgâr esmek. * Güzel kokunun yayılması. Kokmak. * Vurmak. * Def'etmek, kovmak. * Vuruşmak, kat'etmek.
nefh ›–‰: üflemek, şişmek, üfürük. * Kaba kuşluk vaktine varmak.
nefh-î sur ›–‰‚œ: îsrafil Aleyhisselâm'ın Kıyamet gününde "Sur' denilen boruyu üflemesi. * Kıyamet kopması. (Bak: Acbüzzeneb)
nefha: üfürmek. üfürük. * şişmek. * Kabarık olan.
nefha ›–ˆœ: Koku. Rüzgârın hafif esişi. Azıcık koku.
nef'î ›–”ÿ: Menfaat ile alâkalı, faydacı. * Sihâm-ı Kaza nâmındaki hicivli şiirleri ile meşhur Erzurum - Hasankale'li olup îstanbul'da yaşamış bir şâirin adıdır. 1634'de 4. Murad devrinde bir hicviyesinden dolayı boğdurulup denize atılmıştır.
nefî ›–ÿ: (Bak: Nefy)
nefîf: Hevâ.
nefîr ›–ÿœ: Cemaat, topluluk. * Harp için seferber olan cemaat.
nefîs: (Bak: Nefs)
nefîs-perest ›–ž„œž…: şeriat kanunlarına aykırı olarak, ahlâk kaidesini tanımadan nefsinin isteklerine uyan. Nefsine taparcasına düşkün olan.
nefîs-perver ›–ž‚„œœ: f. Nefsini çok sevip besleyen, nefsi isteklerine çok düşkün.
nefîs(e) ›–ÿž: Pek beğenilen, pek güzel, pek iyi.
nefît: Kaynamak, galeyan.
nefîte: Unu suya koyup kaynatıp koyulaşıncaya kadar karıştırmak.
nefîy: (Bak: Nefy)
nef'îyyet ›–”ÿ…: (Nef'i) Fls: Faydacı, faydacılık.
nefîz (nefeze): Okun geçmesi gibi içe geçmek, işlemek. * Sözü geçer olmak.
nefk: Helâk olmak.
nefl ›–™: Sevab için yapılan ibâdet. Emredilmemiş, farz veya vâcib olmadan yapılan ibadet. Nâfile. * Birisine ganimet malı veya atiyye, ihsan vermek. * Yemin etmek.
nefr: Heyecan verici bir emirden dolayı bir yerden bir yere fırlayıp çıkmaktır. ürkmek demek olan "Nüfur" da bu mânâdandır. Fakat "Nüfur" tek başına kaçıp kurtulmak için menfi bir harekette kullanıldığı hâlde; "nefr", düşmana karşı gaza için fırlayıp çıkmakta kullanılır. Ve böyle çıkıp toplanan cemaate "nefir", herbirine de "nefer" denilir.îmamın, halkı cihada dâvet ve tahrik etmesine de "istinfar" tâbir olunur ki, lisanımızın şimdiki ıstılâhında "seferberlik emri", frenklerde de "mobilizasyon" yâni, halkı yerinden oynatma tâbir edilir. (E.T.)
nefret ›–œ…: Tiksinmek, ürküp kaçmak. * Birisinin yakını ve akrabası.
nefretbahş: f. însana nefret veren, iğrendiren, tiksindiren.
nefrîn ›–œÿ›: Lânet, beddua. * Söğüp saymak.(Hassasiyet-i ilmiyenin tezayüdüyle ve her günde otuz bin cenazeyi gösteren mevtin ikazatıylae o gaflet perdesi parçalanıyor. Ecnebilerin tağutlarıyla ve fünun-u tabiiyeleriyle dalâlete gidenlere ve onları körü körüne taklid edip ittiba' edenlere binler nefrin ve teessüfler. L.)
nefrîn-hân: f. Sövüp sayan.
nefrîn-künân: f. Lânet okuyan, sövüp sayan.
nefs ›–†: üfürmek, üflemek.
nefs ›–ž: (Nefis) Can, kişi, kendi, öz varlık. Bir şeyin zatı olan, kendisi. * Göz. * şehvet ve gadabın mebdei olan kuvve-i nefsaniye. Fıtri meyil, bedenin hissi istekleri. * Ruh, hayat, asıl. * Maya. * Hamiyet.(Evet, nefsini beğenen ve nefsine itimad eden bedbahttır. Nefsinin ayıbını gören, bahtiyardır. M.)
nefs: Gülme hususunda ifrata gitmek. * çok fazla gülmek.
nefs-î amel ›–ž‚”š™: Amelin ta kendisi.
nefs-î emmare ›–ž‚¤šƒœœ: însanın çirkin ve şeytanın teşviklerine itirazsız ve mücahedesiz tâbi olması hâli.(Nefs-i emmârenin istibdad-ı rezilesinden selâmetimiz îslâmiyete istinad iledir. O habl-ül metine temessük iledir. Ve haklı hürriyetten hakkıyla istifade etmek, imandan istimdat iledir. H.)(Bir zaman evliya-yı azimeden; nefs-i emmaresinden kurtulanlardan birkaç zattan, şiddetli mücahede-i nefsiyeler ve nefs-i emmareden şekvalarını gördüm. çok hayret ediyordum. Hayli zaman sonra, nefs-i emmarenin kendi desaisinden başka, daha şiddetli ve daha ziyade söz dinlemez ve daha ziyade ahlâk-ı seyyieyi idame eden ve heves ve damar ve âsab, tabiat ve hissiyat halitasından çıkan ve nefs-i emmarenin son tahassüngâhı bulunan ve nefs-i emmareyi tezkiyeden sonra onun eski vazife-i seyyiesini gören; ve mücahedeyi, âhir ömre kadar devam ettiren bir mânevi nefs-i emmareyi gördüm. Ve anladım ki, o mübârek zatlar, hakiki nefs-i emmareden değil; belki mecazi bir nefs-i emmareden şekva etmişler. Sonra gördüm ki, îmam-ı Rabbani dahi bu mecazi nefs-i emmareden haber veriyor.Bu ikinci nefs-i emmarede şuursuz kör hissiyat bulunduğu için, akıl ve kalbin sözlerini anlamıyor ve dinlemiyor ki onlarla ıslâh olsun ve kusurunu anlasın. Yalnız tokatlar ve elemler ile nefret edip, veya tam bir fedailikle her hissini maksadına feda etsin. K.L.)
nefs-î hayvanî ›–ž‚ˆÿƒ›ÿ: Hayvani istekler. Canlılardaki yaşama ve hareket kuvvetleri.
nefs-î îhbar ›–ž‚ƒ‰„ƒœ: Tam haber. Haberin tam esası.
nefs-î levvame ›–ž‚™ƒšœ: Kötülüğü işledikten sonra fenâlığını hatırlayarak insanı rahatsız eden pişmanlık hâli ve vicdan rahatsızlığı. * însanın, kendine ait kötülük ve günahını görüp fenalığını bilen ve hayra meyleden iradesi.
nefs-î mardîye (marzîyye): Kusurlarını bilen, kendisinden râzı olunan nefis. Rabbinin indinde makbul olan nefis.
nefs-î mutmaînne ›–ž‚š’š¡›œ: îyiliği kötülükten ayırt ettirerek insanlık vazifesini tanıttıran ve vicdanına rahatlık veren hâl. însanı Allah'a yaklaştıran hâl. Günaha meyleden kötü sıfatlardan temizlenmiş ve güzel ahlâk ile muttasıf olarak kurb-u îlâhiye itmi'nan ve istikrar kazanmış olan insan iradesi. Nefsin, Allah'ın emirleri altına sakin ve şehevâta muâraza ederek ıztırabdan kurtulmuş olma hâli.
nefs-î mülheme ›–ž‚š™œšœ: Tas: Lüzumu hâlinde Cenab-ı Hak tarafından kendisine hakikatlar ilham edilen, tasaffi ve tekâmül etmiş nefis.
nefs-î mütekellîm: Gr: Birinci şahıs. (Bak: Mütekellim-i vahde)
nefs-î nâtika ›–ž‚›ƒ’—œ: Akli ve nakli mes'elelerin münasebetlerini hissetmeğe ve anlamağa istidadı olan zâti ve cevheri hassası. Zâtında maddeden mücerred, fiilinde maddeye mukarin olan cevher. însan ruhu.
nefs-î râdîye ›–ž‚œƒ‘ÿœ: f. Rabbinden râzı ve hoşnud olanın nefsi.
nefs-ül emîr ›–ž‚ƒ™¤šœ: Hakikatın kendisi. îşin hakikatı.
nefsa: (C.: Nefsâvât-Nüfüs-Nifâs-Nevâfis) Yeni doğum yapmış kadın. Loğusa.
nefsanî ›–žƒ›ÿ: Bedeni arzu ve isteklerle alâkalı. Zaruret olmadığı hâlde keyf için olan istek ve arzuya ait. Kendine ait ve mensub.
nefsanîyet ›–žƒ›ÿ…: Nefsini çok beğenmişlik. * Gizli düşmanlık, garez, kin.
nefsî ›–žÿ: Nefis ile, kendisi ile alâkalı. şahsa ait, nefse dair.
nefsî nefsî ›–žÿ‚›–žÿ: "Benim nefsim", "nefsim nefsim" mânâsına yalnız kendini düşünmeyi ve kendisiyle olan alâkayı ifâde eden bir tâbir.
nefş: Açmak. * Yapmak. * Yün ve pamuk atmak. * Davarların, geceleyin yayılıp çobansız otlaması.
nefşele: Yürüken toprağı ayağıyla tozutmak.
neft ›–’: Neft yağı. çam gibi bazı ağaçlardan çıkarılan, tutuşabilen bir yağdır ve boyacılıkta vesair sanayide kullanılır.
neft (nefît): çömleğin kaynayıp taşması ve içinde yemeğin kuruması. * Galeyan.
nefta: (Nifta) (C: Nefat) çalışmaktan dolayı elde çıkan kabarcık.
neftî: f. Neft yağı renginde olan, siyaha yakın koyu yeşil.
nefuh: Sütü sağılmadan çıkıp akan deve.
nefur: ürken, ürküp kaçan. * Herkese iyiliği dokunan kimse.
nefuz: çocuk düşüren kadın.
nefy ›–ÿ: Sürgün etmek. Birisini kendi rızası olmadan, bir yerden başka bir yere nakletmek, sürmek. * Gr: Bir şeyin olmadığını ifade eden (olumsuzluk) edatı. Müsbetin zıddı, menfi olan. Bir şeyin yokluğunu veya olmadığını iddia. (Bak: înkâr)(îşte küffarın ve ehl-i dalâletin bir hakikat-ı imaniyeyi inkâr ve nefyetmelerinde kuvvet yoktur. çünkü, nefiy sırrıyla ittifakları kuvvetsizdir. Bin nefyediciler, bir tek hükmündedir. Meselâ: Bütün îstanbul ahalisi, Ramazanın başında Ayı görmediğinden nefyetse, iki şâhidin isbâtiyle o cemm-i gafirin nefiy ve ittifakı sukut eder. L.)(Nefiy dahi iki kısımdır.Birisi: "Has bir mevkide ve hususi bir cihette yoktur." der. Bu kısım ise, isbat edilebilir. Bu kısım da bahsimizden hariçtir.îkinci kısım ise: Dünyaya ve kâinata ve âhirete ve asırlara bakan imani ve kudsi ve âmm ve muhit olan mes'eleleri nefiy ve inkâr etmektir. Bu nefiy ise... hiçbir cihetle isbat edilmez. Belki kâinatı ihata edecek ve âhireti görecek ve hadsiz zamanın her tarafını temâşâ edecek bir nazar lâzımdır; tâ o gibi nefiyler isbat edilebilsin. ş.)
nefy edâti ›–ÿ‚¤šƒ…ÿ: Arabçada "Lâ", Farsçada "Nâ" gibi olumsuzluk bildiren edât.
nefy-î ebed: Bir daha dönmemek üzere nefyedip sürme.
nefy-î mülk: Bir malın başkasına ait olduğunu söyleme.
nefyan: Vurma ânında yara ve cerahatten akan kan.
nefz: Saçma, yayma. Neşretme. * Silkmek. * Nazar etme, bakma.
negatîf: Fr. Mat: Sıfırdan küçük, önünde eksi işareti bulunan sayı. Menfi. * Gerçekteki karanlık ve aydınlık kısımları tersine gösteren fotoğraf camı veya filmi. ( Bak: Menfi)
negühîde: f. çirkin, kötü.
neha ›œƒ: Pek akıllı adam. * îhtiyacı terkeylemek. (Güya kendi nefsi cihetinden menedilmiş demektir.)
nehabîk: Bildikleriyle amel etmeyip halka da öğretmeyen.
nehabîr: (Nühbur. C.) Kum yığınları, kum tepeleri.
nehafe: Tıksırmak, aksırmak. * Nefes verip almak.
nehafe: Zayıflık.
nehak: Eşek anırtısı.
nehake(t): Bahadırlık, kahramanlık, şecaat. * Keskinlik.
nehamî: Demirci.
nehar ›œƒœ: (C.: Enhür) Fecrin doğuşundan güneşin batışına kadar olan aydınlık. * Toy kuşunun yavrusu. * Altın.
nehar-i ebyaz ›œƒœ‚¤„ÿ‘: Gündüzün beyazlığı, gündüze benzeyen beyazlık. Beyazlığın parlaklığı.
nehar-i örfî ›œƒœ”œ–ÿ: Güneşin tuluundan gurubuna - doğuşundan batışına - kadar olan zaman.
nehar-i şer'î ›œƒœ‚œ”ÿ: Fecr-i sadıktan güneşin batışına kadar olan müddet.
neharen: Gündüzün. Gündüz vakti.
neharî: Gündüzlü, gündüz ile alâkalı. * Yatılı olmayan mekteb veya talebe.
nehave: (Et) çiğ olmak.
nehb ›œ„: Yağma, yağmacılık, çapul. * At oynatmak, koşturmak. * Kahr ile bir kişinin malını elinden almak.
nehbe: Kapmak.
nehber: Helâk olacak yer.
nehc: Yol, usul. * Doğru yol.
nehd: îri gövdeli ve karınlı at.
nehda': îyi otlar yetişen kumlu arâzi.
nehdan: Dolu, dolmuş. 
nehec: (C: Menâhic) Yol, tarik. * îstikâmet.
nehel: Susuz olmak. * îçmenin evveli. * Yaşlı, ihtiyar. * Semiz etli deve.
nehem ›œš: (Nehim - Menhum) Aç gözlü oluş. şikemperver olmak. Doymak bilmemek. Bir şeye çok düşkün, şehvetli, haris.
neheng: (C.: Nehengân) f. Timsah.
nehengân: (Neheng. C.) f. Timsahlar.
neher: Genişlik, bolluk. * Nehir, ırmak.
nehhab: (Nehb. den) Yağmacı, çapulcu.
nehhac: (Nehc. den) Kılavuz, rehber, mürşid. Doğru yolu gösterici.
nehhal: Toprak kazan, kazıcı.
nehham: Yüksek ve gür sesli kimse. * Arslan.
nehhas: Nehs'in mübalağası. * Bir kişinin lakabı.
nehhas: Esirci. 
nehhat: Yüce avazlı, gür sesli kişi.
nehhat (nühhat): çalıştırılan sığır. * înce. * Hımar, eşek. * Sadaka toplamaya memur olan kişinin işini bitirdikten sonra ücretini alması.
nehîb: (Nehb. den) Korku, dehşet, ürküntü. * Yağmacı, çapulcu.
nehîb: înlemekle ve ses ile olan ağıt.
nehîde: Kalın kaymak.
nehîf: Zayıf.
nehîh: Boğaz içinden gelen ses.
nehîk: Bahâdır, kahraman. * Arslan. * Keskin kılıç. * îyi huylu kimse.
nehîk: Anırtı, eşek anırtısı.
nehîm: Aç gözlü, doymaz. * Yırtıcı. * Arslan kükremesi.
nehîr: Burun içinden çıkan ses, hırıltı. 
nehîre ›‰œœ: çürümüş, ufalanmış, rüzgârla savrulur. Delik deşik, göz göz olmuş. * Rüzgâr estikçe ses verir kemik, çürümüş kemik. (Nâhir de denir)
nehîre: Ayın evveli.
nehît: înlemek. * şiddetle teneffüs etmek, nefes alıp vermek.
nehît: Eşek anırtısı. Hımar avazı.
nehîte: (C.: Nehâyet) Tabiat.
nehîy ›œÿ: Yasak etmek. Menetmek. * Gr: Emrin menfi şekli.
nehîzet: Tabiat. * At kulağına benzer dokunmuş nesne.
nehk ›œ—: Eşek bağırışı.
nehk: Zayıf etmek, zayıflatmak. * Eskitmek. * Mübâlağa etmek.
nehme: Hastaların ve çocukların yiyeceğe karşı olan hırsı, oburluğu.
nehmet ›œš…: Himmet, maksat, yüksek himmet. Harislik. şehvet.
nehnehe: Dar kaftan, dar elbise.
nehr ›œœ: çay, ırmak. * Vüs'at, bolluk. Genişlik.
nehr ›ˆœ: Boğazlamak, kesmek. * Namazda sağ elini sol eli üzerine koymak. * Sadr, göğüs.
nehr-üs sema ›œœ‚ƒ™žšƒ£: Samanyolu. Kehkeşan.
nehren: Nehirden. Nehir yoluyla.
nehreyn: îki nehir.
nehrî: (Nehriye) Nehirle ilgili, nehre ait. 
nehs: çok yaramaz nesne. 
nehs: Kabzetmek, almak. * Yılan sokması. * Eti ön dişiyle almak.
nehsek: Yaban havucu.
nehş: Yılan sokmak. * Almak, kabzetmek. * ön dişiyle bir nesneyi ısırır gibi tutmak. * Et almak.
nehşel: Kurt, zi'b. * çakır. * Erkek ismi.
neht: Yontmak. Oymak.
neht: çağırmak. * Ses, avaz. * Men'etmek, engel olmak.
nehud: f. Nohut.
nehur: Burnuna vurmayınca veya burnuna parmak sokmayınca sütünü salıvermeyen deve.
nehus: (C.: Nehâyıs) Gebe eşek.
nehuset ›ˆž…: (Bak: Nühuset)
nehva ›ˆƒ: Bir şey kasdetmek. Bir şey söylemeği istemek. * Bir şey yapmağa evvelden hazırlanmak.
nehy: (Bak: Nehiy)
nehyî an-îl münker ›œÿ‚”›‚ƒ™š›˜œ: Allah'ın haram kıldığı şeyleri işlemekten men'etmek, haram işleri yaptırmamak ve buna çalışmak.
nehz ›œ‘: Ayağa kalkmak, deprenip kalkmak, hareket.
nehz: Durmak, kıyam. * Def'etmek, kovmak. * Yakın olmak. * Berkitmek için devenin memesine eliyle vurmak. * Dolması için kovayı suya vurmak.
nehz: Süngü demirini inceltmek. * Kemik üstündeki eti soyup gidermek. * çok et.
nehz: Vurmak. Dövmek. * Haykırmak.
nehzat: Hareket, davranma, kalkışma. Yola çıkma.
neîb: Karga sesi. * Ağaçtan yemiş indirmek. * Süt sağmak.
nek': Dizine ayağın arkasıyla vurmak. * Def'etmek, kovmak.
nek'a ›˜”œ: Kalkan dikeni üstündeki kızıl kap. * Her kırmızı olan şey.
nekâ' ›˜ƒ£: Yarayı kaşımak. * Soymak. * çok azap etmek, acı çektirmek.
nekab: Devenin tabanı aşınmak.
nekabet: Muayyen zümrelerin başları. * Bir topluluğun vaziyetlerine nezâret etmek, kontrol.
nekâbet: Dönme, vazgeçme, cayma.
nekabet-î ulemâ: âlimlerin başı olma.
nekad: (C.: Nukyud-Nikâd) Ayakları kısa, yüzü çirkin koyun. * Büyümesi geç olan çocuk. * Ağızda dişler çürüyüp ufanmak. * Davarın tırnağı soyulup yüzülmek.
nekahet ›—ƒœ…: Hastalıktan yeni kalkıp henüz iyileşmiş, iyiliğe yüz tutmuş olmak hâli. Hastalıkla sıhhat arasındaki hâl. * Fehmetmek, anlamak, bilmek. * Seri intikal etmek. çok çabuk anlayış.
nekaîs ›—ƒ¡ž: (Nakise. C.) Nakiseler. Noksanlar.
nekaîz ›—ƒ¡‘: (Nakize. C.) Nakizeler. Birbirine zıd şeyler.
nekâl ›˜ƒ™: şiddetli azab. îşkence ve ukubet. * îbret.
nekam ›—ƒš: (A, uzun okunur) Bir kimseyi kötü bir fiilinden dolayı şiddetle cezalandırmak. întikam almak.
nekâre: Güçlük, zorluk. * Belirsizlik.
nekave(t): Her şeyin iyisi, seçkini. * Temizlik, paklık.
nekavet-î vîcdân: Vicdan temizliği.
nekâyat ›˜ƒÿƒ…: çarklar. * Vakitler.
nekayî': (Nakia. C.) Ziyâfetler.
nekaz: (C: Enkâz) Her nesnenin kötüsü, kıymetsizi.
nekb: Musibet ve kedere uğrama. * Meyletmek, eğilmek. * Udul etmek, vazgeçmek, haktan dönmek.
nekba: Esince adamı eğip düşüren rüzgâr. Fırtına.
nekbe: (C.: Nekebât) şiddet, meşakkat. * Bir şeyin kesilmesiyle olan cerahat.
nekbet: (C.: Nekebât - Nükub) Talihsizlik, şanssızlık, bahtsızlık. * Musibet, felâket. * Düşkünlük.
nekbethane: f. Tâlihsizlik yuvası. * Mc: Dünya.
nekbetî: f. Tâlihsiz, bahtsız, şanssız, uğursuz.
nekbetzede: f. Felâket görmüş, musibete uğramış.
nekd: (Nekâde) (C.: Enkâd) Hayırsız olmak.
nekda': Sütü olmayan deve.
nekeb: Hastanın iyileşmesi. * Devenin omuzlarında olan bir hastalık.
neked: Sıkıntı, dert, keder. Belâ, musibet.
nekefe: (C.: Nüküf-Nükfân) çene altında olan küçük bez.
nekel: Kuvvetli kişi.
nekes: (Nâ-kes) Cimri, tamahkâr, hasis.
nekesan: Ardına dönmek.
nekf: Göz yaşını yanağından parmağıyla silip gidermek. * Kuyudan su çekmek. * Arlanmak.
nekh: (Nikâh) (C.: Enkihe) Tezevvüc, evlenme, cimâ etme. * Akit.
nekhet: (Bak: Nükhet)
nekîb: (C.: Nukabâ) Halkın iyisi. * Kâhya. * Kefil. * Müfettiş, kontrolcü.
nekîb: Deve, at ve eşek ayaklarının dâiresi.
nekîbe: Nefsi mübârek.
nekîr ›˜ÿœ: Bilinmemiş olan. Muayyen olmayan. * Mezarda iki sual meleğinden birisinin adı. (Diğerininki; münkerdir)
nekîre: (C.: Nekerât) Belirsiz.
nekîse: Hilâf, ters. * Nefs.
nekkad ›—ƒš: Bir şeyin iyisini kötüsünü seçen kimse. * Paranın sağlamını kalpından ayıran. * îmam, hatib ve kayyum gibi hizmet sahiblerinin, vazifelerine devam edip etmediklerini murakabe ve devam etmiyenlere tenbihat, icra ve devamsızlıkları tesbit eden vazifeli kişi.
nekkar: Ağaçkakan kuşu. * Değirmenci. * çok hayırlı. * çok kokulu.
nekl: Yular. At gemi. * Ezâ, cefâ etmeğe ve işkence yapmağa yarayan şey.
nekmet ›—šœ: (Bak: Nikmet)
nekr ›˜œ: Zeki, akıllı kimse. Pek zeyrek olan. * Dehâ, fetânet.
nekre ›˜œœ: Belirsiz olan. * çıban ve yaradan çıkan kan ve irin. * Garip ve gülünç fıkralar. * Hoş sohbet ve hazır cevap kimse. * Gr: Belirtilmemiş isim, neye delâlet ettiği belli olmayan (harf-i tarifsiz) isim.
nekre-g: f. Tuhaf hikâyeler fıkralar anlatan. Gülünç sözler söyleyen.
nekre-î mevsule ›˜œœý‚š™œ: îki kelime veya mânâyı birbirine bağlayan kelime.
nekre-î tâmme ›˜œœý‚…ƒšœ: Mübhem mânâ ifade eden kelime.
neks: Sözünden dönmek. * Bozmak. çözmek. * üzmek. * Dağıtmak. * Münhal ve muhtel olmak.
neks: çok çekinmek, kaçınmak.
neks (nüküs): Başaşağı etmek, ters döndürmek. * Aynı hastalığın geri gelmesi. (Bak: Nüks)
nekş ›˜: Kuyunun çamurunu temizlemek. * Bir şeyi bitirmek. Bir işden fâriğ olmak. * Bir şey üzerine gelip toplanmak.
nekt: (C: Nikât) Süngüyü yere vurmak. * Taan etmek, çekiştirmek.
neküs ›˜ž: (Nekis - Neküs) Baş aşağı etmek.
nekz: Vurmak. * Kovmak, def'etmek. * Yılan sokmak. * Azalmak. * Suyun, yer tarafından emilmesi.
nekz: Gayret etme, uğraşma, çok çabalama.
nell: Yüz üstüne bırakmak.
nem ›š: f. Rutubet, az yaşlık. Hafif ıslaklık.
nem-î dîde: Göz yaşı.
nema ›šƒ: Gelişme, büyüme. * Uzamak, artmak, çoğalmak, üremek. * Faiz.
nemadâr: f. çoğalan, ziyadeleşen. Artan, büyüyen.
nemaîk: (Nemika. C.) Mektuplar.
nemaîm: (Nemime. C.) Dedikoducular, çekiştiriciler.
nemarik ›šƒœ—: (Nemraka. C.) Yastıklar.
nemas: Kılın ince olması.
nemat: (C: Enmut-Nimât) Usul, tarz. * Yol, tarik. * örtü, ihram. * Topluluk, insan cemaati. * Döşek yüzü, yatak yüzü.
nemat-i takrîr: Söyleme tarzı. 
nemçe: Tar: Osmanlılar tarafından Avusturya ve Avusturyalı mânasında kullanılan bir tâbir idi.
nemdar: f. Nemli, ıslak, yaş, rutubetli.
ne'me: Nağme, ses.
nemed: f. Keçe.
nemed-pâre: f. Keçe parçası.
nemed-puş: f. Keçe giyen. Derviş.
nemed-zîn: f. At eğeri altına konulan keçe.
nemedîn: f. Keçeden yapılma.
nemek: f. Tuz. Milh. * Lezzet, tat. * Bağlılık, hak.
nemek-çeş: f. Tadına bakma, tatma.
nemek-dân: f. Tuzluk, tuz kabı.
nemek-efşan: f. Tat veren. Lezzetlendiren. * Tuz serpen.
nemek-haram: f. Tuz haini. * Mc: Nankör.
nemek-helâl: f. Tuz hakkı tanıyan. Bağlı, sâdık kimse.
nemek-perver: f. Sâdık ve bağlı kimse.
nemek-sud: f. Tuzlanmış, tuza bastırılmış, tuzlu şey. * Pastırma.
nemek-şînâs: f. Tuz tanıyan. * Mc: îyilik bilen.
nemekîn: f. Tuzlu, lezzetli, tadı yerinde. * Tuzlu gözyaşı.
nemeş: Dağınık, parçalanmış şeyleri toplamak. * Nakış hatları. * Yüzde olan siyah ve beyaz noktalar.
nemf: Küçük kurt (böcek).
nemga: çocukların beyni deprendiği yer. * Dağ üstü.
nemîdanem: Bilmiyorum.
nemîdîdem: Görmüyorum.
nemîka: (C.: Nemâik) Mektub. Name.
nemîme ›šÿšœ: Söz götürme. Lâf taşıma. Bir kimse aleyhindeki sözleri ifsad maksadıyla kendisine eriştirme.
nemîmekâr: f. Koğucu, fitneci, dedikoducu, münafık.
nemîn: Fısıltı. * Koğucu.
nemîr: Tatlı su.
nemîr: (C.: Nümur) Kaplan.
nemîre: Dişi kaplan. * Yün kaftan.
nemîs: Bittikten sonra yine biten ot.
nemk: Yazmak. * Düzeltmek.
nemkeşîde: f. Islak, nemli, yaş, rutubetli.
neml ›š™: Karınca.
neml suresî: Kur'an-ı Kerim'de 27. Sure olup Süleyman Suresi de denir. Mekkidir.
nemle: Bir tek karınca. * Vücutta olan karıncalanma.
nemm: Birinin sözünü başkasına götürüp ikisinin arasını bozma. Koğuculuk.
nemmal: Koğucu, dedikoducu, münafık.
nemmam: (Nemmas) : Koğuculuk ve nemimecilik eden. Dedikoducu.
nemnak: f. Nemli, yaş, ıslak.
nemnakî: f. Nemlilik, ıslaklık, yaşlık, rutubet.
nemreka: (C.: Nemârık) Yastık.
nemrud ›šœš: Zâlim ve gaddar olarak tanınmış ve Allaha karşı kibir ve isyan ile büyüklük taslamış bir kralın ismidir. Milâddan evvel 2640 yılında yaşadığı sanılmaktadır. Peygamber îbrahim Aleyhisselâm zamanında yaşamış ve onu ateşe atarak yakmak istemiş, mu'cize ile îbrahim Aleyhisselâm ateşten kurtulmuştur. Bâbil'in müessisi ve hükümdarı olup, en evvel hükümranlık ve tecebbür eden bu olduğu mervidir. (Bak: Enaniyet)
nems: Süt ve yağın ekşimesi. * Ekşimek ve kokmak. * Sırrı ketmetmek, gizlemek.
nemş: f. Hile, oyun, dalavere, desise.
nemy: Kaldırmak. * Yetiştirmek.
ne'nee: Zayıflık.
ne'nehava: Anason, kimyon.
neng: f. Ayıp, utanma, hayâ etme. * ün, şöhret, nam.
ner: f. Erkek, er.
nerbdan: f. Merdiven. (Neverdi bâm'dan alınmıştır. Neverd; kıvrım, büküm; neverdiden; tayyetmek, dürmek; bam, ban; tavan mânalarına gelirler. üst kata merdivenle çıkıldığından, neverdibâm yerine hafifletilmişi olan nerdbân denilmiştir.)
nere: f. Dalga. * Erkek.
nere-î âb: Su dalgası.
nergîs ›œªž: (Nerges - Nercis) îri papatya biçiminde ortası yeşil veya sarı, yaprakları gri ve sarı bir çiçek. Suyu, uyuşturucudur. Mahmur bakışı andırır.
nergîs-dân: f. Nergis saksısı.
nergîsî: f. Nergis biçiminde kesilip yapılan bir çeşit hamur işi.
nerîman: f. Pehlivan, yiğit, kahraman.
nerîmanî: f. Nerimanlık, kahramanlık, yiğitlik.
nerm ›œš: (Nermi - Nermin) f. Yumuşak. 
nerm nerm: f. Yavaş yavaş, âheste âheste.
nerm-âhen: f. Gevşek şey.
nermdîl: f. Yüreği yumuşak. Merhametli.
nermg: f. Yumuşak sözlü.
nermî: f. Gevşeklik, yumuşaklık.
nermîn: f. Yumuşak.
nermîyet: Yumuşaklık, gevşeklik.
nermlîgam: (Nerm-ligâm) f. îtaatli, muti, söz dinler. * Başı sert olmayan at.
nermsaz: f. Yumuşak adam.
nerre-şîr: f. Erkek arslan. 
nesa: (C.: Ensâ) Uyluk başından tırnağa kadar varan bir damar. * Te'hir etmek, sonraya bırakmak.
nesaî ›žƒ¡: (Bak: Kütüb-ü sitte-i hadisiyye)
nesaîc ›žƒ¡‡: (Nesice. C.) Dokumalar. Dokunmuş kumaşlar. Ette ve deride olan nescler, dokular. (Bak: Nesc)
nesaîh ›žƒÿˆ: (Nesâyih) (Nasihat. C.) Nasihatler, öğütler.
nesaîk: (Nesike. C.) Kesilen kurbanlar.
nesaîm: (Nesim. C.) Hafif ve lâtif rüzgârlar.
nesaîs: (Nesise. C.) Fesatlık için yapılan fısıltılar.
nesak: Tarz, usul, yol, şekil, üslub.
nesak-i vâhîd: Tek şekilde, tek tarzda, tek biçimde.
nesaksâz: f. Tertib eden, düzenliyen, tanzim eden, düzen veren.
nesar ›žƒœ: (C.: Nüsür - Ensür) Bir kuş adı. Gerges de denir.
nesc ›ž‡: (Nesic) Dokunuş, dokuma. * Canlı mahluklardaki hücrelerin, Allah'ın (C.C.) kudretiyle ve kanunu dâiresinde yanyana gelip birleşerek uzuvların yapılışı. (Meselâ: Hayvanlarda deri, kemik, et vesâir kısımların yapılışı gibi)
nescî ›ž‡ÿ: Nesc ile alâkalı.
nescolmak: Dokunmak, örülmek, örülü hâle gelmek. Kumaş dokunması, bez dokunması. (Canlıların vücudundaki nescolunmak gibi)
nes'e: Veresiye alma. Vade ile alma. * Tehir etmek.
neseb ›ž„: Sülâle, hısımlık, karabet, soy. Baba soyu, atalar zinciri. * Vuslat.
neseben: Soyca, sülâlece, soy bakımından.
nesebî: Neseb ve soya âit. Sülâle ile alâkalı.
nesel: Davar sağıldıktan sonra meme başlarında arta kalan sütü. * îki tarafı saf saf ağaçlar olan yol.
nesem ›žš: Soluk ruh, nefes. Rahatı mucib hâlet. * Rüzgârın lâtif, hoş esmesi.
neseme: (Nesme) : (C: Nüsüm) Nefs. însanın ve her nesnenin başlangıcı.
nesevî: (Neseviye) Kadına mensub, kadınla alâkalı, kadınlık.
nesevîyyet: Kadınlık.
nesf: Bir yapıyı temelinden yıkma.
nesfe: Dökülmüş ve saçılmış un.
nesg: Gitmek. * Almak. * Ağaç kesildiğinde çıkan su. * Vurmak. * Dürtmek.
nesh ›ž‰: Ist: şer'i bir hükmü yine şer'i bir emirle kaldırmaktır. (îtikada ait olan ve zamanla değişmeyen hükümlerde nesih olmaz, bunlar sabit birer hakikattırlar.) * Bir şeyin aynını kopya etmek, aynını çoğaltmak. * îbtal etmek, hükümsüz bırakmak, değiştirmek. * Nakletmek, kaldırmak, bir şeyi zâil kılmak. (Güneşin, gölgeyi giderdiği gibi.)
neshî ›ž‰ÿ: Nesihle alâkalı, neshe ait. * Bir cins yazı.
nes'î: Câhiliyet devrinde belirli vakti geciktirilmiş haram aylar.
nesî' ›žÿ: (C.: Ensâ) Yolcuların ve misafirlerin konakladıkları menzilde düşürdükleri esvap. * Unutkan. * Unutulan. Unutulmuş olmak. 
nesî' ›ž¡: Te'hir, sonraya bırakma.
nesîb ›žÿ„: Asil kadının vasfı. * Edb: Kasidenin âşıkâne olan mukaddemesi.
nesîc: (C: Nüsüc) (Nesc. den) Dokunmuş, nescolunmuş. 
nesîce: (C: Nesâyic) Dokunmuş, nescolunmuş şey.
nesîe ›žÿ¡œ: Veresiye almak. Satın alınan şeyin bedelini vermeyip sonraya bırakmak.
nesîf: îki kişi arasındaki sır.
nesîg: Ter.
nesîk: Düzenli, tertibli, nizamlı * Süslü, bezenmiş, donanmış.
nesîke ›žÿ˜œ: Hak yoluna kesilen kurban. * Altın veya gümüş külçesi. (Bak: Akika)
nesîl ›ž™: (Bak: Nesl)
nesîl ›ž™: Erimiş mumsuz bal.
nesîl ›†ÿ™: Kazıldığında çıkan kuyu toprağı.
nesîm ›žÿš: Hoşa giden, hafif ve lâtif esen rüzgâr.
nesîm-î nevbahâr: îlkbahar rüzgârı, tan yeli.
nesîm-î seher: Lâtif sabah rüzgârları.
nesîm-î subh: Sabah rüzgârı.
nesîm-î subh-dem: Sabah vakti esen rüzgâr, sabah rüzgârı.
nesîmî: Hafif hafif ve lâtif bir tarzda esen rüzgârla ilgili.
nesîr: Hayvan aksırması.
nesîre: Kuyu toprağı.
nesîs: Aşırı derecedeki açlık. * însan gücünün sonu. însanın en son tâkati. * Son nefes.
nesîs: Bir sıvının sızıp kabından dışarı çıkması.
nesîse: (C.: Nesâis) Fesatlık için yapılan fısıltı.
nesk: Bir kelâmı başka kelâma atfetmek.
nesl ›ž™: Soy, sop. Zürriyet, döl, kuşak. * Halk. * çocuk hâsıl etmek. * Kıl yolmak. * Mumsuz, süzme bal.
nesl ›†™: Kuyudan toprak çıkarmak. * Sadaktan ok çıkarmak.
neslan: çok yelmek. Evmek.
nesle: Geniş gömlek.
nesme: Fık: Satın alınan köle.
nesnas: Koğuculuk eden kişi. * Maymun.
nesne ›ž›œ: şey, herhangi bir şey.
nesr ›†œ: (Nesir) çoğaltmak, saçmak, yaymak. * Manzum olmayan söz veya yazı.
nesr ›žœ: Hamele-i Arş'tan olan bir melek. * Akbaba, kartal. * Nuh kavminin putlarından birisinin ismi. * Yarayı deşmek. * Kuşun, eti didiklemesi. * Birinin aleyhinde konuşmak. * Güneyde bir parlak yıldız. Buna Nesr-ül vâki' denir. Batıdaki yıldıza ise: Nesr-üt-Tair denir. * Atın tırnağının içi veya tırnağın üstündeki et.
nesre: Büyük geniş gömlek. * Hayvanın tiksirip burnundan sümüğünü çıkarması. * Menazil-i kamerden iki yıldız. 
nesren: Nesir olarak, manzum olmadan yazılan yazı. * çoğaltmak suretiyle. 
nesrîn: Yabani gül.
ness ›ž: Sürmek, sevk. * Kurumak.
ness ›†: îfşa etmek, açıklamak. * Gayret ve hamiyyet etmek.
nessabe: Nesepleri iyi bilen kimse.
nessac ›žƒ‡: Dokuyucu, dokuyan, çuhacı.
nessaf: Gagası büyük bir kuş.
nessar ›†ƒœ: Dağıtan, saçan, neşreden. * Parlatan.
nest: Sâkin olmak.
nesteînu: "Biz senden yardım, inayet dileriz, istiane ederiz" meâlinde duâ.
nester: (Nesteren-Nesterin-Nesterun) f. Ağustos gülü, yaban gülü.
nesterînzar: f. Gül bahçesi. Güllük.
nesuc: üstünde yük doğru durmayan deve.
nesv: îzhar etmek, göstermek, açıklamak.
nesy: Unutma, nisyan. * Unutulmuş.
nesyen mensîyyen: Tamamıyla unutulmuş, tamamen hatırdan çıkmış.
ne'ş ›ýƒ: şiddetle ve kahirle almak. Zorla almak.
neş' ›”: Bir nesneyi zorla çekmek.
neş' (nüşu') ›ýƒ: Yiğit olmak. * Yüksek olmak. * Rüzgâr esmek. * îyi ve hoş kokulu şeyler koklamak.
neşa ›ƒ: Nişasta.
neşabet: Okçuluk san'atı.
neşaîd ›ƒ¡š: (Neşide. C.) Meşhur kaside ve beyitler, mısralar.
neşak: Burna su ve sâire çekme. Burunla çekme.
neşame: Yüksek beyaz bulut.
neşasa: Beyaz yüksek bulut.
neşastec: Nişasta.
neşat ›ƒ’: Sevin. şen şâd ve hoşdil olmak. Sürur, keyf. * Bir iş işlemek. çalışmak.
neşat-âver: f. Sevinç ve sürur getiren.
neşat-bahş: f. Sevinç ve neşe bağışlayan.
neşat-efza: f. Neşe ve sevinç artıran.
neşât-engîz: f. Sevinç uyandıran.
neşb: (îğne ve diken) batma, girme.
neşc (neşîc): (C.: Enşâc) Sesli sesli ağlamak. * Ses.
neşd ›š: Talep etmek, istemek. * Yüksek yerde düz yer olmak. * Kaybolan şeyi aramak. * Bir şeyi gereği gibi bilmek.
neş'e ›¡œ: Gönül açıklığı, sevinç. * Yeniden meydana gelmek. Yeniden olan şey. * Yiğit olmak. * Yüksek olmak.
neş'e-î uhrâ ›¡œý‚ƒ‰œƒÿ: ölümden sonra mahşerde yeniden dirilmek. Buna "Neş'e-i sâniye" de denir.
neş'e-î ulâ ›¡œý‚ƒ™ÿ: îlk hayat. Ruhun bedene girmesi. Dünyaya gelmek.(...Peygamber'in (A.S.M.) emrettiği gibi, " Neş'e-i ulâyı gören adam, neş'e-i uhrâyı inkâr edebilir mi?" çünkü ikinci teşekkül, yâni ikinci yapılış birinci teşekkülden daha kolaydır. î.î.) (Bak: Taaccüb)
neş'e-î ulyâ ›¡œý‚”™ÿƒ: Ahiretteki yüksek dereceli hayat, âhiret hayatı.
neş'e-nîsar: f. Neşe dağıtan.
neş'e-yab: f. Keyifli, neşeli, sevinçli.
neşeb: Mal, mülk.
neşef: îçmek. * Sinmek. * îçine girmek, dühul etmek.
neşefe: (C.: Nüşüf) Ayağın kirini temizlemede kullanılan taş.
neşer: Dağılmış, intişar etmiş, münteşir.
neş'et ›¡…: Meydana gelmek, vücuda gelmek. Büyüyüp kat ve kamet sahibi olmak. Yetişmek, ileri gelmek. * çıkmak. Kaynak olmak.
neş'et-î uhrâ: (Bak: Neş'e-i uhrâ)
neş'et-î ulâ: (Bak: Neş'e-i ulâ) 
neşf ›–: îçmek, suyu emerek içmek. * Sızmak. Sünger gibi sızmak. * Suyu çekmek.
neşg: Aşk galebe edip haykırıp çağırmak. * Tâlim etmek.
neşîde ›ÿšœ: Manzume. şiir. * Yüksek sesle okunan şiir. * Darb-ı mesel (atasözü) derecesinde kullanılan meşhur beyit veya mısrâ.
neşîdehân: f. Neşide okuyan.
neşîl: çömlekte pişmiş et.
neşîr ›ÿœ: Dağıtma, yayma, herkese duyurma.
neşîş: Kaynayan şeyden çıkan ses.
neşît ›ÿ’: Neş'eli, sevinçli, şenlikli. Faal.
neşîta: Bir şeyin, aramaksızın bulunması. * Ansızın bulunan nesne. * Gâzilerin kastettikleri yere varamadan yolda buldukları ganimet.
neşk: Burna çekme.
neşl: Taan etmek. * Cezbetmek, kendine çekmek.
neşm: Zerdali ağacı gibi bir ağaç. * Bir çiçek cinsi.
neşneşe: Koyun derisini yüzmek. * Zırh sesi. * Su kaynarken ötüp ses çıkmak.
neşr ›œ: Neşretmek, yaymak, bir haberi fâşetmek, herkese duyurmak, şâyi kılmak. * Başıboş cemaat. * Bulutlu günde yel esmek. * îzhar etmek. * Katetmek. * Mecnun veya hastaya duâ yazmak veya okumak.
neşr-î suhuf ›œ‚ˆ–: Sahifelerin neşri. * Haşirde, insanların hesab görülmek için dirildiklerinde amel defterlerinin meydana çıkarılıp herkesin amelinin belli oluşu.( $ kelimesiyle ifade eder ki: Haşirde herkesin bütün a'mâli bir sahife içinde yazılı olarak neşrediliyor. şu mes'ele kendi kendine çok acib olduğundan akıl ona yol bulamaz. Fakat, surenin işaret ettiği gibi, haşr-i baharide başka noktaların naziresi olduğu gibi, şu neşr-i suhuf naziresi pek zâhirdir. çünki: Her meyvedar ağaç ve çiçekli bir otun da amelleri var, fiilleri var, vazifeleri var. Esmâ-i îlâhiyyeyi ne şekilde göstererek tesbihat etmiş ise ubudiyetleri var. îşte onun bütün bu amelleri tarih-i hayatlariyle beraber umum çekirdeklerinde, tohumcuklarında yazılıp başka bir baharda, başka bir zeminde çıkar. Gösterdiği şekil ve suret lisaniyle gayet fasih bir surette analarının ve asıllarının a'mâlini zikrettiği gibi dal, budak, yaprak, çiçek ve meyveleriyle sahife-i a'mâlini neşreder. îşte gözümüzün önünde bu Hakimâne, Hafizâne, Müdebbirâne, Mürebbiyâne, Lâtifâne şu işi yapan O'dur ki, der: $Başka noktaları buna kıyas eyle. Kuvvetin varsa istinbat et. S.)
neşren ›œƒø: Yayılmak suretiyle, neşir yoluyla. Yazarak, dağıtarak.
neşrî: Neşir ile alâkalı.
neşrîyât ›œÿƒ…: Gazete, kitap, radyo ve sâir vasıtalarla neşrolunmuş, yayılmış şeyler.
neşrîyât-i kâzîbe: Yalandan, uydurma sözler.
neşş: Kaynamak, galeyan. * Her nesnenin yarısı. * Davarın tezce derisini yüzüp etinden ayırıp çıkarmak. * Yirmi dirhem. * Karıştırmak.
neşşab: Okçu, ot atan.
neşşabe: Ok yapıcılık, ok yapma sanatı.
neşşaf: Bir şeyi kendine çeken. * Emen.
neşşal: Pişmemiş yemeğe saldıran.
neşt ›’: Yılan sokmak ve ısırmak. * Bir yerden bir yere gitmek. * çözmek. * çıkarmak. * îpi bağlamak.
neşter ›…œ: Ameliyat bıçağı. Hekim bıçağı.
neşur ›œ: Ziyadesiyle neşreden. Fazla yayan. Dağıtan.
neşut: Bir balık cinsi. * Kovası katı çekilmeyince su çıkmayan kuyu.
neşv ›: f. Canlıların büyümesi, yetişmesi, boy atması. * Yeniden hayata gelmek.
neşv ü nema ››šƒ: Büyümek ve gelişmek. 
neşvan: Sarhoş.
neşvar: Davar gevişi.
neşvat: (Neşvet. C.) Keşifler, neş'eler, sevinçler.
neşve ›œ: (Nişve - Nüşve) Sevinç, keyif. * Büyümek ve yetişmek. * Koklamak. * Rayiha. * Bir şeyi tekrarlamak. * Mest ve sarhoş olmak. * îyice duyup vâkıf olmak.
neşvebahş: f. Keyif ve neşe veren. Neşelendiren.
neşvedâr: f. Keyifli, neşeli.
neşvegâh: f. Neşe ve keyif yeri.
neşvemend: f. Keyifli, neşeli.
neşverüba: f. Neş'e verici.
neşvet: Keyif, neşe. Sevinç sarhoşluğu.
neşveyab: f. Neşeli, keyifli.
neşz: (C.: Enşâz-Nişâz) Yüksek yer.
neta: (Nütü') Yaranın şişmesi. * Yüksek olmak.
netaîc ›…ƒ¡‡: (Netayic) (Netice. C.) Neticeler.
netane: çirkin kokmak, pis kokmak.
netb (nütüb): Büyük olmak, gövdeli olmak.
netc: Doğurmak.
netf: Kıl yolma.
netg: Alayla gülmek. * Bir kimseyi ayıplamak.
neth: Terlemek, sızmak.
neth: Koparmak. * çıkarmak.
netîce ›…ÿ‡œ: (C.: Netâic) Son, gaye. Semere, hülâsa. * Döl, evlâd.
netîce-î hayat: Hayatın neticesi ve gayesi.
netîce-î hîlkat ›…ÿ‡œý‚‰™—…: Yaratılışın sonu, gayesi. Yaratılmanın neticesi.
netîce-î kelâm: Sözün kısası.
netîce-î ma'kse ›„ÿ‡œý‚š”˜žœ: Aksi netice, ters netice.
netîcebahş: f. Neticelendiren, sonuçlandıran. Netice veren.
netîcepezîr: f. Son bulmuş, neticelenmiş.
netk: Bir şeyi şiddetle çekmek ve cezbetmek.
netk: Atmak. * Yüzmek. * Kendine çekmek, cezbetmek. * Depretmek, silkmek, harekete geçirmek. * Oğlu ve kızı çok olmak. 
netl (netel): önüne çekmek. * Deve kuşu yumurtasının içini su ile doldurup bir yere gömmek.
netn ›…›: Fena kokmak. Kötü, kerih koku.
netnun: Bir ağaç cinsi.
netr: Cezbetmek, kendine çekmek. * Taan etmek, çekiştirmek. * Bozulmak, fâsid ve zâyi olmak.
nets: Deri yüzmek. * Bir şeyin yerinden ayrılması.
netş: çıkarmak. * Yolmak.
netuc: çıkma. *Ağaç posası.
neur: çivit.
neuzü ›”‹: "Sığınırız" meâlinde fiil.
neuzü-bîllâh ›”‹‚„ƒ™™õœ: Allah'a sığınırız, Allah korusun.
nev ›: f. Yeni, tâze, cedid. Son zamanda çıkmış.
nev' ›”: çeşit, sınıf, cins. * Taleb etmek. Meyletmek, eğilmek. îki yana sallanmak.
nev'-î beşer: însanlar, beşer nev'i.
nev-a-nev: f. Yeni yeni.
nev-amuz: f. Acemi. Yeni alışan.
nev-arus: (C.: Nev-arusân) f. Yeni gelin.
nev-ayîn: f. Yeni tarz, yeni üslub. * Yeni üslub çıkaran.
nev-î beşer ›”‚„œ: (Bak: Nev')
nev-îcad: f. Evvelce yok iken sonradan yapılmış. Yeniden meydana getirilmiş.
nev-înan: f. Acemi at, bineğe yeni alıştırılan at.
neva ›ÿ: Bir yerden bir yere nakletmek. * Hıfzetmek, korumak. * Sohbet etmek.
neva ›ƒ‚‚ÿ‚: f. Ahenk, ses, güzel sadâ, nağme, avaz. * Musikide bir makam ismi. * întizamlı hâl. * Azık, zahire, rızık.
neva-saz: f. çalgıcı, okuyucu.
neva-yî ney ›ƒÿ‚›ÿ: Ney sesi.
nevabiz: (Nâbıza. C.) Nabız damarları.
nevabîg: (Nâbiga. C.) şerefli ve ulu kimseler. * Sonradan şâir olan kişiler.
nevabît ›ƒ„…: (Nabite. C.) Nebatlar. Bitkiler. * îmar ve ihdas. * Dünya ahvâlinden habersiz. * Taze, genç kimse.
nevacîz: (Nâciz. C.) Azı dişlerinin arkasındaki altlı üstlü bulunan dişler.
nevad: f. Zarar, ziyan, hasar. * Mahzen. * Dil.
nevade: Torun.
nevadî: (Nâdi. C.) Toplantılar, meclisler.
nevadîr ›ƒšœ: Az olanlar, nâdirler.
nevafîl ›ƒ–™: (Nâfile. C.) Farz ve vâcib olandan başka ibadetler. Nâfile (yani sevab için kılınan) namaz veya tutulan oruçlar.
nevafîs: (Nefsâ. C.) Loğusalar. Yeni doğum yapmış kadınlar.
nevager: f. Okuyucu, hânende.
nevah: Kül renkli beyaza benzer kumru gibi bir kuş cinsidir ve sesi gayet lâtiftir.
nevahî ›ƒˆÿ: (Nahiye. C.) Taraflar, yanlar, nahiyeler.
nevahî ›ƒœÿ: (Nehy. den) Yasak edilmiş şeyler. * Allah (C.C.)tarafından menedilmiş olanlar.
nevahî-î kaza: bir kazâya bağlı olan nahiyeler.
nevahî-î mekke ›ƒˆ¡‚š˜œ: Mekke civarı. Mekke'nin yakınları, nahiyeleri.
nevaht: f. Okşama. * Saz çalma.
nevahte: f. Okşanmış. * Saz çalmış.
nevahten: f. çalgı veya saz çaldırmak.
nevaî: f. Ahenkle, makamla ilgili.
nevaîb ›ƒ¡„: (Naibe. C.) Musibetler, kazalar, belâlar.
nevaîb-î eyyam ›ƒ¡„‚¤ÿƒš: Günlerin belâları.
nevaîr: (Naire. C.) Ateşler, alevler.
nevaîr: (Naure. C.) Bostan dolapları.
nevaket: Hamakat, ahmaklık.
nevakis ›ƒ—: (Noksan. C.) Eksiklikler, noksanlar.
nevakis ›ƒ˜ž: (Nâkis. C.) Başlarını devamlı olarak önlerine eğen adamlar.
nevakîs: (Nakus. C.) çanlar. îbadet vakitlerinde kiliselerde çalınan çanlar.
neval(e) ›ƒ™œ: Bahşiş. Kısmet, tâli', nasib. * Yiyecek içecek. * Bir tek porsiyon.
nevale-çîn: f. Yiyecek toplayan, kısmetini alan.
nevamîs ›ƒšÿž: (Namus. C.) Namuslar, kanunlar, şeriatlar. (Bak: Desâtir) 
nevamîs-î îlâhîye: îlâhi kanunlar. (Bak: şeriat-ı fıtriye)
nev'an ›”øƒ: Cins bakımından, çeşitçe. * Biraz.
nev'an-ma: Bir dereceye kadar, bir bakıma göre, bir suretle.
nevar: (C.: Niver) ürkmek, korkmak.
nevasî: (Nâsiye. C.) Alınlar. * Bir topluluğun ileri gelenleri. Ulular.
nevasî: îyi cins bir beyaz üzüm.
nevat ›ƒ : çekirdek, hurma çekirdeği. * Yirmi veya on adet. * Bir veya on okka altın. Beş dirhem altın. * Düşman.
nevatih: şiddetler.
nevatir: Kirişi kesik olan yay.
nevatî: (Nevti. C.) Gemiciler.
nevatîr: (Nâtur. C.) Hamam hademeleri. * Bostan bekçileri.
nevaye: Devenin semiz olması.
nevaz ›ƒ: f. Okşayıcı, taltif edici, iyi edici. (Bak: Nüvaz)
nevazende: f. Okşayan, okşayıcı.
nevazic: (Nâzıc. C.) Kıvama gelmişler, olgunlaşmışlar.
nevazîl ›ƒ™: Nezleler. * Hâdiseler. Belâlar.
nevazîş ›ƒ: (Nüvaziş) f. Okşayış, iltifat.
nevazîşgâr: f. Gönül alan, okşayan. îltifat eden.
nevazîşgârane: f. Gönül alarak, okşayarak, iltifat ederek.
nevb: Yakınlık. * îsabet.
nevbahar: f. îlkbahar.
nevbahar-i ömr: ömrün ilkbaharı.
nevbaharî: f. îlkbaharla ilgili.
nevbave: f. Yeni yeşillik. * Turfanda yemiş. * Hediye, armağan.
nevbe: (C.: Nüveb) Nöbet.
nevbenev: f. Tâzeden tâzeye. Yeniden yeniye.
nevber: f. Turfanda meyve. * Memeleri yeni belirmeye başlamış kız. 
nevbet ›„…: Nöbet, sıra. Sıra ile görülen iş.
nevbet-zen: f. Belirli vaktin geldiğini bildiren, nöbet çalan.
nevbetî: f. Mehter başı.
nevbünyan: f. Yeni yapılı, yeni yapılmış.
nevbürîde: f. Yeni koparılmış, yeni kesilmiş.
nevcah: f. Bir makama veya memuriyete yeni geçmiş olan. * Tahta yeni oturmuş (padişah).
nevcet: Fırtına.
nevcîvan ›‡ƒ›: f. Genç, delikanlı.
nevcîvanî: Gençlik, delikanlılık.
nevdel: Sarkık ve sülpük olmak.
neve: Torun.
neved: f. Doksan. 90
nevend: (Nevende) f. Postacı. Atlı postacı. * Hızlı giden at.
neverd: f. Dönen, gezen, dolaşan.
nevesan: Kımıldama, hareket etme.
nevey: (Nevât. C.) çekirdekler.
neveyat ›ÿƒ…: (Nevâ) Nüveler, çekirdekler.
nevf: (C.: Envâf) Hörgüç. * Uzun ve yüksek olmak.
nevfel: Deniz, derya, bahr. * Atâsı çok olan kişi. çok bahşiş dağıtan.
nevfele: Tuzluk.
nevfer: Nilüfer çiçeği.
nevgüşade: f. Yeni açılmış.
nevh: Yükseltmek, yüceltmek. * Kuvvetli ve kavi olmak.
nevh (nevha): Ağıt etmek. * Bağırıp çağırarak sesle ağlamak.
nevha ›ˆœ: ölüye sesli ağlamak. * Nağme ile güvercin ötmesi.
nevhast: Taze ve genç hayvan.
nevhat ›‰’: Sakalı yeni çıkmış genç.
nevheves: (C.: Nevhevesân) f. Bir işe yeni olarak ve büyük bir hevesle başlayan. * Sık sık iş değiştiren. Hevesi çabuk geçen.
nevhîz: f. Genç, taze. * Yeni çıkmış, yeni yetişmiş.
nev'î ›”ÿ: Nev'e ait, çeşit ile alâkalı.
nevî ›ÿ: f. Yenilik.
nev'î şahsina münhasir: Sadece şahsına benzer çeşit, başka benzeri olmayan. Eşi bulunmaz olan.
nevîd: f. Müjde, beşaret, iyi ve sevinçli haber.
nevîn: f. Yeni, yepyeni, yeni şey.
nevîs: Kuvvet.
nevk: f. Sivri uç.
nevk-î müjgân: Kirpiklerin ucu.
nevka: Ahmak, akılsız kimse.
nevkar: f. Acemi. îşe yeni başlamış.
nevl: Yolcuların verdiği vapur parası. Gemi kirâsı. * Bahşiş, atiyye.
nevm ›š: Uyku. Uyumak. Rüya. * Sönmek. Sükun. (Bak: Kaylule)
nevm-âlud: Uykulu, uykuya bulaşmış, uyumuş.
nevmî: Uyku ile alâkalı, uykuya âit.
nevmîd ›šÿš: f. ümidsiz, me'yus, mükedder, cesareti kırılmış.
nevmîdâne ›šÿšƒ›œ: f. ümitsizce, kederli ve ümidsiz olarak.
nevmîdî ›šÿšÿ: ümidsizlik, cesaret kırıklığı.
nevnîhal ››œƒ™: f. Taze fidan, yeni filiz.
nevnîyaz: f. îşe yeni başlayan.
nevpeyda: f. Yeni çıkma.
nevr: (C.: Envâr) Parlaklık. * Ağaç çiçeği. Tomurcuk.
nevrah: f. îlk olarak seyahata çıkan. Yeni yolcu. * Yeni yol.
nevrec: (Nevâric) Kağnı.
nevred: f. Gezen, yol alan, dolaşan.
nevres ›œž: (Nevrese) f. Yeni yetişmiş, yeni yetişen, yeni biten. * Genç, taze.
nevres ›œž: Su kuşlarından mavi renkli bir kuştur; başının yarısı siyah yarısı beyaz olur; güvercin büyüklüğündedir. Su üstüne yakın uçar ve balık gördüğü gibi kapar.
nevresîd: f. Yeni yetişmiş, yeni yetişme.
nevresîde ›œžÿšœ: f. Yeni yetişmiş, yeni yetişme. * Tâze, genç.
nevresîdegân: (Nev-reside. C.) Yeni olgunlaşmağa başlamış olanlar, yeni yetişmeler. Gençler, tazeler.
nevresm: f. Yeni çıkma. * Yeni moda.
nevreste: (C.: Nevrestegân) f. Yeni yetişmiş, yeni bitmiş, yeni meydana gelmiş, yeni hâsıl olmuş.
nevroz ›œ: Fr. Tıb: Sinir sistemi bozukluğu. Sinirlilik hastalığı.
nevruz ›œ: f. Yeni gün. îlkbahar. Baharın ilk günü sayılan ve güneşin Hamel (Kuzu) burcuna girdiği 22 Marta rastlayan gün. Bu tarihte gece ve gündüz müsâvi olur. îranlıların yılbaşısıdır.
nevruzîye ›œÿœ: Nevruz gününe âit olan. Hususan o gün için yazılan, söylenen manzume.
nevrüste: f. Yeni yetişme.
nevs: Tehir etmek, sonraya bırakmak. * Kaçmak, firar etmek. * Vahşi hımar, yabani eşek.
nevs: Asılmış olan bir şeyin hareket etmesi, sallanması. Hareket etme. Deprenme.
nevsale: f. Genç. Küçük. Tâze.
nevsefer: f. Yeni yolculuğa çıkan.
nevş ›: Bir şeyi el uzatıp almak ve istemek. * Yürümek. * Sür'atle deprenip kalkmak. * Alıp yemek.
nevşah: f. Yeni dal. * Yeni bitmiş geyik boynuzu.
nevşe ›œ: f. Genç hükümdar. * Yeni damat.
nevşüküfte: f. Yeni açılmış (çiçek).
nevt: (C.: Envât-Niyât) Bir yere asma. Kaldırma.
nevta: Göğüste olur bir verem.
nevtî: Gemici.
nev'umma: Bir derece, bir suretle.
nev'un münhasirun fîş-şahs: Nev'i şahsına münhasır. Başka bir benzeri olmayan.
nevür: çivit. * Damga için kullanılan içyağı isi.
nevvab: Nâiblik eden. Birinin yerine vekil olarak iş gören.
nevvah(e): Ağlayan, çığlık koparan.
nevvar(e) ›ƒœœ: Nurlu, aydın. Aydınlık.
nevz: (C.: Envâz) Dere, vâdi.
nevzad ›ƒš: f. Yeni doğmuş. * Yeni doğmuş çocuk.
nevzemîn: f. Yeni çeşit, yeni tarz.
nevzuhur: f. Yeni çıkma. Yeni zuhur etme.
ne'y ›ýƒÿ: Uzak olmak.
ney ›ÿ: Kamıştan yapılan damaksız düdük. * Kamış kalem. * Mc: Kâmil insan. * Farsçada : Yokluk. (Bak: Nay)
ney' ›ÿ”: Susuzluk. * Meyletmek, eğilmek.
neyb: Dişle ısırmak.
neyçe: f. Küçük ney.
neydelan: Kâbus denilen ağırlık ki uyku arasında olur.
neyelan: îsteğe ulaşma. Arzulanan şeye vâsıl olma.
neyfak: Tilki derisinden olan kürk.
neyh: Vücudun kemikleri taze iken pekişmek.
neyîstan: f. Kamışlık, sazlık.
neyk: Cima etmek.
neyl: Merama erme. îsteğe ulaşma. * Ulaşılan şey.
neynüfer: Nilüfer çiçeği.
neypare: f. Kamış parçası.
neyrenc: (C.: Neyrencât) Tılsım.
neyrencât: (Neyrenc. C.) Tılsımlar.
neyrîb: Koğuculuk, dedikoduculuk.
neyruz: Yaz günü.
neyseb: Karıncaların birbirine bitişerek yol almaları.
neysîtan: f. Sazlık, kamışlık.
neyşeker: f. şeker kamışı.
neyt ›ÿ’: Cenaze. * ölüm. * Duâda tazarru etmek. * Tıb: Kalbin asılı olduğu damar. * Derinliği adam boyu miktarı olan kuyu.
neyt ›ÿ…: înlemek. * şiddetle teneffüs etmek.
neytal: (C: Neyatil) Belâ, musibet, felâket, meşakkat. * Kova. * îçki ölçeği.
neyy: Pişmemiş çiğ et vs. * Devenin semiz olması. * Semiz ve besili deve.
neyyîf ›ÿ–: Küsur. Ziyade. Artık. Fazla. * îhsan. * Yakın.
neyyîr ›ÿœ: (Nur. dan) Nurlu, parlak, ışıklı cisim. * Yıldız. Cisim halindeki nur. * Güneş, şems.
neyyîr-î a'zam: Güneş, şems.
neyyîr-î asgar: Ay. Kamer.
neyyîrat ›ÿœƒ…: (Neyyir. C.) Nurlular, nur saçanlar.
neyyîreyn: Cisimlenmiş iki nur, yâni: Güneş ile Ay.
neyz: çok olmak.
neyzar: f. Kamışlık, sazlık.
nez' ›£: Halkı birbirine düşürmek, ifsâd, bozmak.
nez' ›”: çekip koparmak, ayırmak. * Can çekişmek. * çekip almak. Kuyudan kovayı çekip çıkarmak. * Saymak. * Kaldırmak, yok etmek.
neza': Başta, alnın iki yanında saç olmayan açık yer.
nezafet ›“ƒ–…: Temizlik, paklık, pakizelik.
nezahet ›ƒœ…: Ahlâk temizliği, temizlik. * încelik, rikkat.
nezaîr ›“ƒ¡œ: (Nazire. C.) Nazireler, benzerler, emsâl olanlar.
nezaket ›ƒ˜…: Naziklik, incelik, zariflik. Kaba olmamak. Edeb, terbiye.
nezale: Sefillik. * Hasislik.
nezare ›ƒœœ: Azlık. Kıllet.
nezare ›‹ƒœœ: Korkutmak.
nezaret ›‘ƒœ…: (Nedâret) Tazelik. Parlaklık. Letafet.
nezaret (t): (Nazar. dan) Bakmak, seyir, bakış. * Nâzırlık etmek. Göz etmek. * Tenezzüh. * Reislik. * Vekillik, nâzırlık, bakanlık.
nezaza: Az olmak, kıllet. * Her nesnenin bakiyyesi, artığı ve âhiri.
nezb: çağırmak. * Ses, sadâ, savt.
nezd ›š: f. Yan. Yakın. Karib. * Göre, nazarında, fikrince. (Arapçadaki "ind" mânâsındadır)
nezdîk: f. Yakın, karib.
neze: Hafif deve.
nezel: Menzil, mekân.
nezele: Akmak, seyelan.
nezevan: Atlama, sıçrama.
nezf ›–: Kuyunun suyunu tamamen boşaltma. * Aklı gitme, sarhoş olma. Zevâle gitme.
nezg ›•: îfsad etmek, halk içine fitne ve fesad bırakmak. Vesvese.
nezga: Taan etmek, çekiştirmek.
nezh: (Nezih) Nezihlik, temizlik, saflık. * Hiçbir kötü hareketi olmamak. * Kerim, pak, pâkize.
nezîa: (C.: Nezâyı') Aşiretinden başkasına nikâhlanmış olan kadın.
nezîb (nezâb): Geyik ve sair hayvanların cima zamanı çıkardıkları ses.
nezîf: (Nezf. den) çok kan kaybından kuvvetsiz kalan kimse. * Sarhoş kimse.
nezîh: (Nezihe) Pâk, temiz. (Bak: Nezh)
nezîhâne ›ÿœƒ›œ: f. Temizce, iyice, güzelce.
nezîl ›ÿ™: Misafir. înen, konan.
nezîl: Menzil, mekân.
nezîr ›‹ÿœ: (Nezr. den) Bir iş için korkulacak bir şey söyleyip gözdağı vermek. îlerdeki hesap için korkutmak. ("Beşir" in zıddıdır) * Peygamberimiz Aleyhissalâtü Vesselâmın bir vasfı olup Allaha (C.C.) inanıp itaat etmeyenlere cehennemden haber verdiği için "Nezir" denmiştir.
nezîre ›‹ÿœœ: Nezredilmiş olan şey, adak.
nezk: Yaramaz söz. * Süngü ile vurmak.
nezk $: Hafiflik. * Acele. * Sebkat.
nezle: (C.: Nevâzil) Burnun akmasını mucib olan hastalık. * Vücudun herhangi bir organından cerahat veya başka bir maddenin akması.
nezr ›‹œ: Adak adamak. * Fık: Cenab-ı Hakka ta'zim için mübah bir fiilin yapılmasını deruhde etmek, öyle bir işin yapılmasını kendi nefsine vacib kılmaktır.
nezr ›œ: Suâlde ısrar etmek. * Az miktar, azlık.
nezur: Evlâdı az olan kadın.
nezv: Sıçramak.
nezz: Hafif zeki kimse. * Susuz nadas.
nezzam ›“ƒš: Nizâm veren, düzenleyen, tertipleyen.
nezzare ›“ƒœœ: Seyirci, seyreden, bakan. Nezaret eden, müfettiş, mürakabe ve kontrol eden. Vekillik eden.
nihle: (C.: Nihal) Millet. * Yol. * Diyânet. * Bahşiş, atâ. * Dâva.
nihv (nîhâ): (C.: Enhâ) Tulum. Yağ tulumu.
nikbe: (C.: Nakıb) Zarar ve ayıp verecek derece eziyet.
nikk ›—: Kurbağa sesi.
nikmet ›—š : (Bak: Nikmet)
nikrîs: (Nıkris) (C.: Nekaris) Ayak ağrısı.
niky: îlik.
ni'me: (C.: Niam) Mal. * Sanat.
nisa': Bir cins beyaz elbise.
nisaf: Bir şeyi tam olarak ikiye bölme.
nisf ›–: Yarım, yarı.
nisf-i kutr ›‘–‚—’œ: Dairenin merkezinden geçen ve onu iki eşit kısma ayıran doğru çizginin yarısı. Yarı çap.
nisf-ül leyl ›–‚ƒ™™ÿ™: Gece yarısı. 
nisf-ün nehar ›–‚ƒ™›œƒœ: öğle vakti, gündüzün ortası. * Meridyen.
nisfet ›–…: (Bak: Nasfet)
nisfîyet: Yarımlık. Yarı yarıya bölme.
nish (nisâh): Terzilik. * Bir şeyi temizleyip yaramazını içinden çıkarıp hâlis yapmak.
nit': Ağız tavanının pütür yerleri.
nitab: Baş. * Boyun damarı.
nitaf: Ter.
nitnit: Uzun boylu adam.
nizar: (C.: Nuzarâ-Nizâr) Her nesnenin misli ve benzeri. Nazir.
nizv: (C.: Nuzuv, Enzâ') Gitmek. * Sebkat etmek. * Kesmek, kat'etmek. * çekip çıkarmak. * Bırakmak. * Zayıf deve. * Eski elbise.
nî ›œ: f. Nefy edatıdır. (Bak: Na-Ne)
nîac: (Na'ce C.) Dişi koyunlar.
nîal: (Na'l. C.) Ayakkabılar, pabuçlar. * Hayvanların ayaklarına çakılan demirler, nallar.
nîam ›”ƒš: (Ni'met. C.) îyilikler. Yiyecekler. Nimetler. * Hidayetler.
nîam-i esasîye ›”š‚¤žƒžÿœ: Esas nimetler, en lüzumlu maddeler. îman, din gibi en kıymetli îlâhi ihsanlar.
nîbah: Köpek havlaması.
nîbal ›„ƒ™: Küçük tepe. * (Nebl. C.) Oklar.
nîbras ›„œƒž: (Süryânice) Lâmba, çıra.
nîbz: Hurma ağacının dış kabuğu.
nîcad ›‡ƒš: Kılıç bağı.
nîcaf: Kapının üst eşiği. 
nîcar: Asıl.
nîda' ›šƒ£: Seslenmek, çağırmak, haykırmak, bağırmak. Ses vermek. * Gr: ünlem (!)
nîdal ›‘ƒ™: (Nizâl) özür beyan ederek bir zararı def etmek.
nîdd ›š: Aynı, eş. Benzer, denk.
nîdre: Et parçası.
nîfa': Menfaat, fayda.
nîfak ›–ƒ—: Müslüman gibi görünüp kâfir olmak. îki yüzlülük. * Bozuşukluk, ara açılmak. * Dinde riyâ etmek. * îhtiyaca sarf olunacak şeyler.
nîfakî: Nifakla alâkalı.
nîfar: întikal etmek, göçmek. * Dağılıp kaçmak. * ürkme, korkma, çekinme. * Nefret gösterme.
nîfas ›–ƒž: Yeni doğurmuş kadının hâli. Loğusalık. Böyle bir kadına "Nüfesâ" da denir. Hanefi Mezhebine göre bu hâl kırk gün devam eder.
nîfaz: çocuğa sarılan bez. çocuk bezi.
nîgâh ›ªƒœ: (Nigeh) f. Bakmak, nazar etmek. Bakış.
nîgâh-i gazab: öfkeli bakış, kızgınlık bakışı.
nîgâh-i hayret: Hayret bakışı.
nîgâh-i tedkîk: Araştırma bakışı, tedkik etme nazarı.
nîgâh-i tegafül: Hâli ve gayeyi anlamazlıktan gelen bakış.
nîgâhban: Bekçi. Gözcü. Gözleyen.
nîgâhbanî: f. Bekçilik, gözcülük.
nîgâhdar: f. Bekçi, gözcü. * Koruyucu, muhafaza eden, saklayıcı.
nîgâl: f. Ateşli kömür parçası.
nîgâr ›ªƒœ: f. Güzel yüzlü sevgili. * Nakış. Resim. * Nakşeden. * Put, sânem. * Resmi yapılmış, resmedilmiş.
nîgârende: f. Ressam.
nîgârhane: f. Resim ve heykeller bulunan yer. Resim ve heykel sergisi. * Ressamların çalıştıkları atölye. * Puthâne. * Güzelleri çok olan yer.
nîgârîn: f. Resim gibi güzel sevgili. * Resimlerle ve nakışlarla süslü.
nîgârîstan: f. Resim ve heykel sergisi. * Güzelleri çok olan yer. * Puthane.
nîgârîş: f. Resim yapma. Tasvir yapma.
nîgâşte: f. Resmolunmuş. Musavver. * Yazılmış.
nîgeh: (Bak: Nigâh)
nîgeh-endâz: f. Bakan, bakıcı, bakıveren.
nîgehbân ›ªƒœ„ƒ›: f. Gözcü, gözetici, bekçi.
nîgehbânî: f. Bekçilik, gözcülük.
nîgehdâr: f. Gözcü, bekçi. * Saklayıcı, koruyucu.
nîgeran ›ªƒœƒ›: f. Bakıveren, bakıcı.
nîgîn: f. Mühür, hâtem. * Yüzük.
nîgîndân: f. Yüzük mahfazası, yüzük kutusu.
nîgînsây: f. Mühür kazıcı. Hakkak.
nîgu: f. Güzel, iyi, hasen.
nîguhâh: f. Hayır temenni eden, iyilik isteyen.
nîguhîde: f. çekiştirilmiş, zemmolunmuş, gıybet edilmiş.
nîguhîş: f. çekiştirme, gıybet, zemm.
nîgun: f. Tersine dönmüş, altüst olmuş, başaşağı. * Ters, uğursuz, aksi.
nîgunbaht: f. Tâlihi ters dönmüş, tâlihsiz, şanssız.
nîgunsâr: f. Başaşağı.
nîh ›œ: f. (Nihâden: "Koymak" mastarından emir kökü) Koy. * Memleket, şehir, belde.
nîha (nîyâha): Yas tutmak. 
nîhab: (Nehb. C.) çapullar, yağmalar.
nîhad ›œƒš: f. Huy, tabiat, hilkat, bünye, yaratılış.
nîhade ›œƒšœ: f. Konmuş, konulmuş.
nîhadî: f. Yaradılışta olan, fıtri.
nîhaf: (Nahif. C.) Cılız, zayıf kimseler.
nîhaî ›œƒ¡ÿ: (Nihâiye) Sona ait, son ile alâkalı, sonuncu.
nîhal ›œƒ™: f. Taze, düzgün. Fidan, sürgün.
nîhal-î zarîf: înce, güzel dal.
nîhalan: (Nihal. C.) f. Taze fidanlar, sürgünler.
nîhale: f. Yeni, taze fidan. * Avcı korkuluğu. * Sahan altlığı. * Döşenecek şey. Döşeme.
nîhalî: f. Sahan altlığı.
nîhalîstan: f. Fidanlık.
nîhan ›œƒ›: f. Gizli, saklı. Bulunmayan. Mevcut olmayan. * Sır.
nîhanhane: f. Saklanacak yer. Mağara, bodrum, mahzen.
nîhanî: f. Gizlilik, saklılık.
nîhas: Asıl. Tabiat.
nîhas: Kağnı tekerleğinin etrafına takılan çenber, yuvarlak demir. * Kavafların kullandığı nesne.
nîhavend ›œƒ›š: îran'ın batı tarafında meşhur bir şehir adı. * Musikide bir makam. 
nîhavendî: f. Nihavend şehrine ait. Nihavendli.
nîhayet ›œƒÿ…: Son, uç, son derece. * çok.
nîhayet-î azm: Kemik ucu.
nîhayet-pezîr ›œƒÿ…‚¨ÿœ: Son bulan. Nihâyet bulur olan.
nîhayet-ül emr: îşin nihayetinde, işin sonunda. Netice.
nîhayet-ün nîhaye: En sonunda. Akıbet.
nîhle ›ˆ™œ: Cenab-ı Hakk'ın ihsanı. Atıyye. * Millet. * Yol. Tarik. * Diyânet. Mezheb.
nîhrîr: (C.: Nahârir) Tecrübeli, bilgili, fâzıl, âlim, mâhir kimse.
nîhvar: f. Gururlu, kibirli, kendini beğenmiş adam.
nîhy: Gölcük.
nîjad: f. Nesil, soy, neseb. * Cibilliyet, tabiat.
nîjm: f. Bazı kış sabahları inen koyu sis.
nîk ›ÿ˜: f. îyi, güzel, hoş.
nîk ›ÿ—: (C.: Niyâk) Dağın yüksek yeri, dağ tepesi. * Kızgın, hiddetli, gadaplı kimse.
nîk ü bed ›ÿ˜‚„š: îyi ve kötü.
nîk-terîn: f. çok iyi, hepsinden iyi olan.
nîkab ›—ƒ„: Yüz örtüsü, peçe, perde.
nîkabe (nekabe): Kâhyalık. * Ululuk.
nîkâbet: Rüzgârın ters yönlerden esmesi.
nîkâh ›˜ƒˆ: Evlenme. şeriata uygun şekilde evlenme. * Resmi evlenme muâmelesi. (Bak: Mücâhede)
nîkâh-i dâhîlî: îçerden evlenme, akrabadan kız alma.
nîkâh-i hârîcî: Dışardan evlenme, akraba hâricinden kız alma.
nîkâh-i mut'a: Bir zamanlık, geçici nikâh olup meşru değildir.
nîkâh-i sahîh: Sıhhat şartlarını cami' olan nikâh.
nîkahter: (Nik - ahter) f. Tâlihli, şanslı, mutlu.
nîkal: Devenin suyu içip gittikten sonra gelip yine içmesi.
nîkâl ›˜ƒ™: f. Ateşli kömür parçası.
nîkâl: Dizgin demiri.
nîkam ›—ƒš: (Nikmet. C.) întikamlar, öc almalar.
nîkan: (Nik. C.) f. îyiler, iyi kimseler.
nîkar: înat. Kin.
nîkaşe ›—ƒœ: Nakış yapma san'atı. Nakışçılık.
nîkat ›—ƒ’: (Nokta. C.) Noktalar.
nîkât ›˜ƒ…: (Nükte. C.) Nükteler. înce mânâlar. * înce mânâlı, şakalı ve zarif sözler.
nîkâyet: Düşmanı kılıçtan geçirme.
nîkbaht: (Nik-baht) f. Bahtlı, tâlihli, şanslı.
nîkbaz: (Nik-bâz) f. Davranışları ve işleri iyi olan.
nîkbîn ›ÿ˜„ÿ›: (Nik-bin) f. îyi gören, iyimser, her şeyi iyi tarafından gören.
nîkda: Yaş kanbel otu.
nîkendîş: (Nik-endiş) f. Her vakit iyilik düşünen. Herkesin iyiliğini istiyen.
nîkfercam: (Nik-fercâm) f. Sonu, âkıbeti hayırlı ve iyi olan.
nîkhaslet: (Nik-haslet) f. Ahlâkı ve huyu iyi olan.
nîkhu: f. Güzel huylu, iyi huylu.
nîkî: f. îyilik, iyi olma.
nîkkîrdar: (Nik-kirdâr) f. Hareket ve davranışları iyi ve beğenilir olan.
nîkl: (C.: Enkâl) Köstek. * Kayd. * Dizgin demiri.
nîkmanzar: (Nik-manzar) f. Görünüşü ve manzarası güzel olan.
nîkmet: şiddetli ceza. Hoş olmayan muamelelerle olan mücâzat.
nîknam: f. îyi nam kazanmış, iyi ünlü.
nîknîhad: (Nik-nihâd) îyi huylu.
nîks: Ters doğan çocuk. * Zayıf ve cılız adam.
nîks: Elbisenin ve örülmüş şeylerin eskilerini bozup gidermek, tekrar yine iplik yapmaya kabil olanı ip eğirip yenilemek.
nîkter: (Nik-ter) f. çok beğenilmiş, çok iyi.
nîku: Güzel, iyi, hoş.
nîkubaht: f. Bahtı açık.
nîkukâr: f. îşleri doğru ve iyi olan, iyi işli.
nîkuyî: f. Güzellik, iyilik.
nîkz: (C.: Enkaz) Bina yıkıntısı.
nîl ›ÿ™: Vesime adı verilen boya otu. * çivit boyası.
nîl ›ÿ™: Mısır'ın bir nevi hayat menbaı olan en büyük nehrinin ismi.(Nil-i mübarek, Cebel-i Kamer'den çıktığı gibi, Dicle'nin en mühim bir şubesi, Van vilâyetinden Müküs nahiyesinden, bir kayanın mağarasından çıkıyor. Fırat'ın da mühim bir şubesi, Diyadin taraflarında bir dağın eteğinden çıkıyor. Dağların aslı, hilkaten bir madde-i mâyiadan incimad etmiş taşlar olduğu fennen sabittir. Tesbihat-ı Nebeviyyeden olan: $ kat'i delâlet ediyor ki: Asl-ı hilkat-i arz şöyledir ki: Su gibi bir madde, emr-i îlâhi ile incimad eder, taş olur. Taş, izn-i îlâhi ile toprak olur. Tesbihteki arz lâfzı, toprak demektir. Demek o su, çok yumuşaktır; üstünde durulmaz. Taş çok serttir, ondan istifade edilmez. Onun için Hakim-i Rahim, toprağı taş üstünde serer, zevilhayata makarr eder. S.)
nîle: f. çivit.
nîlî ›ÿ™ÿ: Mavi, çivit rengi.
nîlî perde: Gökyüzü, sema.
nîlu-berg: f. Nilüfer.
nîlüfer: f. Beyaz, mavi ve sarı çiçekler açan bir cins su bitkisi. * Bursa yakınlarında akan bir akarsu.
nîm ›ÿš: f. Yarım, nısf, buçuk, yarı.
nîm ›ÿš: Eski kürk. * Bir ot cinsi.
nîmal: (Neml. C.) Karıncalar.
nîmar: (Nimr. C.) Kaplanlar.
nîmat: (Nemat. C.) örtüler, ihramlar.
nîmbîsmîl: f. îyice boğazlanmayıp yarı kesilmiş olan.
nî'me ›”š: Ne iyi, ne âlâ, ne güzel.
nîme ›ÿšœ: f. Yarım, nısf, yarı.
nîme nîme: f. Parça parça, yarım yarım.
nî'me-l matlub: Tam aradığımız. îsteyip aradığımızın en âlâsı.
nî'me-l mevla ›”š‚ƒ™š™ÿ: Ne iyi sâhib ve mâlik, ne iyi Allah (C.C.)
nî'me-l vekîl ›”š‚ƒ™˜ÿ™: Ne güzel, ne iyi vekil.
nî'me-l vesîle ›”š‚ƒ™žÿ™œ: Ne güzel sebeb, ne âlâ vesile.
nî'me-r rakîb: Ne iyi gözetici, koruyucu.
nîme-î ruz: Günün ortası. Yarım gün.
nîme-ruz: (Bak: Nime-i ruz)
nî'met ›”š : (Nimet) îyilik, lütuf, ihsan. Saadet. Hidayet. * Giyecek şeyler. * Yiyecek faydalı şey, rızık.(Eğer dünyanın veya vücudun mülkiyeti, zılliyeti sende ise, taahhüd, tahaffuz, korku külfetleriyle nimetlerden lezzet alamazsın, dâima rahatsız olursun. çünkü noksanları tedarik, mevcutları telef olmaktan muhafaza ile dâimâ evham, korkular, meşakkatlere mahal olursun. Halbuki o nimetler Mün'im-i Kerim'in taahhüdü altındadır. Senin işin O'nun sofra-i ihsanından yeyip içmekle şükretmektir. şükürde bir zahmet yoktur. Bilâkis nimetin lezzetini arttırır. çünkü şükür, nimette in'amı görmek demektir. în'amı görmek, nimetin zevalinden hâsıl olan elemi defeder. Zira nimet zâil olduğundan Mün'im-i Hakiki, onun yerini boş bırakmaz, misliyle doldurur ve teceddüdünden lezzet alırsın. M.N.)
nî'met-î îlâhîye: Allah'ın nimeti. Allah'ın verdiği nimet.
nî'met-şînas ›”š…‚›ƒž: f. Kendisine yapılan iyiliği bilip unutmayan.
nîmgerm: f. Pek sıcak olmayan. Ilık.
nîmhab: f. Yarı uykulu, mahmur.
nîmhande: f. Gülümseme, tebessüm.
nîmküşte: f. Yarı öldürülmüş, yarı kesilmiş olan.
nîmlahza: f. Yarım bakış. Gözucuyla bakış. * çok kısa zaman.
nîmmanzur: f. Yarı görülen. Bulanık olarak görülen.
nîmmest: f. Sarhoşça.
nîmmuzlîm: f. Yarı karanlık.
nîmmürde: f. ölüm derecesinde olan. ölüm hâlinde bulunan.
nîmnîgâh: f. Yarı bakış. Gözucuyla bakma.
nîmnîme: Birbirlerine yakın çizgiler. * Tırnakta olan beyazlık.
nîmnîmeteyn: Tırnak işareti.
nîmpuhte: f. Tam pişmemiş, yarı pişmiş.
nîmr: (C.: Enmâr - Nümur - Nimâr) Kaplan.
nîmre: Dişi kaplan.
nîmres: f. Yarı ham, yarı olgunlaşmış olan.
nîmruz: f. Yarı gün, öğle.
nîms: Bir ot cinsi.
nîms: Firavun faresi dedikleri küçük hayvan. * Sansar.
nîmsüfte: f. Yarım olarak söylenmiş, tam denmemiş.
nîmşeb: f. Geceyarısı.
nîmten: f. Mintan.
nîmzînde ›š‚›šœ: Yarı canlı. ölü ile diri arası.
nîmzulmet: f. Yarı karanlık.
nînan: (Nun. C.) Balıklar, semekler.
nîr: (C.: Nirân-Enyâr) öküz boyunduruğu. * Bez damgası. * Irgaç.
nîran ›ÿœƒ›: (Nur ve Nâr. C.) Nurlar, ziyalar. Ateşler, nârlar.
nîrenc: (C.: Nirencât) Düzen, hile. * Resim, taslak.
nîreng: f. Düzen, hile, aldatmaca. * Taslak, resim. * Büyü, efsun.
nîru: f. Kuvvet, güç, zor.
nîrumend: f. Güçlü, kuvvetli, zorlu.
nîrumendî: f. Kuvvetlilik, zorluluk, güçlülük.
nîs': (C.: Ensu') Gizlemek. * Gitmek. * Sarkık olmak. * Kuzey rüzgârı.
nîs'a ›ž”œ: (C.: Nüsu'-Ensu'-Ensâ') Devenin göğsü için yapılan enli kolan.
nîsa ›žƒ£: (C.: Nisvân) Kadınlar.
nîsa suresî: Kur'an-ı Kerim'in dördüncü suresi.
nîsab ›ƒ„: Zekât ölçüsü, ölçü miktarı. * üzerine zekât verilmesi farz olan mal miktarı. * Asıl, esas. Sermaye mal. Derece, had. * Fık: Altının nisabı: 20 miskal; gümüşünki 200 dirhem (yani 600 gram); koyun ile keçinin 40 adet; sığır, manda 30; ve devenin nisabı da 5'dir. * Bir mecliste görüşmeye başlanabilmek, yahut karar verebilmek için bulunması şart olan âza sayısı. * Hisse, nasib. * îstenilen had, derece. (Bak: Zekât)
nîsab-i ekserîyet: Ekseriyet derecesi. çoğunluk derecesi.
nîsacet: Dokumacılık.
nîsaî ›žƒ¡: (Nisâiye) Kadınlarla alâkalı, kadınlara dâir.
nîsal: (Nasl. C.) Ok ve kargı gibi şeylerin uçlarındaki sivri demirler.
nîsar ›ƒœ: Saçmak, dağıtmak. * î'ta etmek. Vermek.
nîsar ›ƒœ: "Saçan, saçıcı" mânasına gelir ve kelimeleri sıfatlandırır. Meselâ: Pertev-nisar $ : Işık saçan.
nîsarçîn: f. Saçılan şeyleri toplayan.
nîsbet ›ž„…: Münasebet, yakınlık, bağlılık, ölçü. * Rağmen. înat olarak. înat olsun diye.
nîsbeten: Nisbetle, kıyaslanarak. öncekine göre. Bir dereceye kadar. şöyle böyle.
nîsbî ›ž„ÿ: (Nisbiye) Kıyaslama ile olan. Diğerine, öncekine göre. Diğerlerine göre kıyaslıyarak olan. Nisbete, ölçüye göre.
nîseb ›ž„: Nisbetler, kıyaslamalar ve ölçüler.
nîst: f. Değildir, yoktur.
nîstî: f. Yokluk, adem.
nîsun: (Nisvan. C.) Kadınlar.
nîsvan ›žƒ›: (Nisa. C.) Kadınlar. Nisalar.
nîsvan-i zelîl: Ahlâken ve dinen düşmüş, zelil olmuş kadınlar.
nîsvî: Nisa taifesine mensub. Kadınlarla alâkalı.
nîsyan ›žÿƒ›: Unutmak, hatırdan çıkarmak.
nîsyan-î ebedî: Ebedi unutma.
nîş: f. (Arı, akrep gibi böceklerde olan) îğne. * Diken. * Ağu, zehir.
nîşa: f. Nişasta.
nîşad ›ƒš: Bir kimseye yemin vermek.
nîşande: Hedef. Nişan olarak dikilmiş şey. 
nîşan(e) ›ƒ›: f. îz. Nişan. Alâmet. îşaret. * Yara izi. * Hedef, vurulması istenen nokta. * Hâtıra için dikilen taş. * Taltif için verilen madalya. * Evlenmeden önceki anlaşma ve karar işareti veya merasim. * Tuğra. * Ferman.
nîşane ›ƒ›œ: (Bak: Nişan)
nîşane-î tasdîk ›ƒ›œý‚…šÿ—: Kabul edildiğine dâir işaret, tasdik işareti. * Mu'cizeler.(Kabir, ehl-i iman için bu dünyadan daha güzel bir âlemin kapısı (olduğunu) ihbar eden 124 bin muhbir-i sâdık, ellerinde nişane-i tasdik olan mu'cizeler bulunan enbiyalar ve o enbiyaların haber verdikleri aynı haberleri, keşif ve zevk ve şuhud ile tasdik eden ve imza basan 124 milyon evliyanın aynı hakikata şehadetleri ve hadd ü hesaba gelmeyen muhakkiklerin kat'i delilleriyle o enbiya ve evliyanın aklen ilmelyakin derecesinde isbat ettikleri ve yüzde doksandokuz ihtimal-i kat'i ile "idam ve zindan-ı ebediden kurtulmak ve o yolu saadet-i ebediyeye çevirmek, yalnız iman ve itaatledir" diye ittifaken haber veriyorlar. S.) (Bak: Muhbir-i sâdık)
nîşangâh: f. Hedef yeri. Nişan tahtası. * Silâh namlusunun üstünde bulunan, nişan almağa yarayan kısım.
nîşde (nîşdân): Talep etmek, istemek. * Söz vermek, and vermek.
nîşdet: Araştırıp sorma. * Kaybolan bir şeyi arama.
nîşe: f. çoban düdüğü. Kaval.
nîşest: f. Oturan.
nîşeste: (C.: Nişeste-gân) f. Oturan, oturmuş.
nîşeste-gân: (Nişeste. C.) f. Oturanlar, oturmuş olanlar.
nîşestgâh: f. Oturacak yer.
nîşhar: f. Diken batmış, iğnelenmiş.
nîşîb: f. (Yukarıdan aşağıya) iniş.
nîşîb ü fîraz: îniş ve yokuş.
nîşîbgâh: f. çukur yer.
nîşîmen: f. Oturacak yer.
nîşîmengâh: f. Durak, yurt. Toplanılacak yer.
nîşîn ›ÿ›: f. "Oturan, oturmuş" gibi mânâya gelir ve başka kelimelerle birleşir.
nîşînende: f. Oturan, oturucu.
nîşter: f. Hekim bıçağı, neşter.
nîşve: Koklamak. * Bilmek. * Haber vermek.
nîta': (C.: Nutu') Deri döşek.
nîtac: Yavrulama, yavru doğurma.
nîtaf: (Nutfe. C.) Saf ve duru sular.
nîtah: Tos vurma, toslaşma. Boynuzla vurma. * Vuruşup kavga etme.
nîtak: Kemer, kuşak. * Kuşak yeri. * Peştemal.
nî'tal: Kova.
nîtasî: Anlayışlı tabib, doktor.
nîva: Düşmanlık. * Besili, semiz deve.
nîve: f. înleme, ağlama, sızlanma.
nîvend: f. îdrak, anlayış, akıl.
nîver: f. âlemde meydana gelen hâdiseler, haller.
nîya: (C.: Niyâgân) Dede, cedd.
nîyabe: Nöbet.
nîyabet ›ÿƒ„…: Nâiblik, vekillik. Kadı vekilliği.
nîyagân: (Niyâ. C.) Dedeler, ceddler. Ecdad.
nîyam: (Nâim. C.) (Nevm. den) Uykuda olanlar, uyuyanlar.
nîyam: f. Kılıf, kın. Kılıç kını.
nîyamger: (C.: Niyamgerân) Kın veya kılıf yapan san'atkâr.
nîyar: (Nâr. C.) Ateşler.
nîyat ›ÿƒ…: (Niyet. C.) Niyetler.
nîyat: (Niyâta) Bir damar ismi (yürek onunla bağlıdır.)
nîyaz ›ÿƒ: f. Yalvarma, yakarma. Dua. * Rağbet ve istek. * Hâcet, ihtiyaç.
nîyazî-î misrî: (Mi: 1618 - 1694) Malatya'nın Soğanlı köyünde doğdu. şâir ve tasavvufçu olup Halveti tarikatının Niyaziye veya Mısriye şubesini kurmuştur. Mısır'da Câmi-ül-Ezher'de tahsil gördü. 1646'da îstanbul'a döndü ve Sokollu Mehmed Paşa Medresesinde irşada başladı. Eserlerinden bazıları şunlardır: Risale-i Hasaneyn, Mevâid-ül îrfan ve Avâid-ül îhsan, Hidayet-ül îhvan, Mektubat gibi eserleri ve bir de şiirlerini cami' divanı vardır. 
nîyazkâr ›ÿƒ˜ƒœ: f. Yalvarıp yakaran. Dua eden. îhtiyacı olan.
nîyazkârâne: Yalvararak, niyaz ederek. * Muhtaç olarak, muhtaçlıkla.
nîyazmend: (C.: Niyazmendân) f. îhtiyacı olan, muhtaç. * Yalvaran, yakaran, niyaz eden.
nîyere: (Nâr. C.) Ateşler.
nîyet ›ÿ…: Kasd. Kalbin bir şeye yönelmesi. * Fık: Yapılan bir vazife ile Cenab-ı Hakk'a taatta bulunmayı ve O'na mânen yaklaşmayı kasdetmektir.(Niyet, ölü ve meyyit olan hâletleri ihya eden ve canlı, hayatlı ibadetlere çeviren bir ruhtur. Ve keza niyette öyle hâsiyet vardır ki; seyyiâtı hasenâta ve hasenâtı seyyiâta tahvil eder. Demek niyet, bir ruhtur. O ruhun ruhu da ihlâsdır. öyle ise necat, halâs ancak ihlâs iledir. îşte bu hasiyete binaendir ki; az bir zamanda çok ameller husule gelir. Buna binâendir ki; az bir ömürde, Cennet bütün lezâiz ve mehasiniyle kazanılır. Ve niyet ile insan, dâimi bir şâkir olur. şükür sevabını kazanır. M.N.)
nîylec: çivit.
nîyy: çiğ, olmamış, ham.
nîyyat: (Niyet. C.) Niyetler.
nîza ›ƒ£: Cima etmek.
nîza' ›ƒ”: çekişme, kavga. (Dünya öyle bir meta' değil ki; bir niza'a değsin. "çünki fani ve geçici olduğundan kıymetsizdir." Koca dünya böyle ise dünyanın cüz'i işleri ne kadar ehemmiyetsiz olduğunu anlarsın. M.) 
nîza-î lafzî: Boşuna çene yarıştırma. Sözle yapılan kavga.
nîzal: Nişan, işaret, alâmet.
nîzam ›“ƒš: Sıra, dizi, düzen. Dizilmiş olan şey, sıralanmış. * îcaba göre yapılan kanun. Bir kaideye binaen tertib olunmak ve ona binaen tertib olundukları kaide. * Bir işin sebat ve kıyamına medar, sebep olan şey ve hâlet.
nîzam-i âlem: Kâinatta Allah'ın koyduğu umumi nizam. (Nizam-ı âlem saadet-i ebediyeye işaret ediyor. S.) (Bak: Delil-i inayet)
nîzam-i cedîd ›“ƒš‚‡šÿš: Yeni nizam. Osmanlı Devletinde III. Sultan Selim zamanında yeni nizamla yetiştirilen bir askeri teşkilât.
nîzam-üd dîn: (Nizameddin) Dinin nizam ve düzeni.
nîzamât ›“ƒšƒ…: (Nizam. C.) Nizamlar, muntazam şeyler, düzenler.
nîzamât-i lâzîme: Lüzumlu, gerekli nizamlar.
nîzamen: Nizam dairesinde. Nizama ve kanuna tabi olarak.
nîzamî: Düzenli, tertipli, usulüne uygun. * Kanun ve nizama ait, onunla alâkalı.
nîzamîye: îlk askerlik devresi. * Bu nevi askerlik işleriyle uğraşan daire. * Tanzimat ordusunun asıl silâh altında bulunan kısmı.
nîzar: Korkutup, uygunsuz şeylerden vazgeçirmek için söylenilen söz.
nîzar ›ƒœ: Zayıf, arık, düşkün, bitkin.
nîzaret: f. Zayıflık, arıklık.
nîze ›ÿœ: Mızrak.
nîzedâr: f. Mızraklı. Kargılı. Süngülü.
nîzek: f. Câriye. * Küçük mızrak, süngü.
nîzezen: f. Mızrakla vuran. * Mızrakçı.
nîzk: Küçük süngü.
nobran: Sert mizaçlı, inatçı, nâzik olmayan.
noksan: (Nuksan) Eksik, kusurlu, nâkıs. * Eksiklik, azlık. Eksilme, azalma. * Yokluk.
noksanî: Eksiklik ve noksanlıkla alâkalı.
noksanîyet: Eksiklik, noksanlık.
nokta ›—’œ: (Nukta) Benek. * Durak, mevki. Mahâl. * Göze ârız olan leke. * Durak işareti. * Tek karakol, tek nöbetçi. * Yazıdaki durak işâreti. * Mat: Hiçbir uzunluğu olmayan şekil.
nokta-î bînîş: Gözbebeği.
nokta-î galeyân: Suyun buhara çevrildiği harâret derecesi.
nokta-î îstîmdad: Yardım isteme noktası. însanın kalbindeki sonsuz emel ve arzuların yerine getirilmesine olan ihtiyaç.
nokta-î îstînad: Dayanma ve güvenme noktası. Kâinatta cereyan eden ve insana dehşet verip âciz bırakan hâdiseler karşısında insanın çok kuvvetli bir yere dayanmaya ve güvenmeye olan fıtri ihtiyacı.
nokta-î mîhrakîye ›—’œý‚šˆœƒ—ÿœ: Yanma noktası. Odak noktası. * çok Esmâ-i îlâhiyyenin tecellisinin toplandığı nokta.
nokta-î nazar ›—’œ£‚›“œ: Görüş, bir nevi fikir. (Bak: Rasyonalizm)(Nazar-ı Nübüvvet ve tevhid ve imân; vahdete, âhirete, Uluhiyete baktığı için, hakaikı ona göre görür. Ehl-i felsefe ve hikmetin nazarı; kesrete, esbâba, tabiata bakar, ona göre görür. Nokta-i nazar birbirinden çok uzaktır. Ehl-i felsefenin en büyük bir maksadı, ehl-i usulü'd-din ve ülemâ-i îlm-i Kelâm'ın makasıdı içinde görünmiyecek bir derecede küçük ve ehemmiyetsizdir.îşte onun içindir ki, mevcudatın tafsil-i mâhiyetinde ve ince ahvallerinde ehl-i hikmet çok ileri gitmiş fakat hakiki hikmet olan Ulûm-u Aliye-i îlâhiyye ve Uhreviyede o kadar geridirler ki, en basit bir mü'minden daha geridirler. Bu sırrı fehmetmiyenler, muhakkıkin-i îslâmiyeyi, hükemalara nisbeten geri zannediyorlar. Halbuki, akılları gözlerine inmiş, kesrette boğulmuş olanların ne haddi var ki, Veraset-i Nübüvvet ile makasıd-ı âliye-i kudsiyeye yetişenlere yetişebilsinler.Hem herbir şey iki nazar ile bakıldığı vakit, iki muhtelif hakikatı gösteriyor. îkisi de hakikat olabilir. Fennin hiçbir hakikat-ı kat'iyyesi, Kur'anın hakaik-ı kudsiyesine ilişemez. Fennin kısa eli, onun münezzeh ve muallâ dâmenine erişemez. Nümune olarak bir misâl zikrederiz:Meselâ, Küre-i Arz ehl-i hikmet nazariyle bakılsa hakikatı şudur ki: Güneş etrafında mutavassıt bir seyyare gibi hadsiz yıldızlar içinde döner. Yıldızlara nisbeten küçük bir mahluk. Fakat ehl-i Kur'an nazariyle bakıldığı vakit hakikatı şöyledir ki: Semere-i âlem olan insan; en câmi', en bedi' ve en âciz, en aziz, en zaif, en lâtif bir mu'cize-i kudret olduğundan, beşik ve meskeni olan zemin: Semâya nisbeten maddeten küçüklüğüyle ve hakaretiyle beraber mânen ve san'aten bütün kâinatın kalbi, merkezi... bütün mu'cizat-ı san'atının meşheri, sergisi... bütün tecelliyat-ı esmâsının mazharı, nokta-i mihrakiyesi.. nihayetsiz faaliyet-i Rabbâniyyenin mahşeri, ma'kesi.. hadsiz Hallâkıyet-i îlâhiyyenin hususan nebatat ve hayvanatın kesretli envâ-i sagiresinden cevvadâne icadın medârı, çarşısı ve pek geniş âhiret âlemlerindeki masnuatın küçük mikyasta nümunegâhı ve mensucat-ı ebediyenin sür'atle işliyen tezgâhı ve menâzır-ı sermediyenin çabuk değişen taklidgâhı ve besâtin-i dâimenin tohumcuklarına sür'atle sünbüllenen dar ve muvakkat mezraası ve terbiyegâhı olmuştur.îşte Arzın bu azamet-i mâneviyesinden ve ehemmiyet-i san'aviyesindendir ki, Kur'an-ı Hakim; semâvata nisbeten büyük bir ağacın küçük bir meyvesi hükmünde olan Arzı, bütün semâvata karşı küçücük kalbi, büyük kalıba mukabil tutmak gibi denk tutuyor. O'nu bir kefede, bütün semâvâtı bir kefede koyuyor, mükerreren: $ diyor. îşte sair mesâili buna kıyas et ve anla ki: Felsefenin ruhsuz, sönük hakikatleri; Kur'an'ın parlak, ruhlu hakikatleriyle müsademe edemez. Nokta-i nazar ayrı ayrı olduğu için ayrı ayrı görünür. S.)
nokta-î tekatu': Kesişme noktası.
nokta-î telâkî ›—’œý‚…™ƒ—ÿ: Karşılaşma noktası. Uygun ve karşılıklı nokta. Buluşma noktası, yeri. * Münâsebet. Uygunluk.
nokta-î temas: Değme noktası. Temas etme noktası.
nokta-î zerrîn: Güneş. Altun nokta.
noktateyn: îki nokta.
normal ›œšƒ™: Fr. Kanun, usul ve âdetlere uygun olan. Uygun. * Mat: Bir eğri çizgiye teğet olan doğrunun değme noktasından bu doğruya çizilen dik çizgi.
nota ›’œ: (îtalyancadan) Emir ve istek bildiren yazı. * Bir şeyi sonradan hatırlamak için konan işaret. * Resmi ve siyasi mektup, muhtıra. * Mülâhazat. * Hesap pusulası. * Müziğe ait yazı.
nuaa: Yumuşak ot.
nuak (naîk): çobanın koyuna haykırıp çağırması.
nuas ›”ƒž: Uyuklama, uyuşukluk. (Bak: Nüas)
nuf: f. Yankı. Aks-i sadâ.
nufaha: Su üzerindeki kabarcık.
nu'fe: Erkeklerin iki yanına sallanan saçı.
nugaşî: Kısa boylu adam.
nugbe: (C.: Nugab) Bir içim su.
nuger: f. Köle, kul.
nugerî: f. Kölelik, kulluk.
nugnug: (C.: Negânig) Boğaz içinde olan et. * Kulak içinde fazlalık olan nesne.
nugre: (C.: Nugur-Nugrân) Serçe kuşu büyüklüğünde olup kırmızı olan bir kuşun adı.
nugz (nagz): Kürek ucuna bitişik olan kıkırdak.
nuh (aleyhîsselâm): Kur'an-ı Kerim'de adı geçen bir peygamber ismi. (Elli yaşında iken kavmini imana dâvete memur edilmiş ve kavmi kendisini dinlemediğinden, iman etmeyenlere ceza olarak dünyayı kaplayan su tufanı olmuş ve zâlimler mahvolmuşlar; iman edenler Nuh Peygamber'in (A.S.) yaptığı gemiye alınarak kurtulmuşlardır.)
nuh suresî: Kur'an-ı Kerim'de 71. Suredir ve Mekkidir.
nuha': Boyun kemiği içindeki murdar ilik.
nuhaa: Tükürmek.
nuhame: Balgam.
nuhas ›ˆƒž: Bakır. Bakır para. * Kızgın mâden. * Kıtr. Ateş. Tunç ve demir döğülürken sıçrayan şerâre. * Dumansız alev. * Bir şeyin aslı. * Tütün.
nuhasî: Bakırlı, bakırla alâkalı, bakırdan.
nuhat: Nahiv (gramer) âlimleri.
nuhat: Hıçkırma.
nuhbe: Herşeyin seçkini, iyisi. * Seçkin, seçilmiş, müntehab, güzide. * Korkak.
nuhbe-î âmâl: Mefkure, ideal. Emellerin en sonu.
nuhî: Nuh (A.S) ile ilgili. * Pek eski.
nuhl: Karşılıksız hediye ve hibe.
nuhla: Atiyye, hediye.
nuhre: Kemik dokusunun çürümesi.
nuhre: Burun deliği.
nuhrub: (C.: Nehârib) Kaya yarığı. * Arı kovanı. * Arı sesi.
nuht: çocukla birlikte karından çıkan su.
nuhul ›ˆ™: Zayıflık, arıklık.
nuhur ›ˆœ: (Nahr. C.) Ayların evvelleri. * Göğüsler. (Bak: Nahr)
nuhuset: Uğursuzluk.
nuhust: f. Birinci, ilk, evvel.
nuhustîn: f. Birinci, ilk, evvel.
nuhustzâd: f. îlk doğmuş olan. Evvel doğan.
nuk ›˜: f. Okun ucu, temren. Kuş gagası. * Gaga gibi sivri uçlu olan şey.
nuk ›—: (Naka. C.) Dişi develer.
nuka: Her şeyin kötüsü.
nukaa: Birşeyi ıslamada kullanılan su.
nukat ›—ƒ’: (Nokta. C.) Noktalar.
nukave: Temizlik, paklık. * Her şeyin iyisi, seçkini.
nukaye: Her nesnenin iyisi.
nukaz: Küçük serçe kuşu.
nukaza: Binâdan yıkılmış veya örülmüş iplikten sökülmüş nesne.
nukbe: (C.: Nukab) Yol. * Yırtık, delik. * Paçasız don. * Levn, renk. * Pas.
nukre: Külçe hâlinde gümüş. * Ense çukuru.
nukre-î kafa: Ense çukuru.
nuksan: Eksilmek, noksanlaşmak.
nukta: (C.: Nukat-Nukut-Nikât) Nokta.
nukud ›—š: (Nakid. C.) Nakidler, paralar, akçeler, madeni paralar.
nukud-i mevkufe: Vakfedilen paralar.
nukul ›—™: Nakiller, rivâyetler. Başkasından anlatılanlar. Hikâyeler.
nukuş ›—: Resimler, nakışlar.
nukz: (C.: Enkâz) Binâ yıkıntısı.
nul: f. Kuş gagası.
nu'm: Sürur, neşe, sevinç, neşat.
nu'man ›”šƒ›: (Niam. C.) Dört ayaklı hayvanlar. * Kan. * îmam-ı Azam Hazretlerinin adı. * şakayık-ı nu'man denen bir lâle çiçeği. 
numîd ›šÿš: f. (Bak: Nevmid)
numruka: (C.: Nemarik) Küçük yastık.
numud ›šš: (Bak: Nümud)
numude ›ššœ: f. Gösterilmiş, gözükmüş olan. Nişan verilmiş. (Bak: Nümune)
nun ››: Kur'an alfabesinde yirmibeşinci harf. Ebced hesabına göre değeri ellidir. * Divid, kalem. * Kılıcın ağzı. Kılıç. * çene çukuru. * Balık, semek.
nun suresî: Kur'an-ı Kerim'de 68. sure ve Kur'anda müteşabih ve şifre olan bir harf.(Bütün kalemlerin ve tastir ve kitapların aslı, esası, ezeli me'hazı ve sermedi üstadı Kader'in kalemi ve Nur ve îlm-i Ezeli'nin nuruna işaret eden bir kelimedir. ş.)
nun-u mütekellîm-î maa-l gayr: Mütekellim-i maalgayrın "nun" harfi. Fiildeki cemi' sigasındaki nun. (Bak: Mütekellim-i maalgayr)
nun-u na'büdü ›‚›”„š: (Bak:Na'büdü) (Arkadaş! deki un ifade ettiği cem' ve cemaat; fikri ve kalbi ayık olan musallinin nazarında, sath-ı arzı bir mescid şekline getirir ve bütün mü'minlerden teşekkül etmiş, şarktan garba kadar dizilmiş safları havi o cemaat-i kübra içinde namaz kıldığını ihtar ettirir. M.N.)
nu'nu: Uzun boylu adam.
nu'nua: Devenin boyun eti. * Horozun boyun tüyü.
nur ›œ: Aydınlık. Parıltı. Parlaklık. Her çeşit zulmetin zıddı. Işık. * Kur'ân-ı Kerim. îman. îslâmiyet. Peygamber. * Zulmeti def eden, şule, ışık. (Bazılarınca ziya, nurdan daha sağlamdır ve daha hastır. Nur; dünyevi ve uhrevi olmak üzere iki nevidir. Dünyevi olanı da iki çeşittir: Biri: Envar-ı îlâhiyeden intişar eden nurdur. Akıl ve Nur-u Kur'an gibi. îkincisi: Görmekle hissedilir ki, nurlu cisimlerden ibarettir, güneş, ay ve yıldız gibi... Uhrevi nur: $ ilâ âhir.. âyet-i kerimesinde mensus olan nurdur. Nur, âlemin mânen aydınlığına sebep olan Hazret-i Peygamber'e de (A.S.M.) denir. $ âyetinde beyan olunduğu gibi eşyanın hakikatını olduğu gibi beyan eden şeye de "nur" denir. Meşhur bir zata "Nuri" denmiştir; bunun sebebi her ne zaman vaaza ve nasihata başlasa gayb âleminden nurun şimşek gibi parıltısı ona tecelli ederdi. L.R.)
nur suresî: Kur'an-ı Kerim'in 24. Suresinin ismi.
nur-feşan: (Bak: Nurefşan)
nur-î ayn ›œ”ÿ›: f. Göz nuru. * Pek sevgili olan.
nur-î çeşm: Göz nuru. Gözün iyi görür olması. * Mc: Saadet.
nur-î îman: îman nuru. Kur'an ve kâinat hakikatlarının görünmesine ve bulunmasına vesile olan imanın mânevi nuru.
nur-î kasd: Kasd ve irâdenin nuru. Kasd ve iradeden gelen parlaklık. Bir istek ve kasıtla yapıldığına âit alâmet ışığı.
nur-î mübîn: Mübin olan nur. Aşikâr ve açıklayıcı olan ve hak ile batılı ayıran nur. Bilhassa iman ve Kur'an ilminin mânevi nuru.
nur-î mücessem ›œ‚š‡žš: çok parlak ve güzel olan. Canlı kılığına girmiş gibi olan nur.
nur-ul envâr ›œ‚ƒ™¤›ƒœ: Nurların nuru.
nuran: Nurlu, parlak.
nuranî ›œƒ›ÿ: Nurlu, ışıklı, nura yakışır, parlak, münevver.
nuranîyyet ›œƒ›ÿ…: Nurlu olanın hali, parlaklık, nurluluk.
nurbahş ›œ„‰: f. Işık saçan, aydınlatan, parlatan.
nurculuk: Bediüzzaman Said Nursi Hazretleri ile Türkiye'de başlayan dini bir hareket ve faaliyettir. Bu hareketin en mühim istinad noktası, Risale-i Nur namındaki eserlerdir.Risale-i Nur eserleri 1926 - 1949 seneleri arasında yazılmıştır ve Kur'anın bu asra bakan mânevi bir tefsiridir. Bilhassa iman ve îslâm esaslarını ve Kur'anın hikmetlerini izah ve isbat eder.Siyasi ve dünyevi cem'iyetçilikten mücerred; ve aynı eserleri okumaktan doğan mânevi alâkadarlık ile gönüllerde kurulan nur irfan müessesesi mensublarına, yani Risale-i Nur eserlerini okuyanlara: "Risale-i Nur Talebesi"; kısaltılmış şekli ile "Nur Talebesi" veya "Nurcu" denilmektedir.Daha başka bir tarif ile Nurcu : Risale-i Nur Külliyatı'nı okuyanların meydana getirdiği maddilikten, teşkilâttan, cemiyet kademelerinden mücerred, aynı eserleri okumaktan doğan mânevi alâkadarlıktan ibaret olan ekol mensublarına da Nurcu denmektedir.Risale-i Nur ve Talebeleri, âlem-i îslâma, hattâ dünyanın her tarafına kadar genişlemiş ve hüsn-ü kabule mazhar olmuştur.Diyanet îşleri Başkanlığının 2.7.1963 tarih, 18746 sayılı yazısına ekli, Müşavere ve Dini Eserleri înceleme Kurulu'nun 29.6.1963 tarih, 326 sayılı kararında:"Nurculuk: Bir tarikat veya bir mezheb olmayıp, Said Nursi adındaki zâtın, son zamanlarda yayılma istidadı gösteren dinsizlik cereyanına karşı, Kur'an-ı Kerim âyetlerini ele alarak, Risale-i Nur namıyla yazdığı eserlere izafe edilen bir cereyandır. Adı geçen eserler, imanı fikirlerle birleştirmeye çalışmaktadır." şeklinde beyan edilmiştir.
nu're: (C.: Near-Nerât) Eşeğin burnuna giren bir cins sinek.
nurefşan ›œ‚¤–ƒ›: f. Etrafı aydınlatan, nur saçan, ışık veren.
nurî ›œÿ: Nura mensub, nura ait. * Erkek ismidir.
nurîye: Nura âit, nura mensub. * Kadın ismidir.
nurpaş: f. Nur saçan, nur saçıcı.
nurtal'at: Nur yüzlü.
nurun ala nur ›œ‚”™ÿ‚›œ: Daha âlâ, daha iyi, nur üstüne nur.
nusaha: (Nasih. C.) Nasihat edenler, öğüt verenler.
nusara: (Nasir. C.) Yardımcılar.
nusb ›„: (C.: Ensâb) Meşakkat, zahmet, elem. * Zehir, ağu. * Belâ, musibet. * Put, sanem, heykel.
nush ›ˆ: Nasihat, ögüt.
nusha ›ž‰œ: (Bak: Nüsha)
nusret ›œ…: (Nusrat) Yardım. Cenab-ı Hakkın yardımı, hususen ruhani muavenet. Zafer, galebe, fetih, üstünlük, başarı, düşmana gâlib olmak.
nussa: Saç kırpıntısı.
nussah: (Nâsih. C.) Nasihat edenler, öğüt verenler.
nussar: (Nâsır. C.) Yardımcılar.
nusu': çok beyaz olmak. * Hâlis olmak.
nusul: Huruç etmek, çıkmak. * Dühul etmek, girmek. (Ezdaddandır) * (Nasl. C.) Mızrakların uçlarındaki sivri demirler. Temrenler.
nusus ›: (Nass. C.) Nasslar. (Bak: Nass)
nuş ›: f. îçen, içici. * Tatlı şerbet gibi içilecek şey. * Zevk ve safâ.
nuşa nuş: f. îçtikçe içerek, tekrar tekrar içerek, defalarca içerek, içe içe.
nuşadur: f. Nişadır.
nuşdaru: f. Panzehir. * Tiryak. * şarap.
nuşe ›œ: f. şâd ve sevinçli. Mesrur olan.
nuşende: (C.: Nuşendegân) f. îçki içen kimse.
nuşhand: f. Tatlı gülüşlü.
nuşîden: "îçmek" mastarındandır. îçen ve içiçi gibi mânâlara gelir.
nuşîn: f. Lezzetli, tatlı.
nuşîrvan ›ÿœƒ›: îran'da Milâdi (531 - 579) tarihleri arasında hükümdarlık etmiş Sâsâni padişahı olup adâlet ve doğruluğu ile meşhur olmuştur.
nutfe ›’–œ: Duru ve sâfi su. * Meni. Rahimde iki yarım ve ayrı cinsten hücrelerin birleşmişi. * Taşmış, dökülmüş su. * Deniz.
nutfe ›…–œ: (C.: Nütef) Parmak ile yolunan şey.
nutî: (C.: Nevâti) Gemici.
nutk ›’—: (Nutuk) Söyleyiş, söyleme kabiliyeti, konuşma, hitabet. * Dervişlerce büyüklerin manzum sözleri.
nutk-u îftîtahî: Açış nutku.
nutu': (Nat'. C.) Meşinden yapılmış döşekler. * Sofra bezleri.
nutuf: (Nutfe. C.) Nutfeler, dölsuları, spermalar.
nutuh: Boynuzuyla vuran davar.
nuumet: Yumuşaklık.
nuut ›”…: (Na't. C.) Vasıflar, keyfiyetler, umuma şâmil sıfatlar. * Peygamberimiz Aleyhissalâtü Vesselâm hakkındaki medhiyeler.
nuyan: f. şehzâde. Pâdişah oğlu.
nu'z: Hicaz'da yetişen misvak ağacı.
nuzar: Altın. * Her nesnenin hâlisi ve iyisi. * Necid diyârında yetişen bir ağacın adıdır, ondan tas ve kâse yaparlar.
nuzc: $ (Nazc) Yemişin tam olarak yetişmesi, olgunlaşması. * Etin kemikten dökülür derece pişmesi. 
nuzera: (Nazir. C.) Akranlar, eşler.
nuzub (nazab): Sinmek. * Iraklık, uzaklık. * Suyun, toprak tarafından emilmesi.
nüame: Eksen. çark veya çıkrık ortasındaki mihver.
nüamî: Güney rüzgârı.
nüans: Fr. înce fark.
nüas ›”ƒž: Uyuklama, uyku gelip basma. * Hislere ârız olan uyuşukluk ve fütur. Pineklemek.
nüasî: Uyuklama ile ilgili.
nübah: Havlama.
nübea: (Nebi. C.) Nebiler, peygamberler.
nübele: (C.: Nübel) îstincâ taşı. * Kesek parçası.
nüble ›„™œ: îhsan, atiyye. Fazl. 
nübta: Atın kolanı veya karnı altında olan beyazlık.
nübu': Suyun, yerden çıkıp akması.
nübub: Bitmek.
nübut: Suyun, yerden çıkıp akması.
nübüvvet ›„…: (Nebi. den) Peygamberlik, nebi olmak, nebilik. Allah'ın (C.C.) emriyle vazifeli olarak insanları doğru yola çağırmak. (Bak: Muhammed (A.S.M.) - Resül)(.... Hem mâdem nev-i beşerde Nübüvvet vardır. Ve yüzbinler zât -Nübüvvet dâva edip mu'cize gösterenler - gelip geçmişler. Elbette umumun fevkinde bir kat'iyyet ile Nübüvvet-i Ahmediye (A.S.M.) sabittir. çünkü îsa (A.S.) ve Musa (A.S.) gibi umum resüllere nebi dedirten ve risâletlerine medar olan delâil ve evsâf ve vazifeler ve ümmetlerine karşı muameleler, Resül-i Ekrem'de (A.S.M.) daha ekmel, daha câmi bir surette mevcuddur... M.)(Enbiya-yı Sâlifinde nübüvvete medar ve esas tutulan noktalar ve onların ümmetleriyle olan muâmeleleri hakkında yalnız zaman ve mekânın tesiriyle bazı hususat müstesnâ olmak şartiyle yapılacak tam bir teftiş ve kontrol neticesinde Hazret-i Muhammed Aleyhissalâtü Vesselâmda daha ekmel, daha yüksek bulunmakta olduğu tahakkuk eder. Binaenaleyh nübüvvet mertebesine nâil olanların hey'et-i mecmuası mu'cizeleriyle vesair ahvalleriyle, lisan-ı hal ve kal ile nev-i beşerin sinni kemâle geldiğinde üstad-ül beşer ünvânını taşıyan Hazret-i Muhammed Aleyhissalâtü Vesselâm'ın sıdk-ı nübüvvetine ilân-ı şehadet etmişlerdir. O Hazret de (A.S.M.) bütün mu'cizeleriyle Saniin vücub ve vahdetini nurlu bir bürhan olarak âleme ilân etmiştir. O Zat'ın (A.S.M.) ahvâl ve harekâtı birer birer yani tek tek O'nun sıdk ve hakkaniyetini gösterirse hey'et-i mecmuası O'nun sıdk-ı nübüvvetine öyle bir delil olur ki; şeytanları bile tasdike mecbur eder.î.î.)(Bil ki nev-i beşerde nübüvvet, beşerdeki hayır ve kemâlâtın fezlekesi ve esasıdır. Din-i hak saadetin fihristesidir. îman bir hüsn-ü münezzeh ve mücerreddir. Madem şu âlemde parlak bir hüsün, geniş ve yüksek bir feyiz, zâhir bir hak, fâik bir kemâl görünüyor. Bilbedâhe hak ve hakikat, Nübüvvet içindedir ve nebiler elindedir. Dalâlet, şer ve hasâret, onun muhâlifindedir... M.N.)
nübüvvet da'va etmek: Peygamber olduğunu bildirip doğruluğunu isbat için deliller göstermek, peygamberliğini ileri sürmek.
nübüvvet-penah ›„…‚¨›ƒœ: Peygamber, nebi. Nübüvvet kendisine istinad eden zât.
nüc'a: Otlu yer istemek.
nüceba: (Necib. C.) Necib kimseler. Nesli, soyu sopu temiz ve pâk olan kişiler.
nücebe: Lütuf ve keremi çok olan. Cömert insan.
nüceym ›‡ÿš: Yıldızcık. Küçük parıltısı olan. Küçük yıldız.
nüch (necâh): Zafer bulmak. Hâlâs olmak. Kurtulmak. îhtiyaçlarını giderip zafer bulmak.
nücme: Bir ot cinsi.
nücu': Yemeğin hazmolup sindirilmesi. * Eser yapmak. * Duhul etmek, girmek.
nücum ›‡š: Tulu' etmek, doğmak. * Görünmek, zuhur etmek.
nücum ›‡š: (Necm. C.) Yıldızlar. 
nücum-perest ›‡š‚¨œž…: f. Yıldıza tapanlar.
nücum-u sâkibe: Işığıyla karanlığı delip geçen yıldızlar.
nücum-u seyyare ›‡š‚žÿƒœœ: Seyyar, gezici yıldızlar.
nücumî: Yıldızlarla ilgili. * Yıldızlarla uğraşan.
nüda: (C.: Endâ-Endiye) Yağmur. * Boğaz ıslatıcı nesne. * çiy, rutubet. * Atâ, bahşiş. * Sesin uzaklara gitmesi.
nüdbe: ölen bir kimsenin iyilikleri, mehasini sayılarak ağlamak.
nüd'e: Mal çokluğu. * Kavs-i kuzeh. Gökkuşağı. * Et köpüğünün üstü. * îç yağı.
nüdema: (Nedim. C.) Nedimler.
nüdfe: Atılmış az nesne. * Sağılmış az süt.
nüdga: Tırnak sonunda olan beyazlık.
nüdha: Genişlik, vüs'at.
nüdub: (Nedebe. C.) Yara izleri, nedbeler.
nüfase: Diş arasında kalan yemek parçası.
nüfaz (nüfâze): Ağaçtan veya başka birşeyden silkmekten ve hareket ettirmekten dolayı düşen nesne.
nüf'e: (C.: Nifâ) Seyrek ve dağınık olan ot.
nüfesa: Loğusa kadın.
nüffaha: (C.: Nefehâ) Suyun üstünde olan kabarcığı.
nüfha: Yüce beyaz tepe.
nüfture: (C.: Nefâtir) Müteferrik, dağılmış ot.
nüfuk: Helâk olmak.
nüfur ›–œ: ürküp kaçma, dağılma, firar etme. * întikal etme. * Hacıların Mina'dan Mekke'ye doğru gitmeleri.
nüfus ›–ž: (Nefs. C.) Nefisler, canlar, şahıslar.
nüfus-u seb'a: 1- Nefs-i emmare, 2- Nefs-i levvame, 3- Nefs-i mülhime, 4- Nefs-i mutmainne, 5- Nefs-i râdiye, 6- Nefs-i mardiyye, 7- Nefs-i sâfiye. (Bak: Nefs)
nüfuş (nefâş): Yabana yayılmak. * Davarların geceleyin yayılıp çobansız otlamaları.
nüfuz ›–‹: Sözü geçer olmak, sözü dinlenmek. * Vücudundan işleyip geçmek. îçine alan.
nüfz: Arka ve kürek eti.
nüfza: Bir yere saçılmış veya dökülmüş olan kan.
nügak (nagîk): çobanın koyuna çağırıp haykırması.
nüh ›œ: f. Dokuz.
nüha ›œÿ: Yüksek olmak. * Miktar. * Bir kimse hakkında olan yasak ve men.
nühab: Deve öksürüğü.
nühak: Eşek anırtısı.
nühale: Kepek.
nüham: Bir kuş cinsi.
nühame: Tükrük.
nühas ›ˆƒž: Bakır. * Duman. (Bak: Nuhâs)
nühat: Mağrur ve kibirli kimse. Kendini beğenmiş insan.
nühate: Yonga. Talaş.
nühaz: Yokuş. * Güç yer.
nühaz: Deve öksürüğü. * Devenin göğsünde olan bir hastalık.
nühbe: Gadapla ve kahirle cebren alınan mal.
nühbe: (C.: Nuheb) Her nesnenin iyisi.
nühbur: (C.: Nehâbir) Kum yığını.
nühs: Kuş ismi.
nühs: Dağ.
nühu': Kusmak.
nühud ›ˆ‘: (Nühuz) Kalkmak, kıyam etmek, yerinden yükselmek. * şiddetle muharebe etmek.
nühud: Atın iri gövdeli olması.
nühul ›ˆ™: Arık, zayıf olmak. * Arılar. Bal arıları. (Bak: Nuhul)
nühur: (Nahr. C.) Kurbanlar.
nühur: Akarsular, nehirler, ırmaklar.
nühur: f. Göz, basar, ayn.
nühur: Ayların evvelleri.
nühuset ›ˆžœ: Yaramazlık, uğursuzluk. (Mübârek'in zıddı)
nühust ›‰ž…: f. îlk gelen, evvel doğan, evvelki olan.
nühuz: Hareket etme, deprenip kalkma.
nühüft: f. Saklı, gizli. 
nühüfte: f. Saklı, gizli.
nühüftegî: f. Gizlilik, saklılık.
nühüm ›œš: f. Dokuzuncu.
nühüve: (Et) çiğ olmak.
nühye: (C.: Nühâ) Akıl. * Gayet. Son.
nühza: Devenin göğsünde olan bir hastalık.
nühze: Fırsat.
nükaf: Deveyi öldüren bir verem.
nükah: Tatlı soğuk su.
nükas: Devenin dudağında olan bir hastalık.
nükat ›˜ƒ…: (Bak: Nikât- Nüket)
nüket ›˜…: (Nükte. C.) Nükteler. Herkesin anlayamıyacağı ince mânâlı ve zarif sözler.
nükhet ›˜œ : Râyiha. Ağız kokusu. * Günahlı sözler. Hoş olmayan günah olan söz, kelime.
nükke: Zayıflıktan dolayı sesi çıkmayan deve.
nükr ›˜œ: Anlayışı, fikri, ferâseti iyi olmak. * Zorluk. * înkâr.
nükre: Bilinmezlik. * Zorluk, güçlük. * Kabile ismi.
nüks ›˜ž: Hastalığın geri dönmesi, depreşmesi.
nükte ›˜…œ: înce mânalı söz, idraki ve anlaşılması nezâket ve zarifliğe dayanan nazik husus. îbarenin asıl mânasından başka olan nazik ve lâtif mânâ, dikkatle anlaşılabilen ince mânâ. * Yere ağaçla vurup eser bırakmak.
nükte-âmîz: f. Nükte karıştıran.
nüktebîn: f. înceliği gören, nükteyi anlıyabilen. Kavrayışlı, anlayışlı, zeki.
nüktedân: f. Nükte bilen. înce ve zarif kimse.
nüktedânî: Nüktecilik, nüktedanlık.
nüktedâr: f. Nükteli söz söyleyen. Nükteli konuşan.
nüktegu: f. Nükteli konuşan, nükteli söz söyleyen.
nükteguyî: f. Nükteli konuşma. Nükteli söz söyleme.
nükteperdaz: (C.: Nükteperdâzân) f. Nükteli söz söyleyen, nükteli konuşan.
nüktepîra ›˜…œ‚¨ÿœƒ: f. Nükteye süs veren.
nüktesenc: (C.: Nüktesencân) f. Nükteyi değerlendiren. Nükteden anlayan. Nükteyi yerinde kullanan.
nüktever: f. Nükteyi anlamakta mâhir olan, nükte bilen.
nüku': Kısa boylu kadın.
nükub: Rücu' etmek, geri dönmek. * Udul etmek, ayrılmak. * (Nekbet. C.) Tâlihsizlikler, şanssızlıklar. Felâketler, musibetler, düşkünlükler.
nükul: Vazgeçme, geri dönme, cayma.
nükus: Ardına dönmek.
nülk: Alıç adı verilen dağ yemişi.
nüma ›šƒ: f. Gösteren veya gözüken mânasında olup, birleşik kelimeler yapılır.
nümayan ›šƒÿƒ›: f. Görünen, aşikâr olan, gözükücü olan. Parlayan.
nümayanter: f. Fazla görünen, en çok görünen.
nümayende: f. Gösterici.
nümayîş: .f Görünüş, gösteriş, dış görünüş. Gösteri.
nümayîşgâh: f. Gösteri yeri.
nümayîşkâr: f. Gösterişli.
nümruk (nümruka): (C.: Nemârık-Nemârıka) Yüz yastığı.
nümud ›šš: f. Gösteren, görünen, benzeyen.
nümudar: f. Görünen. * Nümune, örnek.
nümude: f. Görünmüş, gösterilmiş, gözükmüş.
nümun ›š›: f. Gösteren, benzer, müşabih olan. 
nümune ›š›œ: f. örnek, misâl, misal olarak gösterilen. Düstur ve misâl olacak şey.
nümune-î îmtîsal: örnek tutulacak şey.
nümunehane: f. Nümunelik şeylerin konulduğu yer. * Müze.
nümur: (Nimr. C.) Kaplanlar.
nümuzec ›š‡: Enmuzec. örnek, nümune, misal.
nümüvv ›š: Bereketlenip artmak. * (Canlılarda) büyümek, yetişmek, gelişmek.
nümüvv-ü tabîî: Normal şartlar altında büyüyüp gelişme.
nümy: Pul.
nüsafe: Buğdaydan ayrılan saman.
nüsah ›ž‰: Nüshalar, sahifeler, yazılı şeyler.
nüsal: Hayvandan dökülen tüyler.
nüsare: Saçılan şey. * Yemek döküntüsü.
nüsha ›ž‰œ: (C.: Nüsah) Yazılı şey. Yazılı bir şeyden çıkarılan suret. * Muska, duâlı kâğıt. * Gazete ve dergilerde (sayı).
nüsha-î kübra ›ž‰œý‚˜„œÿ: Büyük sahife. Kâinat, dünya, çok manayı ifade eden âlem.
nüsha-î suğra ›ž‰œý‚•œÿ: Küçük sahife, küçük nüsha. Küçük mâna ifade eden, küçük mahluk, âlemin küçük bir nüshası mânasında insan.
nüshateyn: îki nüsha.
nüsu': Diş etlerinin sıyrılarak dişlerin meydana çıkması.
nüsul: Tüy dökme.
nüsur ›†œ: (Nesr. C.) Nesirler, manzum olmayan yazılar. Dağıtmalar. * çok çocuk doğuran kadın.
nüsur: (Nesr. C.) Kartallar. Akbabalar (kuş).
nüsük ›ž˜: (Nüsk) Allah için ibadet etmek.
nüsüse: Kurumak.
nüşab: (Nüşabe. C.) Oklar. Temrenli oklar.
nüşabe: (C.: Nüşab) Ok. Temrenli ok.
nüşafe: Sütü sağdıklarında üzerine gelen köpük.
nüşare: Kesilen ağaçtan dökülen talaş, yonga.
nüşbe: Sırnaşık. Ciddi olmayan adam.
nüşhar: f. Geviş.
nüşk: Buruna birşey koymak. * Koklamak.
nüşka: Davarın boynuna takılan ip.
nüşre: Sihir, efsun.
nüşu': îlâç içirmek.
nüşub: Dühul etmek, girmek, dâhil olmak. * îlgilendirmek, alâkalandırmak, taalluk etmek.
nüşuh: Az miktar su.
nüşuk: Buruna çekilen ilâç, toz, enfiye vs. * Buruna çekme.
nüşur ›œ: Neşirler. * Yaymalar, dağıtmalar. * öldükten sonraki dirilmeler.(Nüşur, neşir gibi bâzan müteaddi, bâzan lâzım olur. Müteaddi olursa bir şeyi açıp yaymak mânasına gelir ki, lisanımızda neşr ve neşriyat ve menşur bu mânadandır. Bunun lâzımına intişar denilir, lâzım oldukları zaman ise ölmüş bir şeyin dirilip kalkması mânasınadır ki, Kur'anda nüşur, ekseriyetle bu mânayadır. (E.T.)
nüşus (neşs): Yüksek olmak, yücelmek. * Nefret etmek. 
nüşut: Tohumun baş vermesi, uç göstermesi.
nüşuta: Devenin ayağındaki ilmikli düğüm. (îcabına göre çekip uzatılarak çözülür.)
nüşuz ›: Yüksek olmak, yücelmek. * Kadının, erkeğinden kaçıp nefret etmesi.
nüşuze ›œ: Kadının, kocasından nefret edip kaçması. * Fık: Kocasına karşı üstünlük iddia eden kadın.
nütac: Doğurmak. * Gebe devenin karnındaki yükü.
nütu: Yumru, çıkıntı. * Yumruluk.
nütuc: Doğurucu hayvan. * Doğurması yakın olan.
nüub: Seri seyir.
nüume: Yumuşaklık.
nüut ›”…: (Bak: Nuut)
nüütî: (C.: Nevat) Gemi reisi, kaptan.
nüv': Açlık.
nüvah ›ƒˆ: ölü için sesle ağlama.
nüvaht: f. çalgı çalma.
nüvat ›ƒ…: (Nüve. C.) Nüveler, çekirdekler.
nüvatî: (C.: Nüvâta) Gemici, mellah.
nüvaz ›ƒ: f. "Okşayıcı, taltif edici, iyi edici" mânâsına kelimenin sonuna gelebilir.
nüvb: Bir siyahi kabile adı. * Bal arısı sürüsü.
nüvbe: Yetişmek. * Siyahi bir kabile.
nüve ›œ: çekirdek, asıl, menba. (Sayısız hatemlerden canlı mahlukata vaz' edilen hayat hâtemine bakınız. Evet canlı bir mahluk, câmiiyeti itibariyle kâinata küçük bir misaldir. şecere-i âleme güzel ve tatlı bir meyvedir. Kevn ve vücuda bir nüvedir ki; Cenab-ı Hak o nüvede pek çok âlemlerin örneklerini dercetmiştir. Sanki o zihayat, gayet hakimane muayyen nizamlar ile bütün vücutlardan sağılmış bir katre veya bir noktadır. Bu itibarla bir zihayatı halketmek, bütün kâinatı yed-i tasarrufuna alan Cenab-ı Hak'tan maada hiçbir şeye isnad edilemez. M.N.)
nüveyt: çekirdekçik.
nüvîd ›ÿš: f. Müjde, beşaret. Hayırlı haberlerle tebşir.
nüvîd-î vasl: (Nevid-i vasl) Kavuşma müjdesi.
nüvîs ›ÿž: f. Yazan, yazıcı.
nüvîsende: f. Yazıcı, kâtib.
nüvîşt: f. Yazılı, yazılmış. * Mektub.
nüvne: çene çukuru. 
nüvre: Alçı taşı. * Kireçten yapılan.
nüvvar: (C.: Nevâre) Ağaç çiçeği.
nüy'e: Ham ve çiğ olmak.
nüyub: (Nâb. C.) Azı dişleri.
nüz': Erkek ister kösnek davar.
nüza: Koyunda olan öldürücü bir hastalık.
nüzera: (Nezir. C.) Doğru yola getirmek için korkutmalar.
nüzfe: (C.: Nüzüf) Az miktar, cüz'i.
nüzhet ›œ : f. îç açıklığı, safa, eğlenme, gönül ferahlığı. * Temizlik, paklık. * Karışık, bulaşık ve kalabalık yerlerden uzak olmak. Buud.
nüzhet-efzâ: f. Eğlenceli ve gönül açacak yer.
nüzhet-fezâ: (Bak: Nüzhet-efza)
nüzhet-gâh ›œ…˜ƒœ: Seyir yeri, gezinti, eğlence yeri.
nüzhet-pezîr: f. Safa ve neşe bulmuş olan.
nüzl: (C.: Enzâl) Konak yeri. * Misafir için hazırlanan yemek.
nüzu': çekilmiş. * Su çeken deve.
nüzul ›™: îniş, inmek, aşağı inmek, konaklamak. * Nüzül, felç hastalığı. * Hacıların Mina'ya gelip konaklamaları.
nüzul-î sefîne: Geminin denize inişi.
nüzur ›‹œ: (Nezir.C.) Nezirler, adaklar. (Bak: Nezr)
nüzur ›‹œ: Korkutmak.
nüzü' (nez'): îfsad etmek, bozmak, aldatmak, yaramaz nesneye kandırmak.
nüzzar: (Nâzır. C.) Bakanlar. Nâzırlar.