ubab: Her nesnenin muazzamı, her şeyin büyüğü. * Cemaat, topluluk. * Taşkın sel suyu. * Pek taşkın, coşkun.
ubar: f. Ağlama, inilti.
ubeyd ”„ÿš: Küçük kul, kulcuk.
ubeyde bîn cerrah (r.a.): Aşere-i Mübeşşere'den olup, asıl ismi Amir bin Abdullah'tır. Her din muharebesinde bulunup çok büyük şecaat ve metanet göstermiştir. Adaleti ile de meşhurdu. şam'ın fethinde kendisi kumandandı. Hicri 18 senesinde 58 yaşında iken taundan vefat etmiştir.
ubr: çok. * Sedir ağacından su kenarlarında biten ağaç.
ubs: Huzursuzluktan yüz burkulmak. Yüz ekşime, surat asma.
ubsur: Seri. çok yürüyen deve.
ubud: (Ebed. C.) Ebedler, sonsuzluklar.
ubudet: Kulluk. (Aslında zillete derler.)
ubudîyyet: Bendelik, kulluk, kölelik. Kul olduğunu bilip Allah'a itaat etmek. Allah'a teslim olup, Kur'an ve Peygamber (A.S.M.) vasıtası ile verilen emirleri aynen icra ve tatbike çalışmak.(însanlar kendileri için değil, Allah'a ubudiyet için yaratılmışlardır.)(Ubudiyet, emr-i îlâhiye ve rıza-i îlâhiye bakar. Ubudiyetin dâisi, emr-i îlâhi ve neticesi rıza-i Hak'tır. Semeratı ve fevaidi, uhreviyedir. Fakat ille-i gaiye olmamak, hem kasden istenilmemek şartıyla, dünyaya ait faideler ve kendi kendine terettüb eden ve istenilmeyerek verilen semereler, ubudiyete münafi olmaz. Belki zaifler için müşevvik ve müreccih hükmüne geçerler. Eğer o dünyaya ait faideler ve menfaatler, o ubudiyete, o virde veya o zikre illet veya illetin bir cüz'ü olsa, o ubudiyeti kısmen ibtal eder. Belki o hasiyetli virdi akim bırakır, netice vermez. îşte bu sırrı anlamıyanlar, mesela yüz hasiyeti ve faidesi bulunan Evrad-ı Kudsiye-i şah-ı Nakşibendi'yi veya bin hasiyeti bulunan Cevşen-ül Kebir'i o faidelerin bazılarını maksud-u bizzat niyet ederek okuyorlar. O faideleri göremiyorlar ve göremiyecekler ve görmeye de hakları yoktur. çünki o faideler, o evradların illeti olamaz ve ondan onlar kasden ve bizzat istenilmeyecek. çünkü onlar fazli bir surette, o halis virde talebsiz terettüb eder. Onları niyet etse, ihlası bir derece bozulur. Belki ubudiyetten çıkar ve kıymetten düşer.Yalnız bu kadar var ki; böyle hasiyetli evradı okumak için, zaif insanlar bir müşevvik ve müreccihe muhtaçtırlar. O faideleri düşünüp, şevke gelip, evradı sırf rıza-yı îlahi için, âhiret için okusa zarar vermez. Hem de makbuldür. Bu hikmet anlaşılmadığından; çoklar, aktabdan ve selef-i salihinden mervi olan faideleri görmediklerinden şübheye düşer, hattâ inkar da eder. L.) (Bak: Rububiyet)
ubur ”„œ: Geçmek. Atlamak. * Zorlamak. * Suyun öte kıyısına geçmek.
ubus ”„ž: çatık yüzlü. Abus. * Utanmaz kimse.
ubuset: Yüz ekşiliği. çehre çatıklığı. Somurtkanlık.
u'büd ƒ”„š: îbadet et (meâlinde emir.)
ubye: Büyüklenmek, kibirlenmek.
ucab: (Uccâb) çok şaşılacak fazla gülünç olan şey.
ucacet: (C.: îcâc) Dişi deve sürüsü. * Toz. * Yüce avazlı, yüksek sesli.
ucale: Misafirlerin yolda yemek için götürdükleri azık. * çiftçilerin azık diye evvelce koyup getirdikleri buğday ve arpa.
ucam: çekirdek.
ucarîm: Kuvvetli adam.
ucave: Tırnağa bitişik olan sinir.
ucb ”‡„: (Ucub) Kibir, gurur. Kendini beğenmişlik. Ameline, yaptıkları işe güvenmek. * Varlığı nâdir olan şeyi görünce istiğrab etmek hâli. * Yabancı kadın taifesiyle beraber oturmak ve konuşmaktan pek hoşlanan.(Arkadaş! Ye'se düşen adam, azabdan kurtulmak için istinad edecek bir noktayı aramaya başlar. Bakar ki, bir miktar hasenât ve kemâlâtı var, hemen o kemâlâtına bel bağlar. Güvenerek der ki: "Bu kemalât beni kurtarır, yeter" diye bir derece rahat eder. Halbuki a'mâle güvenmek ucubdur. însanı dalâlete atar. çünkü insanın yaptığı kemalât ve iyiliklerde hakkı yoktur; mülkü değildir, onlara güvenemez. Hem insanın vücudu ve cesedi bile onun değildir. çünkü, kendisinin eser-i san'atı değildir. O vücudu yolda bulmuş, lekita olarak temellük de etmiş değildir. Kıymeti olmayan şeylerden olduğu için yere atılmış da insan almış değildir. Ancak, o vücut havi olduğu garip san'at, acip nakışların şehadetiyle, bir Sani-i Hâkim'in dest-i kudretinden çıkmış kıymettar bir hane olup, insan o hanede emâneten oturur. O vücudda yapılan binlerce tasarrufattan ancak bir tane insana aittir. M.N.)
ucb-üz zeneb: (Bak: Acb-üz-zeneb)
ucbe: Acaib ve şaşılacak şey.
uccab: (C.: Eâcib) şaşırıp taaccüp edecek nesne.
uccet: Kaygana aşı.
ucd: Atın kuvvetli olması.
ucfet: Kuru üzüm çekirdeği.
ucle: Acele ile ve çabuk yapılan iş.
ucm: Araptan gayrisi. Arap milletinden olmayanlar. * (Acmâ. C.) Dilinde tutukluk olanlar.
ucme: Dil tutukluğu. Tutuk tutuk kekeliyerek konuşma. * Acemlik.
ucre: (C.: Ucer) Ağaç boğumu. * Düğme. * Bedenin tomur kabaran yeri. * Ayıp.
ucruf: (C.: Acârif) Uzun ayaklı karınca.
u'cube ƒ”‡„œ: Taaccüb olunacak şey. Ucube. Pek acib ve garib olan. * Hayret edilecek derecede olan isti'dad.
u'cube-î hîlkat ƒ”‡„œý‚‰™—…: Yaratılıştan insanlara hayret verici olan. şaşılacak, hayrete düşülecek hilkat garibesi.
uçbeyî: Hudutlardaki sancakbeyleri hakkında kullanılan bir tâbir idi. Orta çağlarda Türk Devletinin uçbeyleri yarı müstakil idiler. Bağlı bulundukları devletler zayıfladıkça istiklâl dereceleri artar, neticede müstakil devlet olarak ortaya çıkanlar olurdu. Akkoyunlular, Karakoyunlular ve nihayet Osmanlılar bu şekilde müstakil bir devlet olarak meydana gelmişlerdir. (O.T.D.S.)
ud: Meşhur bir sazın adı. * Bir hoş kokulu buhur. * Ağaç parçası. * Budak.
udal ”‘ƒ™: Katı, şiddetli. * Pek zor. * Ağır hastalık.
udat: Düşman.
uddet ”š…: Gelecek zamanın hâdiseleri için, darlığa düşmemek için mal ve silâh gibi şeylerde hazırlık. Mühim levâzımat. * îstidad. * Gençlerin yüzlerinde çıkan sivilce.
udhîy ƒšˆÿ: Deve kuşu yumurtası.
udhîye ƒ‘ˆÿœ: Cenab-ı Hakk'ın rızası için kurban niyetiyle kesilen hayvan.
udhuke ƒ‘ˆ˜: Gülünç şeyler. Komedi.
udhukeperdâz: f. Güldürücü, komik.
udî: înce taştan kapak.
udîka: Demir çengel.
ud'îyye: (C.: Eda'i) Mesel, hikâyat. * Bilmece, yanıltmaç.
udlet: (C.: Uzul) Zahmet, meşakkat. * şiddet.
udlul ƒ‘™™: Doğru yoldan sapma. îslâmiyetten ayrılma, sapıtma.
udm: Ekmek katığı.
udme: Buğday renklilik. * Beyazı çok olan deve.
udmus: Karanlık.
udre(t): Yel inip hayası büyümek.
udrîc: Sarı kaftan. * Hızlı ve çok yürüyen at.
udtumme: Kişinin aslı.
udube: Keskinlik.
udul ”š™: Yoldan çıkma, dönme, sapma. * Vazgeçme. * (âdil. C.) âdiller, âdil olanlar.
udva': Kuru, sert yer. * üzerine oturulduğunda rahat olmayan yer. * Evin uzak olması.
udvan ”šƒ›: Düşmanlık, haksızlık, zulüm.
ufafe: Memede kalan süt artığı.
ufat: Haramdan nefsini koruyanlar.
ufave: çorbanın sonu.
ufaze: Pamuk kozası. * Yüksek yer.
uffare: Her nesnenin evveli. * Katılık. * şiddet.
uffe: Bir deniz hayvanı. * Davarın emziğinde kalan süt bakiyesi.
ufk ƒ–—: Kıyı, kenar. * Rüzgârın estiği cihetler. * Ufuk. Gökle yerin birleşmiş gibi göründüğü yer. Görüşümüzün nihayetindeki yerler. * Mc: Görüş ve düşünüş derecesi.
ufka: înce deri. * Sünnet edilen deri.
ufkî ƒ–—ÿ: Ufka ait. Ufka dair ve müteallik. * Yatık düzlük. Yatay.
ufre: Başın ortasında olan saç.
ufuc: (C.: Afâc) Vurmak. * Göden bağırsağı denilen bağırsak.
uful ƒ–™: Gurub, batış. Gözden kayboluş. Görünmez olmak. * Mc: ölmek.
ufunet ”–› : çıban veya yaranın çürüyüp fena kokması. * îltihab. * Her hangi bir maddenin çürümesinden hasıl olan pis koku, çürük kokusu. * Sıkıntı veren manevi ağırlık.
ufure: üzerinde her ne varsa yenilip hiç bir şey kalmayan yer.
ufusa: Kekrelik.
ugeylîme ƒ•ÿ™šœ: Küçük oğlan çocukları.
ugluta: (C.: Uglulât - Egalit) Bilmece, bulmaca, yanıltmaca.
ugnîye ƒ•›ÿœ: şarkılar, ilâhiler. Teganni edilen sözler.
ugnîyye: (C.: Egâni) Ahenk.
ugtube: Azar, tekdir.
ugvîyye: Belâ. Zahmet. Musibet.
uhah: Susuzluk. * Galiz, kaba, yoğun.
uhbuşe: Türlü kabilelerden meydana gelen topluluk.
uhcîyye: Bilmece, bulmaca, yanıltmaca.
uhcüvve: Bulmaca, yanıltmaca, bilmece.
uhde ”œšœ: Bir işi üzerine alma. Söz verme. * Ahidnâme. Bir kimsenin üstünde olan iş veya şey. * Mes'uliyet hududu. * Ric'at ve taalluk dâiresi. * Becerme, yapma. * Mes'uliyet, sorumluluk.
uhdud ƒ‰šš: (C.: Ahâdid) çukur. * Uzun hat. * Yeryüzündeki uzun yarık ve çatlak. * Hendek. * Kamçı vurulmasından vücutta hâsıl olan yara ve iz.
uhduse: Hayret edilecek derecede uydurma haber. * Haber verilen nesne.
uhfuk: (C.: Ehâfik) Yer yarığı.
uhkuk: Yarık, hendek.
uhne: (C.: ühan) Kin tutmak.
uhra ƒ‰œÿ: Sâir, diğer, başka. Ahir, gayr, son, sonra.
uhre: Bir şeyin sonu.
uhrevî ƒ‰œÿ: âhirete dair, âhiretle alâkalı. öteki dünyaya ait.
uhrun: f. Doğurmayan, kısır kadın veya hayvan.
uht: (C.: Ahavât) Kızkardeş.
uhteyn: îki kızkardeş.
uhud ”œš: (Ahd. C.) Ahidler, yeminler, peymanlar, anlaşmalar, sözleşmeler.
uhud muharebesî: Uhud, Medine-i Münevvere'nin bir mil kuzeyinde kırmızı bir dağ olup, Hz. Peygamberimizin (A.S.M.) ashâbıyla Kureyşliler arasında vuku bulmuş olan Uhud Gazasıyla meşhurdur.Uhud gazası, hicretten 2 sene 6 ay 7 gün sonra olmuştur. Bunun zahiri sebebi: Daha evvel yapılmış olan Bedir Gazasında Kureyşliler mağlub olduklarından, Kureyşlilerden Bedir Gazasında akrabaları öldürülmüş olan bazı kişiler Ebu Süfyan'a giderek harp teklifinde bulunmuşlardı. Ebu Süfyan, kendi kumandası altında Kureyş müşriklerinden ve Kenane ve Tehâme'den üçbin ikiyüz kişi kadar alarak karısı Hind ve diğer bazı kadınlarla birlikte Medine'ye doğru hareket edip Uhud Dağı'na gelmişlerdi. Hz. Resulullah (A.S.M.) Efendimiz, bunların önüne çıkmak fikrinde bulunmayıp, şehre girdiklerinde müdafaa yapmayı teklif etmişse de, bazı ashabın ısrarı üzerine muharebeye çıkmağa karar vermişlerdi. Hz. Peygamber (A.S.M.) sahabeden 700 kişiyle küffâra karşı çıktı. Muharebede müslümanlar bazan galip, bazan mağlub olarak Peygamberimizin amcası. Hz. Hamza ile birlikte 70 sahabe şehid olmuştu. Hatta Peygamberimizin de dişi kırılmış, yüzü ve dudağı yaralanmıştı.(Mühim bir sual: Fahr-ül-âlemin ve Habib-i Rabb-ül-âlemin Hazret-i Resul-ü Ekrem Aleyhissalâtü Vesselâm'ın Sahabelerinin, müşrikine karşı Uhud'un nihayetinde ve Huneyn'in bidayetinde mağlubiyetinin hikmeti nedir?Elcevab: Müşrikler içinde o zamanda saff-ı Sahabede bulunan ekâbir-i Sahabeye istikbalde mukabil gelecek Hazret-i Halid gibi çok zatlar bulunduğundan, şanlı ve şerefli olan istikballeri nokta-i nazarında bütün bütün izzetlerini kırmamak için, hikmet-i îlahiyye, hasenat-ı istikbaliyelerinin bir mükâfat-ı muaccelesi olarak mazide onlara vermiş, bütün bütün izzetlerini kırmamış. Demek mazideki Sahabeler, müstakbeldeki Sahabelere karşı mağlup olmuşlar. Tâ o müstakbel Sahabeler, berk-i süyuf korkusuyla değil, belki bârika-i hakikat şevkiyle îslâmiyete girsin ve o şehâmet-i fıtriyeleri çok zillet çekmesin. L.) (Bak: Huneyn)
uhud-î atîka: Eski anlaşmalar.
uhud-u mer'îye: Yürürlükteki anlaşmalar.
uhuvvet ƒ‰ : Kardeşlik. Din kardeşliği. Samimi dostluk.
uhuvvet-î efkâr: Fikir kardeşliği.
uhuvvetkâr: f. Kardeş gibi davranan. Kardeş gibi muâmelede bulunan.
uhuvvetkârane ƒ‰…˜ƒœƒ›œ: f. Kardeşçesine, kardeş gibi olarak. Birlik, beraberlik ve karşılıklı sevgi ile.(Uhuvvetin sırrı: şahsiyetini kardeşler içinde fâni edip, onların nefislerini kendi nefsine tercih etmek. L.)(Her ikinizin, Hâlikınız bir, Mâlikiniz bir, Mâbudunuz bir, Râzıkınız bir... Bir bir, bine kadar bir bir. Hem Peygamberiniz bir, Dininiz bir, Kıbleniz bir.. Bir bir yüze kadar bir bir. Sonra köyünüz bir, devletiniz bir, memleketiniz bir... Ona kadar bir bir. Bu kadar bir birler vahdet ve tevhidi, vifak ve ittifakı, muhabbet ve uhuvveti iktiza ettiği; ve kâinatı ve küreleri birbirine bağlıyacak mânevi zincirler bulundukları hâlde; şikak ve nifaka, kin ve adâvete sebebiyet veren örümcek ağı gibi ehemmiyetsiz ve sebatsız şeyleri tercih edip mü'mine karşı hakiki adâvet etmek ve kin bağlamak; ne kadar o rabıta-i vahdete bir hürmetsizlik ve o esbab-ı muhabbete karşı bir istihfaf ve o münâsebât-ı uhuvvete karşı ne derece bir zulüm ve i'tisaf olduğunu; kalbin ölmemiş ise aklın sönmemiş ise anlarsın! M.)
uhuz: Göz ağrısı.
uhz: Sihir, efsun.
ukab: Duman, toz.
ukab: (C.: Ukbân-Ekub) Tavşancıl kuşu.
ukabeyn: îşkence veya asmak için dikilen iki tane dar ağacı. * Kovayı muhafaza etmek için kuyu içinde olan yumru taş. * Kuyu duvarı arasına koyulan saksı parçası. * Havuz içinde akan suyun yolu. * Büyük ilim.
ukad ”—š: (Ukde. C.) Düğümler, bezler, şişlikler. Boyun, koltuk altı ve kasıkta bulunan guddeler.
ukad-i hayatîye: Can alıcı noktalar, hayat düğümleri. Bir şeyi meydana getiren asli rükünler.
ukala ”—™ƒ£: (âkıl. C.) Akıllılar. * Halk dilinde: Akıllılık iddia edenler.
ukam: çok sert. Pek şiddetli.
ukama': (Akim. C.) Kısırlar. Zürriyeti olmayanlar.
ukamîs: çok.
ukar: şarap. * Lüks mobilya.
ukas: Bir cins ot. * "Kesmek" mânâsına mastardır.
ukaykan: Karınca.
ukaz: Mekke-i Mükerreme yakınındaki bir pazar adı.
ukba ”—„ÿ: âhiret, öbür dünya, bâki olan âlem. * Ceza.
ukba-î ferda ”—„ƒ£‚–œšƒ: f. Gelecek olan âhiret. Yarınki devir.
ukbe: Nöbet. * çorba bakiyyesi.
ukbe bîn amîr bîn kays el-cühenî (r.a.): Ashab-ı Kiramın mümtaz fakihlerinden ve Kur'an-ı Kerim'i ezberleyip yazanlardandır. 55 Hadis-i şerif rivayet etmiştir. Mısır Valiliğinde bulunmuş ve orada Hicri 58 tarihinde vefat etmiştir.
ukd: Düğüm. * Yoğun. * Gazap, hiddet. * Sâkin olmak.
ukde ”—šœ: Düğüm, bağ. * Karışık ve müşkil iş. Zorluk, zor iş. Vâlilik ve halifelik için akdolunan biat. * Ağaçlık yer. * Pelteklik, kekemelik. * Arzu edip de ulaşamadığından dolayı içe dert olan şey.
ukde-î hayat ”—šœý‚ˆÿƒ…: f. Hayat düğümü. (çekirdek gibi)
ukde-î lîsan ”—šœý‚™žƒ›: f. Kekelemek.
ukdegîr: f. Müşkil, zor. * şüpheli. * Düğümlü.
ukdegüşa: f. Müşkilleri yenen.
ukdevî: Düğüm biçiminde olan. Ukde ile alâkalı.
ukhuvan: Papatya.
ukiyye: (Bak: Okiyye)
ukkaşe bîn el-mîhsan el-esdî (r.a.) ”˜ƒœ‚„›‚ƒ™šˆ›‚ƒ™¤žšÿ: Efâdıl-ı Sahabeden ve kahramanlardan olup hususan Bedir muharebesinde ve Hazret-i Ebu Bekir (R.A.) devrinde mürtedlerle olan muharebede yararlıklar göstermiştir. Peygamberimizin vefat tarihinde 44 yaşlarında idi.
ukkaze: (C.: Akâkiz) Ucu demirli sopa.
ukke ”˜œ: Tulum, deriden yapılan kap.
ukle: Bağlamak. * Hile edip aldatmak.
uklum: Kuvvetli deve.
ukm: Kısırlık. * Verimsizlik.
ukne: Taş oda veya kulübe, kümes.
ukne: (C.: Uknâ-Akân-Uknât) Karın büklümü. (şişmanlık ve semizlikten olur.)
uknum: (C.: Ekanim) Asıl.
ukr: Kısırlık. * Kısır olan kadının veya dişi hayvanın hali. * Mc: Netice alamama.
ukre: Kısır. Doğurmayan kadın veya hayvan.
ukruban: Akrebin erkeği.
uksume: (C.: Ekasim) Nasib, kısmet. Hisse, pay.
uktua: Alâkayı kesmek gayesiyle gönderilen şey. îlgiyi kesmek üzere verilen şey.
ukub: Her nesnenin sonu.
ukub: Toz. * çömlek kaynaması. * Kalabalık.
ukubat ”—„ƒ…: (Ukubet. C.) Cezalar. îşkenceler, eziyetler. * Kısas ve şahsi cezalar.
ukubet: (C.: Ukubât) îşkence, azab, eziyet. * Ceza.
ukud ”—š: (Akid. C.) Akidler. şartlar, bağlar. îki tarafça kabul edilen şeyler.
ukud suresî: Kur'an-ı Kerim'in beşinci suresi olan Mâide Suresinin diğer bir ismi.
ukuk ”——: Anaya babaya itaatsizlik ve hürmetsizlik etmek. Zorbalık, tanımamak, âsi olmak.
ukul ”—™: (Akıl. C.) Akıllar.
ukul-u aşere: (Bak: Akl-ı evvel)
ukunne: (C.: Ukun) Taştan yapılmış nesne.
ukus: (Aks. C.) Akisler, yankılar, çarpmalar.
ukusa: Berklik, muhkemlik, sağlamlık, sertlik.
ukve: Kuyruk dibi.
ula ƒ™ÿ: Birinci, ilk, evvel. * Eskiden vezirlikten sonra gelen sivil rütbe.
ula: şanlı, şerefli kimse.
ulale: Süt bakiyyesi. * Her nesnenin bakiyyesi, artığı.
ulase: Yağ. Birbirine karışmış olan iki şey.
ulat: Demir örs. * üstünde keş kurutulan taş.
ulbarî: Bir ot cinsi.
ulbe: (C.: Uleb-îlâb) Fıçı. * Büyük kutu. * Sandık.
ulcum: (C: Alâcim) Erkek kurbağa. * Dağ keçisinin erkeği. * Deve kuşu. * Sağlam ve dayanıklı deve. * çok su. * Gece karanlığı.
uleb: (Ulbe. C.) Fıçılar. * Büyük kutular. * Sandıklar.
ulebît: Yoğun ve büyük nesne. * Koyun sürüsü.
ulema ”™šƒ£: (âlim. C.) âlimler. Osmanlı devrinde yüksek ilim ve fıkıh âlimleri. îlmiye mensubları.
ulema-î âmîlîn: îlmine ve bilgisine göre amel eden, ilmini tatbik eden âlimler.
ulema-î bâtin ”™šƒ£‚„ƒ’›: şeriatın, zâhir ve hükümlerinden daha çok, mânâ ve esrarını bilen âlimler.(Ulema-i zâhir ve bâtının Tâbiin zamanında en büyük reisi ve îmam-ı Ali'nin mühim ve sadık bir şakirdi olan Hasan-ı Basri... M.)
ulema-î îlm-î huruf ”™šƒ£‚”™š‚ˆœ–: Kur'anın bir harfinden, bir sahife kadar esrar bulduklarını söyleyen ve dâvalarını, o fennin ehline isbat edenler.
ulema-î râsîhîn ”™šƒ£‚œƒž‰ÿ›: Hak ve hakikat ilminde meleke kazanmış âlimler.
ulema-î rüsum ”™šƒ£‚œžš: Resmi, merasim âlimleri. Kendileri resmen âlim bilinen fakat hakiki âlim olmayan kimseler. (Zâhiri ulema da denir.)
ulema-î zâhîr ”™šƒ£‚“ƒœœ: Kur'an-ı Kerimin zâhir mânâsına göre hakikatları değerlendiren âlimler. şeriatın mâna ve esrarından daha çok, zâhirini ve hükümlerini bilen âlimler.
ulema-üs sû' ”™šƒ£‚ƒ™ž¢: Kötü âlimler. Dünya için âhiretini unutan âlimler. Dünyayı dine tercih eden âlimler. Menfaat için hakikatı örten âlimler.
ulguze: Bilmece, bulmaca, yanıltmaca.
ulî ƒ™ÿ: Sâhib. Ehil.
ulk: şarap.
ulka: Kahvaltı. * Az nesne. * Küçük çocuklara yapılan elbise.
ulkum: (C.: Alâkım) çok karanlık gece. * Pek sağlam deve.
ullame: Kına.
ullef: Muz.
ullîyye ”™ÿœ: (îlliyye) Yüksek tabaka. En yüksek. En şerefli. * çardak.
ulta: Gerdanlık. * Kadınların süs olarak yüzlerine çektikleri siyah çizgi.
uluf ƒ™–: (Elf. C.) Binler, bin sayıları. * ülfet ve ünsiyete ziyade meyyal ve alışkan olan.
ulufe ”™–œ: Yeniçerilere ve sipahilere dağıtılan maaş. * Bir nevi hayvan yemi.
ulufe-hâr: (C.: Ulufehârân) Ulufesi olan, ulufeci.
uluhîyet ƒ™œÿ…: îlâhlık. * Allah'ın kâinattaki tasarruf ve hâkimiyeti ile herşeyi kendisine ibadet ve itaat ettirmesi.
uluhîyet-î mutlaka ƒ™œÿ…‚š’™—œ: Kayıt altında olmayan, mutlak uluhiyet. Ancak bir tek îlâhın mâbud oluşu.(Evet, nev'-i beşerin her taifesi birer nevi ibadetle fıtri gibi meşgul olması ve sair zihayatın belki cemâdâtın dahi fıtri hizmetleri birer nevi ibadet hükmünde bulunması ve kâinatta maddi ve manevi bütün nimetlerin ve ihsanların herbiri bir Ma'budiyet tarafından hamd ve ibadeti yaptıran perestişe ve şükre birer vesile olmaları ve vahiy ve ilhamlar gibi bütün tereşşuhât-ı gaybiye ve tezahürat-ı maneviyenin, bir tek îlâhın ma'budiyetini ilân etmeleri; elbette ve bedahetle bir uluhiyyet-i mutlakanın tahakkukunu ve hüküm-ferma olduğunu isbat ederler. ş.)
uluhîyet-î sârîye ve hayat-i sârîye: Vahdet-ül vücud ehlince kullanılan tasavvufi tabirler olup; îlâhi sıfatların ve hayatiyetin eşyaya sirayet etmesi, yani tecelli etmesi mânasında olan bu tabirlerden, ehil olmayanlar; Allah'ın tecessümünü veya eşyaya hulûl'ünü veya eşya ile ittihad ve ittisal'ini zu'metmek gibi bâtıl vehimlere düştüler.Bu mes'eleye dair Mesnevi-i Nuriye'den nakledeceğimiz veciz bir paragraftan bu tabirler daha iyi anlaşılabilir:"Evet, delil içinde neticeyi görmek, âlemde sânii müşahede etmek, tarik-ı istigrakkârane cihetiyle cedavil-i ekvanda cereyan-ı tecelliyat-ı îlâhiyeyi; ve melekutiyet-i eşyada sereyan-ı füyuzatı; ve meraya-yı mevcudatta tecelli-i esma ve sıfâtı yalnız zevken anlaşılır birer hakikat iken dik-i elfaz sebebiyle, uluhiyet-i sariye ve hayat-ı sariye tabir ettiler.Ehl-i fikir, o hakaik-ı zevkiyeyi nazarın mekayisine sıkıştırdığından, çok evham-ı bâtılaya menşe' oldu."
ul'ul: Göğüs altında ve karın üzerinde dile benzer bir kemik. * çekik kuşunun erkeği.
ul'ul: Yaramazlık. * çağırmak. * Budak.
ulum ”™š: (îlm. C.) îlimler, bilgiler.
ulum-u âlîye ”™š‚¥™ÿœ: (âlet. den) âlet ilimleri. (Gramer, sarf, nahiv, belâgat ve mantık gibi.)(Ulum-u medarisin tedennisine ve mecrayı tabiiden çevrilmesine bir sebeb-i mühim budur: Ulum-u âliye $ maksud-u bizzat sırasına geçtiğinden, ulum-u âliye $ mühmel kaldığı gibi, libas-ı mânâ hükmünde olan ibare-i Arabiyenin halli, ezhanı zaptederek, asıl maksud olan ilim ise tebei kalmakla beraber ibareleri bir derece mebzul olan ve silsile-i tahsile resmen geçen kitaplar; evkat, efkârı kendine hasredip harice çıkmasına meydan vermemeleridir. R.N.)
ulum-u âlîye: Dinden bahseden ilimler. (Tefsir, kıraat, hadis, marifetullah, fıkıh, kelâm, ahlâk bilgileri gibi.)
ulum-u bedîhîyyât ”™š‚„šÿœÿƒ…: Delil ve isbatına lüzum görülmeyip kolaylıkla bilinen ilimler. (Bak: Kaziye-i bedihiyye)
ulum-u bedîîye ”™šš‚„šÿ”ÿœ: (Bak: îlm-i bedi')
ulum-u hafîye ”™š‚‰–ÿœ: Gizli ilimler. Ancak veraset-i Nübüvvet muhakkiklerince veya bir kısım hakikatların esrarına vakıf âlimlerce bilinen ilimler.(îlm-i Cifrin mühim bir düsturu ve ulum-u hafiyyenin mühim bir anahtarı ve bir kısım esrar-ı gaybiyye-i Kur'aniyyenin mühim bir miftahı tevafuktur. M.)
ulum-u kevnîye ”™š‚˜›ÿœ: Kâinatın ilmi. Yaratılışa dair olan ilimler.
ulum-u müteârefe ”™š‚š…”ƒœ–œ: Herkesin bildiği ve tanınmış olan ilimler.
ulum-u naklîye ”™š‚›—™ÿœ: Hadis, tefsir, fıkıh gibi ve mukaddes kitaplardan nakil olunan ve rivâyet üzerine kurulmuş olan ilimler.
ulum-u nazarîye: Yalnız görüş halinde kalmış, tatbikata konulmamış ilimler, teoriler.
ulum-u sîyasîye: Siyasi ilimler.
ulum-u şettâ ”™š‚…ÿ: Dağınık bilgiler, çeşit çeşit ilimler.
u'lume: (C.: Eâlim) Alâmet, işaret, nişan.
ulü ƒ™: Sahipler. Bir şeyin ehli olanlar.
ulü-l azm ƒ™‚ƒ™”š: Kat'i azim sahibi, ciddiyet, sabır, sebat sahibi büyük zâtlar, hususan peygamberler (Aleyhimüsselâm). Başta Hz. Muhammed (A.S.M.), îsa, Musa, îbrahim, Nuh (A.S.).(Kur'an-ı Hakim ehl-i şuura imamdır. Cin ve inse mürşiddir. Ehl-i kemale rehberdir. Ehl-i hakikata muallimdir. öyle ise, beşerin muhaveratı ve üslubu tarzında olmak zaruri ve kat'idir. çünkü, cin ve ins münacâtını ondan alıyor. Duâsını ondan öğreniyor. Mesailini onun lisaniyle zikrediyor. Edeb-i muaşeretini ondan taallüm ediyor ve hakeza. Herkes onu merci' yapıyor. öyle ise eğer Hz. Musa'nın (A.S.) Tur-i Sina'da işittiği kelâmullah tarzında olsa idi; beşer bunu dinlemekte ve işitmekte tahammül edemezdi ve merci' edemezdi. Hz. Musa (A.S.) gibi bir ulü-l azm ancak birkaç kelâmı işitmeğe tahammül etmiştir. S.)
ulü-l ebsar ƒ™‚ƒ™¤„ƒœ: Basiret sâhibleri.
ulü-l elbab ƒ™‚ƒ™¤™„ƒ„: Akıl sâhibleri. Düşünebilenler. Akl-ı selim sahibleri.
ulü-l emr ƒ™‚ƒ™¤šœ: Müslümanları şeriat nâmına idare eden (Halife, kadı, îslâm reisi, pâdişah, sultan, reis-i cumhur, reis, müdür gibi) zâtlar.
ulü-n nüha ƒ™‚ƒ™›œƒ£: Akıllı kimseler.
ulüf: (Ulûfe. C.) Yemler, ulufeler. * Yeniçeri maaşları.
ulüvv ”™: Büyüklük, yükseklik. * Bir şeyin yukarısına çıkma. * şan, şeref ve kadr sahibi olma.
ulüvv-ü cenablik ”™‚‡›ƒ„™—: âli cenablık. * Kerem ve cömertlik sâhibi ve faziletli olmak. Büyüklük.
ulüvv-ü hîmmet ”™‚œš…: Yüksek himmetlilik, gayret ve himmeti çok olmak. (Bak: Himmet)
ulüvv-ü şan ”™ƒ›: şânı şerefi büyük. Yüksek şeref.
ulvan: Mektup ve yazı başlığı. * övünme, tefahur.
ulvî ”™ÿ: (Ulviye) Yüksek, yüce. * Manevi ve göğe mensub.
ulvîyet: Ulvilik, yücelik, yükseklik, ululuk.
ulya ”™ÿƒ: (Müe.) Pek büyük, pek yüce, daha yüksek. çok yüksek olan.
umale: Bir işçinin, işi karşılığında aldığı ücret.
umde ”ššœ: înanılacak şey. * Prensip, temel fikir. * Dostluk. Güvenilecek yer veya kimse. * Kavim veya kabilenin muteber ve mu'temedi olan. Reis. Serasker.
umk ”š—: Derinlik. Dibi derin. * Kuyu veya denizin derinliği.
umkan: Derinliğine.
ummal: (âmil. C.) îdare âmirleri. Valiler. Tahsildarlar.
umman ”šƒ›: Büyük deniz. Okyanus. * Hindistan ile Arabistan arasındaki büyük deniz.
umra: Bir kimsenin mülkünü bir kimseye "ömrüm oldukça veya senin ömrün oldukça sana i'tâ ettim, ölsen yine benim olsun" demesi.
umran ”šœƒ›: îmar ile şenlendirilmiş olan. Bayındırlaşmak. Medenilik. Saâdet. Mutluluk.
umre ”šœœ: Ziyâret. Hac mevsimi dışında Kâbe'yi ve Mekke ve Medine'deki mukaddes yerleri ziyaret etmek. Ist: Kâbe-i Muazzama'yı tavaftan ve Safâ ile Merve denilen iki mukaddes mevki arasında sa'yetmekten ibarettir. Farz olan hacca Hacc-ı Ekber denildiği gibi, Umreye de Hacc-ı Asgar denilir. Cuma gününe tevafuk eden hacca da Hacc-ı Ekber denilir.
umre-î nebevî ”šœœý‚›„ÿ: Hz. Muhammed (A.S.M.) Efendimizin, hac farz olmadan evvelki haccı.
umud ”šš: (Amud. C.) Direkler. Sütunlar. * Mc: Seyyidler. Askeri elçiler.
umuhet: Yapılacak işte tereddüt gösterme, tutulacak yolda duraklama.
umum ”šš: Umumi olmak. Hep, bütün, cümle, herkes.
um'ume: însan topluluğu.
umumen: Bütün, hep.
umumet: Amcalık. Amca akrabalığı.
umumî ”ššÿ: Herkesle alâkalı, herkese dâir.
umumîyet ”ššÿ…: Bir şeyin herkese âit olması. Umumilik.
umumîyetle: Umumi olarak. Genel olarak.
umur ƒšœ: (Emir. C.) Emirler. îşler. Hususlar. Maddeler.(Mühim ve büyük bir umur-u hayriyenin çok muzır mânileri olur. şeytanlar o hizmetin hâdimleriyle çok uğraşır. Bu mânilere ve bu şeytanlara karşı, ihlâs kuvvetine dayanmak gerektir. L.)
umur-u askerîye ƒšœ‚”ž˜œÿœ: Askerlik işleri.
umur-u dünyevîyye: Dünya işleri. Dünyaya ait işler.
umur-u gaybîye ƒšœ‚•ÿ„ÿœ: Gaybi olan ve hissiyâtımızla bilinmeyen işler. Geçmiş zamana yahut geleceğe dâir olan ve hazırda mevcut olmayan işler.
umur-u hasîse: çirkin ve kötü işler.
umur-u îzâfîye ƒšœ‚ƒ‘ƒ–ÿœ: Birbirisiz olmayan ve birbirine nisbet ve mukayese ile anlaşılan vasıflar. (Meselâ: Karanlık olmasa, aydınlığın bilinmemesi gibi)
umur-u mütenasîbe: Aralarında uygunluk ve münasebet bulunan şeyler.
umur-u mütezadde: Aralarında uygunluk olmayan birbirine zıt şeyler.
umuraşna: (Umur-âşnâ) f. îşten anlar, işbilir.
umurat: (Umre. C.) Umreler. Hac mevsiminin haricinde Kâbe'yi ve Mekke-i Mükerreme'nin mübarek yerlerini ziyaret etmeler.
umurdîde: (C.: Umurdidegân) f. îş görmüş, işten anlar ve tecrübeli kimse.
umya ”šÿƒ: (Bak: Amya)
umyan ”šÿƒ›: (A'mâ. C.) A'mâlar, körler.
umye ”šÿœ: Azgın ve sapkın olmak. * Husumet ve inat etmek.
unab: Büyük burun. * Akıl. * Karın.
unat: (Ani. C.) Esirler. * Adi, bayağı ve aşağılık kimseler.
unayîl: (C.: Anâyil) Berk, metin, sağlam, dayanıklı, muhkem.
uncud: çekirdeği çıkmış üzüm.
unf ”›–: Kabalık. Sertlik. Cebir ve zor.
unfen ”›–øƒ: şiddetle, sertlikle. Zor kullanarak.
unfî: (Unfiyye) Sert, şiddetli, kaba.
unfus: Edepsiz ve hayâsız kadın.
unfuvan: Gençlik ve güzelliğin başlangıcı, en parlak zamanı. * Parlaklık, tazelik.
unfuvan-i şebab: Gençlik çağı, tazelik.
unk ”›—: Boyun, gerdanlık, gerdan.
unkud ”›—š: Salkım.
unsul: Ada soğanı.
unsur ”›œ: Kimyevi maddeden her biri. Mürekkeb cisimlerde bulunan basit maddelerin her birisi. * Umumdan ayrılan kısım. * Tam olan şeyin her bir parçaları. * Madde, esas, kök. Element.
unsurîyet ”›œÿ…: Irkçılık. Bir kavmi veya kendi soyunu daha şerefli sayarak diğer insanları hakir görmek. Menfi milliyetçilik.(Cây-ı dikkat bir hal: Türk milleti anâsır-ı îslâmiye içinde en kesretli olduğu halde, dünyanın her tarafında olan Türkler ise müslümandır. Sair unsurlar gibi müslim ve gayr-ı müslim olarak iki kısma inkısam etmemiştir. Nerede Türk taifesi varsa müslümandır. Müslümanlıktan çıkan ve müslüman olmayan Türkler Türklükten dahi çıkmışlardır -Macarlar gibi-. Halbuki küçük unsurlarda dahi, hem müslim ve hem de gayr-i müslim var. M.)
unsut: Kıldan bükülme ip.
unuşe: Refah, huzur, rahatlık. * Adâlet. Merhamet. * şarap. * Beğenme.
unv: Alçaklık. * Alçak gönüllülük, tevâzu etmek.
unve: Zor, kuvvet gösterme.
unveten: Cebren, zorla, kuvvet göstererek.
unzub: (C.: Anâzıb) Erkek çekirge.
unzuba': çekirge olan yer.
unzur ƒ›“œ: Bak, gör (Meâlinde emir).
unzuvan: Herze ve hezeyan söyleyen kimse. * Bir ot.
unzuvane: Dişi çekirge.
ur: önünde hendek olan istihkâm. Yüksek ve müstahkem yer, toprak tabya. Burç.
ur ”œ: Tek gözlüler. * Silâhsız, mühimmatsız olanlar.
ura: çıplaklık.
ura': îlmek yapmak.
ura'ir: (C.: Arâır) Semiz etli deve. * şerefli adam. * Kavmin reisi.
uram: Eti soyulmuş kemik. * çokluk. * Kötü ahlâk. * şiddetli muhâlefet. * çocuğun edepsizlik yapması.
urame: Hiddet. * şiddetli muhalefet. * Kötü ahlâk. * Edepsizlik etmek.
urat ”œƒ : (Uryan. C.) Elbisesi olmayanlar. çıplaklar, uryanlar.
uraza: Misafire çıkarılan yiyecek. * Hediye, armağan.
urb: şiddetli akıcı çay. * Ferah, sevinç, neşat.
urba ƒœ„œ: (Aslı dır.) îtl. Esvab, elbise. * Arabçada: Ukde, köstek, büklüm, düğüm. * Zekâvet. * Mekir, hile.
urban ”œ„ƒ›: çöl arabaları. * Aşiretler.
urbun: Müşterinin bâyie verdiği pey.
urca: Bir nesnenin üzerine durmak veya üstüne çıkmak.
urcan: (A'rec. C.) Topallar.
urcun ”œ‡›: Kurumuş hurma dalı. Ay gibi eğilen dal. Hurma salkımının dalı.
urefa ”œ–¥£: (ârif. C.) îrfan sâhibi kimseler. (Bak: îrfan)
urf ”œ–: (C.: A'râf) At yelesi. * Horuz ibiği. * âdet. * Cennet ile Cehennem arasında bir makam. * îhsan.
urgan ƒœ•ƒ›: t. îp. Halat.
urgun ƒœ•›: t. Vurgun, âşık.
urrak: Kabuğu soyulmuş ağaç. * Eti gitmiş kemik.
urret: Uyuz hastalığı.
urret: (C.: Urr) Devenin dudaklarında ve ayaklarında çıkan bir çıban. * Ulaşmak, varmak. * Kuş tersi.
urs: (Urus) Düğün yemeği.
urş: Boğazın iki tarafında olan iki uzun etin birisi.
urub ”œ„: (Arub. C.) (Bak: Arube)
uruc ”œ‡: Yukarı çıkmak. Yükselmek.
uruc-u îsa ”œ‡‚”ÿžÿ: Hz. îsa'nın (A.S.) göğe çıkması.
uruk ”œ—: (Irk. C.) Irklar. * Kökler, damarlar.
uruk: Kadının hayız görmesi.
uruk-u beşer: însan ırkları.
uruk-u însanîyetkârane ”œ—‚ƒ›žƒ›ÿ…˜ƒœƒ›œ: f. însanlığa yakışır damar, kök veya huylar.
urum: (Urume) Alâmet, nişane. * Kök, dip. * Başın tepesi.
urusat: (Urs ve Urus. C.) Düğün yemekleri.
uruş: (Arş. C.) Gökler, arşlar. Tavanlar.
uruz ”œ‘: (A'raz. C.) Fık: Nakit para, hayvan ve yenecek şeylerden olmayıp, kitap, manifatura eşyası, kumaş gibi mallar.
uruz: Zâhir olmak, görünmek. * Gelme, ârız olma. * (Arz. C.) Bildirmeler, keyfiyetler.
urva: Sıtma. Sıtmaya tutulma.
urve ”œœ: (C.: Urâ) Düğme iliği. * Yazda ve kışta yaprağı dökülmeyen ağaç. * Daima bâki olan nesne. * Arslan. Kudretten kinaye olur. * Kulp. Yapışacak sap. Tutacak yer.
urvet-ül vüska ”œ ‚ƒ™†—ÿ: Sağlam kulp. Metin ve muhkem olan tutulacak şey. * îslâmiyet. * Kur'an-ı Kerim.
uryan ”œÿƒ›: çıplak.
uryanî: çıplaklık. * Bir cins erik.
urye ”œÿœ: Ari olmak. çıplak olmak.
urz ”œ‘: Mania, engel. Açıktan hedef gibi bir şeye mâruz olup duran. * Hâcet, ihtiyaç. * Taraf, nâhiye, cânip. * Vasat, orta.
urza: Hedef.
us: (C.: îsâs) Büyük kadeh.
usafe: Buğday sapından düşen parça.
usam: Pire.
usare ”ƒœœ: Vücud bezlerinden akan faydalı su. Sıkılmış şeylerden çıkan su. öz su.
usare-î îneb ”ƒœœý‚”›„: üzüm suyu. şıra.
usare-î mîdevîye ”ƒœœý‚š”šœ‚ÿœ: Mide suyu, mide salgısı.
usas: çok kıl.
usat: (Asi. C.) Asiler, zorbalar, itaat etmeyenler. * Günahkârlar.
usbe ”„œ: Cemaat. însanlar. Atlılar. Atlar veya kuşlardan cemaat.
usbud: Kelp aşmasından olan kurt yavrusu.
usde: Kaftan altına giyilen küçük gömlek.
usefa: (Asif. C.) Rençberler. Irgatlar.
useybe: (C.: Useybât) Yaprağı bir takım kısımlara ayıran liflerden herbiri. Damar.
useyle: Bal gibi tatlı olan küçük bir şey. * çiftleşme, cinsi münasebet.
usfür: Bir asıl boya.
uskul: Hurma salkımı.
usluc: (C.: Asâlic) Yeni belirmeğe başlamış ağaç budağı.
usm: Her nesnenin bakiyyesi, artık.
usm: Zeytin ağacı.
usmuh: Kulak. * Kulak deliği.
usmur: (C.: Asâmir) Döndükçe suyu çıkarıp döken dolap gözleri.
usnun: (C.: Asânin) Sakal ucu. * Her nesnenin evveli. * Devenin çenesi altında olan uzun kıllar.
usr: (C.: Usur - A'sâr) Sığınacak yer. Melce'. * Dehr, zaman, devir.
usr ”†œ: Tavşancıl kuşu. * Yalan söz.
usr: Güçlük, zorluk. Zor iş. * Sıkıntı. Darlık. Kıtlık.
usr-ün nefes: Nefes darlığı.
usra: Güçlük, zorluk.
usret ”žœ…: Zorluk, güçlük. Darlık, sıkıntı. îşlemezlik.
usret: Sığınacak ve kurtulacak yer.
usret-î hazm: Hazım güçlüğü, sindirim zorluğu.
usret-î teneffüs: Teneffüs zorluğu, nefes darlığı.
usse: Güve denilen böcek.
ustam: f. Güvenilir, emin. îtimad edilir. * Altın veya gümüşten yapılmış at eğeri.
ustuble: üstüpü.
ustumme: Her nesnenin aslı.
usube: îhâta etmek, kaplamak, içine almak.
usul ƒ™: (Asıl. C.) Ana, baba. Cedler. * îstinadgâh. * Râcih delil, kaide. Asıllar, kökler, temeller. Bir ilmin asıl mevzuundan önce öğrenilmesi lâzım gelen esaslar. Bir hedefe ulaşmak için tutulan düzenli yol. * Tarz, metod, tertip.
usul-ü erbaa ƒ™‚¤œ„”œ: (Bak: Edille-i erbaa)
usul-ü fikih îlmî: Fıkıh ilmine âit bilgilerin esası ve istinadgâhı olan bir ilimdir. şer'i hükümlerin mufassal ve muayyen delilleri ve hikmetleri bu sayede bilinir ve bu dini hükümler, bu muayyen ve müşahhas deliller vâsıtası ile istinbat ve isbat olunur. Bu ilme "Hikmet-i teşriiye" de denilmiştir. 
usul-üd-dîn: (Bak: îlm-i Kelâm)
usulîyyun: Fıkıh usulüyle uğraşan îslâm âlimleri. Usul-ü Fıkıh müellifleri.
usur ”†œ: Gözcülük etmek.
usur ”œ: Asırlar. (Bak: Asr)
us'us: Kuyruk sokumu.
usüvv: Kaba ve iri olmak. * Katı olmak. * Gece karanlık olmak. * Yakın olmak.
usve: çoktandır taranmamış sakal.
uşabe: (C.: Eşâyib) Karışık olan. * Nesebi karışık kişi.
uşara: Uzunluğu on zira' miktarı olan.
uşb: (C.: A'şeb) Taze ot.
uşere: (C.: Uşur-Uşerat) Sütleğen cinsinden dikenli, yassı yapraklı ağaç.
uşeyya: (Eşyâ. dan) Küçük şeyler, eşyacıklar.
uşîr: Taze çayır, taze ot.
uşş: Kuş yuvası.
uşşak: (âşık. C.) âşıklar.
uşve: Gece vakti uzaktan görünen ateş.
utahîye: Akılsız, ahmak kimse.
utarîd: Araptan bir kabile adı. * Merkür gezegeni.
utaş: însana ârız olan bir hastalıktır ve hasta insanın yüreği yanar, suyu içer, yine kanmaz.
utat: (Ati. C.) Serkeşler, âsiler.
utat: Arslan. * Bahadır er, kahraman.
utbul: (C.: Atâbil) Uzun boylu güzel kadın.
uteka: (Atik. C.) Azatlılar. Azat olmuş köle veya cariyeler.
utîy ”…ÿ: (Bak: Atiy)
utle: Boş ve muattal olmak. * Hurma salkımı. * şahıs.
utm: (Utüm) Yabani zeytin ağacı.
utme: îğde gibi zeytin biçimindeki meyve.
utrufe: (Turfe. C.) Tuhaf, az bulunur.
utruş: Sağır.
uttel ”’™: üzerinde ziynet eşyası olmayan kadınlar.
utub: Pamuk.
utufet: Nezaket, lütuf. şefkat.
utuh: Aklı noksan olan.
utull ”…™: Soğuk, sert ve cimri insan. Câhil ve hayırdan men'eden. Galiz ve bahil kimse.
utum: Taş duvar. Taş yapı. * Köşk, kasr.
utun ”…›: Katı şey. şiddetli.
ut'ut: Yiğit. * Küçük buzağı.
ut'ut: Eşek sıpası.
utüv ”…: (Atiy-Utiy) Haddini aşma, tecavüz. Kibir. Serkeşlik. * Ayaklanma. îsyan.
utye: Pamuk parçası. * Yanmış bez parçası.
uva ”¥£: şiddetli ses. Avaz, sayha.
uvera ”œƒ£: (Bak: Avrâ)
uvvam: Dalgıç adam.
uvvar: (C.: Avâvir) Korkak adam. * Dağ kırlangıcı.
uvz: Bir kimseye sığınmak.
uyku: (Bak: Kaylule)
uyub ”ÿ„: (Ayıb. C.) Ayıblar, kusurlar.
uyun ”ÿ›: (Ayn. C.) Gözler. * Kaynaklar, pınarlar.
uzafîre: Katı. şiddetli, şedid.
uzbet: (Bak: Uzube)
uzema': (Azim. C.) Mevki ve şeref bakımından büyükler. 
uzeym: (C.: Uzeymât) Kemikcik.
uzeyvat: (Uzeyve. C.) Küçük uzuvlar, uzuvcuklar.
uzeyza': Kuyruk kemiği.
uzfur: Asma filizi. * Tırnak.
uzhul: (C.: Azâhil) Yeyni, hafif. * Yük vurulmayan deve.
uzîma: Vücutta bir organın ateşsiz ve ağrısız olarak şişmesi.
uzlet ”™ : Yalnızlık. însanlardan ayrılarak bir tarafa çekilip yalnız kalmak.
uzletgâh ”™…˜ƒœ: f. Oturulan tenhâ yer. Yalnızlık köşesi.
uzletgüzîn: f. Tenhada yaşayan, yalnızlık köşesine çekilen.
uzletnîşîn: f. Tenha bir köşeye çekilip yalnız yaşayan.
uzlufe: Kayalık. Yalçın kaya.
uzm: Ululanma, kibirlenme.
uzma ”“šÿ: (Müe.) Büyük. îri. * En büyük. çok büyük. (Müz: A'zam)
uzme: Aşiret. * Birinin mensub olduğu âile. * Akrabâ.
uzret: önde olan saç.
uzrîyy: şiddetli muhabbet. şiddetli sevgi.
uztumme: însanın ırk ve nesebi. * Her şeyin aslı.
uzub ”„: Kayıp ve görünmez olmak.
uzube ”„œ: (Uzbe) Bekârlık. Erginlik hâleti varken tecerrüd halinde kalmak. Evlenmemek.
uzubet ”‹„ : Tatlılık, şirinlik.
uzubet-î lîsân: Tatlı dillilik. Dil tatlılığı.
uzuf: Nefsi kötülüklerden ve şüphelerden menedip uzaklaştırmak.
uzuv ”‘: (Uzv) Bir canlının vücud yapısının kısımlarından herbiri. Azâ. Organ.
uzvî ”‘ÿ: (Uzviye) Uzva ait. Canlı. Organik.
uzvîyet: Uzuv oluş. Canlılık. Canlı uzva ait.
uzza ”ƒ: îslâmiyetten evvel câhiliyet devrinde büyük putlardan birisinin ismi.
uzzab ”ƒ„: Zevc veya zevcesi olmayan. Bekâr.: übab: şiddetli ve taşkın sel suyu.