übatîr: Akrabasını arayıp sormayan kişi.
übbehet: Ululuk, büyüklük, azamet.
übeyd: (Abd. dan) Kölecik, kulcağız.
übhet: (Bak: übbehet)
übne: (C.: îben) Ağaç boğumu.
übud: ürkmek.
übülle: Basra yakınında bir harap şehir. * Bir miktar hurma.
übüvvet: (Eb. den) Babalık, atalık.
übüvveten: Babalık sıfatıyla. Atalık cihetiyle.
ücac ƒ‡ƒ‡: Tuzlu, acı su.
ücahîn: (C: Acâhine) Hizmetkâr. * Aşçı. Dost. * Deyyus.
ücem: (Ecme. C.) Sık ağaçlık yerler.
ücra ƒ‡œƒ: f. Pek uçta ve kenarda olan. Uzak. (Bu kelime, Arapça zannedilerek "hücra" yazılması yanlıştır.)
ücret ƒ‡œ…: Hizmet karşılığı verilen şey.
ücum: Kale.
ücun: Suyun renginin ve tadının bozulması.
ücur ƒ‡œ: (Ecir. C.) Ecirler, sevablar.
ücurat: (ücret. C.) ücretler.
ücümm: Medine ehlinin taştan yaptıkları hisar. * Sığınacak yer. * Damlı dört köşeli ev.
üdeba ƒš„ƒ£: (Edib. C.) Edibler, edebiyatçılar. * Edeb sâhibleri. Zarif kimseler.
üf: Kulak kiri. * Tırnak arasında olan kir. * Hüzün ve kedere işaret eden kelime.
üfçe: f. Bostan korkuluğu.
üff: Of!
üffe: Necis, pis.
üfhud: Yetişmiş çocuk.
üfhus: (C.: Efâhis) Kayalarda olan kuş yuvası.
üfkuhe: şaşılacak şey.
üfn: Hamâkat, ahmaklık.
üfnun ƒ–››: Hâl. Nev, çeşit. Saçma sapan söz. Dedikodu.
üftade ƒ–…ƒšœ: f. Düşmüş. Fakir, biçare. * âşık, tutkun.
üftadegân: (üftade. C.) f. Düşkünler. Tutkunlar. âşıklar.
üftadegî: f. Düşkünlük, biçarelik.
üftan: f. Düşen. Düşerek.
üfuk ƒ–˜: (Efk) Yalan söylemek. * Kaçmak. * Bir işten sapmak.
üful ƒ–™: Batmak, kaybolmak. * Mc: ölmek.
üf'ule: Vazife, görev.
üf'uvan: Erkek yılan.
üfürre: Karışmak.
ühbe: Yolculuk veya asker için hazırlanmış elbise ve malzeme. * Süt.
ühcîyye: (ühcüvve) Hicvetmeğe sebep olan şey.
ühcüvve: Hicvetmeğe sebep olan şey. * Yerme, hicvetme.
ühkume: Alaylı söz veya hal.
ükel: (ükle. C.) Lokmalar.
ükîle: Gıybet.
ükl ƒ˜™: (ükül) Meyve, yiyecek, azık. * Zekâ.
ükle: (C.: ükel) Lokma.
ükne: çukur içinde olan kuş yuvası.
ükre: Yuvarlak nesne. Top. * çukur.
ükrume: Kerem, bahşiş, lütuf.
üksum: çimenlik yer. çayırı bol ve güzel olan bahçe.
üksus: Sarmaşık.
ükule: Sürüden ayırıp beslenilen koyun.
ükül: (Bak: ükl)
ükzube: Yalan. Uydurma, söz.
ülbe: Kıtlık. * Açlık.
ülbub: Kiraz çekirdeği.
ülema ”™šƒ£: (Bak: Ulemâ)
ülfet ƒ™–…: Alışma, alışkanlık. Birisiyle münasebette bulunmak. ünsiyet. Ahbablık, dostluk. Huy etme. Görüşme, konuşma.(însanları fikren dalâlete atan sebeblerden biri; ülfeti, ilim telâkki etmeleridir. Yâni me'lufları olan şeyleri kendilerince mâlum bilirler. Hattâ ülfet dolayısıyla âdiyata teemmül edip ehemmiyet vermezler. Halbuki ülfetlerinden dolayı mâlum zannettikleri o âdi şeyler birer hârika ve birer mu'cize-i kudret oldukları halde, ülfet sâikasiyle onları teemmüle, dikkate almıyorlar; ta onların fevkinde olan tecelliyat-ı seyyâleye im'an-ı nazar edebilsinler. Bunların meseli deniz kenarında durup, denizin içerisindeki hayvanata ve sâir garip halâtına bakmıyarak yalnız rüzgâr ile husule gelen dalgalara ve şemsin şuâatından peyda olan parıltısına dikkat etmekle Mâlik-ül Bihâr olan Allah'ın azametine delil getiren adamın meseli gibidir.î'lem Eyyühel-Aziz! însanların arza âit mâlumat ve müsellemat-ı bedihiyatları ülfete mebnidir. ülfet ise, cehl-i mürekkeb üstüne serilmiş bir perdedir. Hakikate bakılırsa zannettikleri ilim, cehildir. Bu sırra binaendir ki, Kur'an, âyetleriyle insanların nazarını me'lufatları olan şeylere çeviriyor. âyetler, necimler gibi ülfet perdesini deler atar. însanın kulağından tutar, başını eğdirir. O ülfetin altındaki havârik-ul-âdât mu'cizeleri o âdiyat içerisinde gösterir. M.N.) (Bak: Tefekkür)
ülfetger: f. ülfet eden. ülfet edici.
ülhîyye: çocuk oyuncağı, oyuncak.
ülhüvve: Oyuncak, çocuk oyuncağı.
ülînnüha: (üli-n nühâ) Akıllı kimseler.
ülker ¡™˜œ‚œ: (Bak: Süreyya)
ülkü ƒ¢™˜: Bazı öz türkçecilik taraftarlarınca kullanılmış bir kelimedir. Divan-ı Lügat-ıt Türk'te "Peyman" mânasına geldiğine merhum A. Hamdi Elmalılı işaret ediyor: "Ahd ü misak" da denir. Emani, ideal mânâsına kullananlar varsa da yanlıştır.
ültîmatom ƒ¢™…ÿšƒ…š: (Oltimatom) Fr. Kat'i ve dönülmez söz. Son söz. * Bir devletin başka bir devlete verdiği ihtar.
ül'ube: Piyes, oyun.
üluf ƒ™–: Binler. (Bak: Uluf)
üluhîyet ƒ™œÿ…: (Bak: Uluhiyet)
ül'üban: Oyuncu, aktör.
ülüm: f. Bölük, takım, cemaat.
ülya ”™ÿƒ: (Bak: Ulyâ)
üma': Kedi miyavlaması.
ümdud: Usûl, âdet, görenek.
ümduha: Medhedilmeğe sebep olan hal veya iş.
ümem ƒšš: (ümmet. C.) ümmetler. Milletler.
ümem-î sâlîfe ¤šš‚žƒ™–œ: Geçmişteki ümmetler. îslâmiyetten evvel diğer Peygamberlere tâbi olmuş ümmetler.
ümena ƒš›ƒ£: Emin kimseler. Eminler. Emniyet sahibleri.
ümera ƒšœƒ£: (Emir. C.) Emirler, beyler. Seyyidler. şerifler. * Yüksek rütbeli zabitler.
ümhud: çömlek. * Tuzluk.
ümîd ƒšÿš: f. Ummak. Emel. Arzu. întizar. Umut. Rica.
ümîdbahş: f. ümitlendiren, ümit veren.
ümîdbeste: f. ümitlenmiş, ümit bağlamış.
ümîdgâh: f. Bir şey ümit edilen yer veya makam.
ümîdvâr ƒšÿšƒœ: f. ümitli. ümit besleyen.(Evet, ümidvâr olunuz; şu istikbal inkılâbı içinde en yüksek gür sadâ, îslâmın sadâsı olacaktır. M.) (Rahmet-i îlâhiyyeden ümid kesilmez. çünkü Cenab-ı Hak bin seneden beri Kur'anın hizmetinde istihdam ettiği ve ona bayraktar tayin ettiği bu vatandaşların muhteşem ordusunu ve muazzam cemaatını muvakkat arızalarla inşâallah perişan etmez. Yine o nuru ışıklandırır ve vazifesini idame ettirir... M.)
ümluc: Yaprak. * Selvi yaprağına benzer uzun, karışık bir ot.
ümlud: (C: Müled) Kamış dalı.
ümm ƒš: Ana, anne, vâlide. Nine. * Asıl, esas. * Başlıca olan şey.
ümm-î seleme: (Mi: 542-626) ümmehât-ı Mü'mininden olup, Resül-ü Ekrem Aleyhissalâtü Vesselâm'ın son vefat eden zevcesi idi. 378 Hadis-i şerif rivayet etti. (R.A.)
ümm-üd dem: Kırmızı kan damarlarında görülen kabarma. Bu nabız damarlarından birisine açılan kan kesesi.
ümm-üd dîmağ: Beyin zarı.
ümm-üd dünya ¤š‚ƒ™š›ÿƒ: Dünyanın anası. Mısır.
ümm-ül bîlâd ƒš‚ƒ™„™ƒš: Mekke-i Mükerreme.
ümm-ül habâîs ¤š‚ƒ™‰„ƒ¡†: şarap, rakı gibi haram olan içki.
ümm-ül kîtab ƒš‚ƒ™˜…ƒ„: Kitabın anası, esası. Levh-i Mahfuz ve ilm-i îlâhi. (Yâni: Kur'ân, îlm-i îlâhide, Levh-i Mahfuz'da ezeli ve ebedi olarak mahfuz bulunduğundan Kur'anın aslı ve anası mânasında kullanılan bir tabirdir.) * Kur'an-ı Kerim'in müteşabih olmayan muhkem âyetlerine de kitabın anası, esası mânasında ümm-ül Kitab denilir. * Fâtiha Suresi. * Diğer bir mânada bütün müsbet ve faydalı kitabların anası ve mercii olarak Kur'an-ı Kerim'e de denir.)
ümm-ül kur'an ƒš‚ƒ™—œ¥›: Fâtiha Suresi.
ümm-ül kurâ ƒš‚ƒ™—œƒ: Mekke-i Mükerreme.
ümm-ül veled ¤š‚ƒ™™š: Huk: çocuğunun kendi efendisinden olduğunu söyleyen çocuk doğurmuş cariye.
ümm-ün nâfî': Tavuk.
ümm-ün nücum: Gök. Sema.
ümm-üt taâm: Buğday.
ümm-üt tarîk: Ulu yol. Yüce yol.
ümm-üt târik: Deve kuşu.
ümman: Emin kimse. Emniyetli kişi.
ümmehat ƒšœƒ…: (ümm. C.) Analar. * Esaslar, asıllar. * îslâmi ana eserler. Me'haz olabilecek kıymetli ilmi eserler.
ümmehât-ül mü'mînîn: Mü'minlerin anaları. Peygamberimiz Resül-ü Ekrem Aleyhissalâtü Vesselâm'ın mübarek zevceleri.
ümmet ƒš…: Cemaat, kavim, taife. * Bir hâkim milletin ashabından olan hey'et-i içtimaiye. * Bir peygambere inanıp onun yolundan giden insanların hepsi. Bir peygamberin Hakka davet ettiği cemaat. * Bir dille konuşan millet. * Arkasına düşülecek bir cemaat veya tarikat.
ümmet-î kaîme: Hakşinas, doğru, doğrudan ve Allah için kalkan, müstakim ve âdil ümmet.
ümmî ƒšÿ: Anasından doğduğu gibi kalmış ve tahsil görmemiş, mekteb ve medresede okumamış kimse. Yazı yazmak bilmeyen. (ümmi ile câhil arasında fark vardır. ümmi yalnız okuyup yazmak bilmiyendir. Câhil ise, okuyup yazmak bilse de, bir şey bilmiyen kimsedir, her ümmi câhil değildir.) * Anaya mensub olan.(Mefhar-i âlem (A.S.M.) hiç bir mektebde, medresede ve hiçbir beşerden tahsil görmeden, ümmiliğiyle beraber, evvel, âhir ilimlerle mücehhez olması, âlem-i îslâma, âlemlere ve dünyaya rahmet olması ve Onun bir misli ve benzeri bulunmaması, en büyük mu'cizelerden ve Hak Peygamber olduğuna dair en mühim delillerdendir.)
ümmî sînan ƒšÿ‚ž›ƒ›: (Vefatı Hi: 958, Mi: 1551) Halveti Tarikatı, Sinaniye kolunun piridir. Bursa'lı olduğu nakledilir. Karaman'lı olduğu hakkında da rivayet vardır. Risale-i şerife-i îstanbuli ümmi Sinan adında bir eseri vardır. (R. Aleyh.) (Osmanlı Müellifleri sh: 214)
ümmîyane ¤šÿƒ›œ: f. Bir şey bilmiyormuşçasına. ümmilere yakışır halde. Okur yazar olmadan.
ümmîyet ƒšÿ…: ümmi oluş. ümmi kimsenin hali. Okur-yazarlığı olmamak.
ümmîyye: Analık, annelik.
ümnîyye: Umut, ümid. * Arzu, istek, talep. * Niyet, kuruntu.
ümsüle: örnek olarak verilen beyit. Misal olarak gösterilen mısra.
ümumet: (ümm. den) Annelik, analık.
üm'uz: Keçi veya karaca.
ümüldan: Taze fidan. Körpe dal. * Genç, güzel. * înce ve narin vücud.
ünafî: Büyük burunlu kimse.
ünah: Süstlük, zayıflık.
ünan: înleme.
ünas ƒ›ƒž: Halk. însanlar.
ünbub ƒ›„„: (ünbube) Kamıştaki boğum arası kısım. * Parmak uçları. * Tüp. înce boru.
ünbuse: çocukların oyunu.
ünbuş: (ünbûşe) Bitki kökü. Kökü yerden takımıyla birlikte çıkarılan fidan.
üncuc: (C.: Anâcic) Hızlı yürüyen at.
üncur: şişe kılıfı.
ünf ”›–: (Bak: Unf)
ünkua: Yağ biriken yer.
ünma: îçi saman veya ot doldurulmuş şey.
üns ƒ›ž: Alışkanlık, alışma. * Arkadaş. Hemdem.
üns tutmak: Alışmak, birlikte düşüp kalkmak.
ünsa ƒ›†ÿ: Dişi. Kadın, kız.
ünsa-üns: Sıkıfıkı konuşma.
ünsî: (ünsiye) Alışmış, ünsiyet etmiş, sokulgan. * Arkadaş.
ünsîyet ƒ›žÿ…: Alışkanlık, dostluk. Birlikte düşüp kalkmak. Ahbablık.
ünşude ƒ›šœ: (Bak: Neşide)
ünşuta: Düğüm, ilmik.
ünuf ƒ›–: Henüz daha yedirilmemiş olan çayır. * (Enf. C.) Burunlar.
ünuset ƒ›†…: Dişilik. Müennes oluş.
ünün: Ayağı ve burnu kırmızı, vücudu kara olan bir kuş.
ünvan ”›ƒ›: îsim. Lâkab. Adres. * önsöz, mukaddeme.
ünvan-i mülâhaza ”›ƒ›‚š™ƒˆ“œ: Bir şeyin hakikatını bir derece düşünebilmek için olan isim, tabir ve vasıta.(Mi'raciyedeki mâceralar, mâlumumuz olan mânalarla, o kudsi ve nezih hakikatları ifade edemiyor. Belki o muhavereler birer ünvan-ı mülâhazadır; birer mirsad-ı tefekkürdür ve ulvi ve derin hakaika birer işarettir ve imanın bir kısım hakaikına birer ihtardır. Ve kabil-i tabir olmayan bazı mânalara birer kinayedir. Yoksa ma'lumumuz olan mânalar ile birer mâcera değil. Biz hayalimiz ile o muhaverelerden o hakikatları alamayız; belki kalbimizle heyecanlı bir zevk-i imani ve nurani bir neş'e-i ruhani alabiliriz. M.)
ünzuha: Gurur, kibir, büyüklük.
ürba: Belâ, mihnet.
ürbe: Büklüm. * Düğüm. * Hile.
ürbun: Pey akçesi, pey olarak verilen para.
ürcuce: Salıncak.
ürcufe: (C.: Erâcif) Yalan. Uydurma söz.
ürcuha: Salıncak.
ürcuze ƒœ‡œ: (Recez. den) Edb: Mısraları kafiyeli, kısa vezinli nazım. (Bak: Kaside)
ürd: f. Gibi, benzer.
ürdünn: Uyuklamak. * Bir büyük ırmak.
ürk: Mekân, mevki.
ürmule: (C.: Erâmil) Ergen delikanlı.
ürne: Taze peynir. * Keler tuzağı olan yer.
ürümek ¡œš˜: f. Havlamak. (ît ürür, kervan yürür)ürüyen köpek ısırmaz: Tehdit savuran, işi gürültüye boğan kimselerden yılmamak lâzım geldiğini anlatır.
ürvîyye: (C.: Ervâ-Erâvi) Dağ keçisinin dişisi.
üryan ”œÿƒ›: (Bak: Uryan)
üsal: çok miktar mal.
üsame: Davar otlatmak. * Arslan.
üsame bîn zeyd (r.a.): Resül-ü Ekrem Aleyhissalâtü Vesselâm'ın azadlısı olan Zeyd bin Harise'nin oğludur. Meşhur sahabedendir. 128 Hadis-i şerif rivayet etmiştir. 75 yaşında iken 54 yılında vefat etmiştir. (R.A.)
üsara: (Bak: üsera)
üsare ”ƒœœ: (Bak: Usare)
üsbu' ƒž„”: Hafta. Yedi günlük zaman.
üsbube: (C.: Esâbib) Sövme, küfür.
üsbuî: (üsbuiyye) Haftalık.
üsera ƒžœƒ£: (üsârâ) Esirler. Harbde teslim alınanlar. * Köleler.
üsfîyye: (C.: Esâfi) üzerine tencere koyup yemek pişirilen ocak taşı.
üsîr: Yaranın iyi olduktan sonra kalan izi.
üskub ƒž˜„: Sıra ile dikilmiş olan ağaçlar. * Kunduracı. * Dökülmüş olan, akan su. * Demirci.
üskuf: (C.: Esâkıf) Kâfirlerin kadısı ve ruhbanları.
üskuf: (C.: Esâkife) Pabuç diken, kunduracı.
üskun: Koruk halinde hurma salkımı.
üskutuss: (Rumcadan) Cevher, asıl, unsur, madde.
üsküdar: Mushaf cildi.
üsküffe: Eşik tahtası.
üskür: f. Kirpi.
üslem: El arkasında hınsırla pınsır arasındaki damar.
üslub ƒž™„: Tarz, yol. Biçim. îfade tarzı. Dizmek.
üslub-perestlîk: Kelâmın mâna ve maksada uygunluğuna değil de, ifade tarzının güzelliğine önem vermek.
üslub-u âdî: Alelâde ifade tarzı. îfadesinde hiçbir üstünlük bulunmayan tarz.
üslub-u âlî: Edb: üstün ifade tarzı. îfadenin yüksek ve nezih olanı.
üslub-u hakîm: Edebi san'atlardan biridir. Sorulan bir suale, soranın halini nazara alarak başka bir sual gibi telâkki edip, ona göre cevab vermek demektir. Meselâ : Bazı Ashab Resulüllah'a (A.S.M.) hilâlin ince başlayıp, kalınlaşarak bedr şekline gelip, sonra yine başladığı şekle dönmesinin sebebini sordular. Bunun cevabı onlara lâzım olmadığı için, Kur'ân-ı Kerim o vaziyetin neticesine terettüb eden hikmeti, yani ayın takvimcilik yaptığını söylemiştir. çünkü bu, soranlar için daha mühim ve anlaşılması daha kolaydır.
üslub-u mücerred: (Sade üslub) Bu üslupta tabiilik, akıcılık, selâset, kısalık, mânâ ve maksada kifayet sıfatları vardır. Bu üslup, âlet ilimlerinde, ders kitablarında, konuşmalarda ve beşeri muamelelerde kullanılır.
üslub-u müzeyyen: (Ziynetli ve parlak üslub) Bu üslub tergib ve terhib (teşvik etme ve sakındırma) gibi hususları tazammun eder. Hitabiyat ve iknaiyatta kullanılır.
üsr: Sidik tutulması, sidik zoru.
üsre ƒ†œœ: Seleften gelen şan şeref. * Söz veya hadis nakletmek.
üsre: Cemaat, topluluk.
üsruş: f. Güzel ses.
üsrüb: f. Kurşun.
üss ƒž: Esas, asıl. Kök, temel. * Askerlikte herhangi bir düşman hücumuna karşı esas dayanak olmak üzere önceden hazırlanmış yer. * Harb gemilerinin, noksanlıklarını tamamladıkları yer. * Mat: Bir sayının hangi kuvvete çıkarıldığını gösteren sayı.
üss-ül esas ¤ž‚ƒ™¤žƒž: Hakiki sağlam temel.
üss-ül harekât ƒž‚ƒ™ˆœ˜ƒ…: Askeri harekâtın başlangıcına esas olan yer.
üst perdeden başlamak: Ağız bozmak, sert konuşmak.
üstad ƒž…ƒš: (üstaz) îlim veya san'atta üstün olan kimse. Usta, san'atkâr. Muallim, profesör. Bilgide veya san'atta veya amelde meharetli zât.
üstad-i a'zam ƒž…ƒš‚ƒ”“š: En büyük üstad. Muallimlerin en üstünü ve reisi olan.
üstad-i ezelî ƒž…ƒš‚¤™ÿ: Cenab-ı Hak. Bütün ilim ve bilgilerin, marifetlerin öğreticisi. Alim-i Mutlak ve Hakim-i Ezeli.(... Hem maden-i kemalât ve muallim-i ahlâk-ı âliye olan o dellâl-ı vahdaniyet ve saadet kendi kendine söylemiyor, belki söylettiriliyor. üstad-ı Ezelisinden ders alır, sonra ders verir... M.)
üstad-i küll ƒž…ƒš‚˜™: Herkesin üstadı. Her çeşit ilimde çok ileri bilgisi olan.
üstad-ül beşer ƒž…ƒš‚ƒ™„œ: Beşerin bütün insanlığın üstadı, hocası, daha bilgili ve ârif. Muhammed Aleyhissalâtü Vesselam.
üstadane ƒž…ƒšƒ›œ: f. üstâda yakışır surette. Ustaca.
üstadî: f. üstadlık, ustalık.
üstah: f. Edebsiz, hayasız, utanmaz kimse.
üstam: f. Güvenilir, itimad edilir, inanılır, emin. * Gümüş veya altından yapılmış üzengi, at eyeri.
üstîbah: Masura.
üstun: f. Direk. Sütun.
üstur: f. At, katır davar gibi dört ayaklı hayvan. 
üsture ƒž’œœ: Edb: Efsane, uydurma hikâye demek olan "esâtir" kelimesinin müfredidir.
üstühan: f. Kemik.
üstühanpâre: Kemik parçası.
üstükus: (C.: üstükusât) Cevher, madde, asıl. * Geometri.
üstümm: (C.: Esâtim) Deniz suyunun toplandığı yer.
üstümme: Orta, vasat.
üstüre: f. Ustura.
üstüvane ƒž’ƒ›œ: Geo: Silindir. Direk şeklindeki sütun. îçi boş direk şekli.
üstüvar: f. Kuvvetli, dayanıklı, sağlam, muhkem. * Güvenilir, itimad edilir.
üstüvarî: f. Sağlam, kuvvetli, emniyetli.
üsun: Suyun tad ve renginin değişmesi. * Bir kimse kuyuya girdiğinde buharından veya murdar kokulardan dolayı aklının gitmesi.
üsür: Yara izi. * Kılıcın rengi ve cevheri.
üsve(t) ƒž : Beraberlik. * Halka reis olmak. * Dert ortağı. Sâdık arkadaş. Manevi tabib. * Nümune ve örnek tutulacak olan insan.
üşabe: Irkı, nesebi karışık adam. * Karışık cemaat. * Rüşvet ve hırsızlık gibi yollarla elde edilen kazanç.
üşbe: Kurt, böcek.
üşer: Dişlerini birbirine sürüp keskinleştirmek.
üşgule: Uğraşılacak iş. Meşguliyet.
üşgur: f. Oklu kirpi.
üşhub: Süt sağılırken çıkan ses.
üşkufe: f. çiçek.
üşkuh: f. Ululuk, büyüklük, şan ü şeref.
üşküfte: f. Açılmış çiçek.
üşkür: Mest içine dikilen astar.
üşne ƒ›œ: Yosun.
üştülüm: f. Kavga, gürültü.
üştülümkâr: f. Kavgacı, gürültücü.
üştür: f. Deve.
üştürbân: f. Deveci.
üştürdîl: f. Kinci, fesatçı, hasedçi.
üştürek: f. Dalga. Mevc.
üştürgav: f. Zürafa.
üştürhu: f. Deve huylu. Kinci, hased eden.
üştürmurg: f. Deve kuşu.
ütam: Sidik tutulması. îdrar tutukluğu.
ütrur: Subaşı oğlanı.
üvam: Susuzluk.
üvera': Ateş ve güneş harareti. * Susuzluk harareti.
üveyl: çığlık, vâveylâ.
üveys-el karanî ƒÿž‚ƒ™—œƒ›ÿ: Hz. Ebu Bekir ve ömer (R.A.) devirlerinde Medine-i Münevvere'de çok hürmet gören ve Tabiinin büyüklerinden olup hadis-i şerif ile medh ü senâsı yapılan büyük bir veli. Peygamberimiz (A.S.M.) zamanında yaşamış ise de vâlidesine çok hürmetinden dolayı Peygamberimizle görüşememiş, fakat ona bütün ruh u canı ile bağlı kalmıştır. Sıffin Muharebesinde Hz. Ali'nin (R.A.) askerleri arasında şehid düşmüştü. (Hi: 37) Veys diye de anılır.
üveysî: (üveysi tarzı) Veysel Karani Hazretleri gibi sevdiği ve kendisine bağlı olduğu zatı görmeden ve gaybi olarak olan muhabbet ve bağlılık; ve bu muhabbetle bağlı olduğu zattan manevi feyz almak tarzı.
üyel: (C: Eyâyil) Dağ keçisi.
üzanî: Kulakları büyük olan adam. (Merkepten kinaye olarak söylenmiştir.)
üzeyr ”ÿœ: (A.S.) Kur'an-ı Kerim'de ismi bulunan büyük zâtlardandır. Peygamber olup olmadığı hakkında ihtilâf vardır.
üzfur: (C.: Ezfâr-Ezâfir) Tırnak.
üzlufe: (C.: Ezâlif) Sarp kayalı yer.
üzn: Kulak. îşitme organı.
üzn-ü dâhîlî: îç kulak.
üzuf: Yakın olmak, yaklaşmak.: ƒƒva: f. "Arkada, geri" mânâlarına gelerek birleşik kelimeler yapar.