ya: "Hey, ey!" mânasında nida olarak kullanılır. Arapçada başına geldiği kelimenin i'rabını ötre okutur. "Yâ-Halimu, Yâ-Rahimu" da olduğu gibi. Yâ, terkibli kelimelerin başına gelirse; baştaki kelimeyi "üstün" meftuh okutur. "Yâ Rabbe-l âlemin" de olduğu gibi."Yâ" üç şekilde kullanılır:1- Müennes zamiri olur. Kübrâ  Hüsnâ gibi.2- Harf-i inkâr olur.3- Harf-i tezkâr olur. Bu hâlde elifle olursa "Harf-i nidâ" dır. Bâzen te'kid için kullanılır: "Yâ Allah, Yâ Rabbi" denildiği gibi. Bazen teessüf, istimdad ve istigase ifade ettiği de olur. "Yâ meded Allah, Yâ Allah!" gibi. Yâ, terdif beyan eder. " Ve yahut" manasına: "Ya gelir ya gelmez" gibi. Taaccüb ve istigrab beyan eder: "Ya öyle mi?" de olduğu gibi. Tasdik bildirir: "Evet, hay hay" mânasını ifade eder. "Gider yâ" gibi.
ya eyyühel hoto: Ey vahşi, kaba dağ adamı!
ya leyte: Keşke, ne olurdu.
yab: "Yaften: Bulmak" mastarından emir kökü olup, birleşik kelimeler yapılır. Meselâ: şifayab: şifa bulan, iyileşen.
yaban: çöl, sahra.
yabanî: Yabana mensub. Issız yerlerde yaşıyan. Yabancı, alışmamış.
yabende: Bulan, bulucu. * Keşfeden, kâşif.
yabîs: Kuru.
yabnak: Bulan, bulucu.
ya'bub: Hızla akan nehir. * Suyu çok olan ark. * Bulut. * Hızla giden at.
yâd: Anma. Hatırda tutma. Zikretme. * Hediye. * Hâtıra. * Hatır, gönül. * Uyanıklık.
yad-bud: Armağan, yâdigâr.
yâd-i şebâbet: Gençlik hâtırası.
yâd-î hazîn: Hüzünlü hâtıra.
yadbüd: Hâfıza kuvveti.
yaddar: Hatırda tutan, unutmayan.
yaddaşt: Hatırda tutulan şey. Hâtıra.
yade: Hâtıra.
yadîgâr: Hatıra. Bir kimseyi veya bir şeyi hatırlatan.
yadkerd: Hazırlama.
yafe: Saçma ve mânasız söz.
yafes: Hz. Nuh'un (A.S.) üçüncü oğlu. Tufandan sonra Hazar Denizinin kuzeyinde yerleşmiştir.
yafte: "Bulunmuş, bulmuş, bulunan" mânalarına gelir ve birleşik kelimeler yapılır. Meselâ: şeref-yafte: şeref bulmuş.
yafuf: Turaç kuşunun yavrusu.
yafuh: Bıngıldak. Yeni doğan çocukların baş kemiklerinin arasındaki yumuşaklık.
ya'fur: (C.: Yaâfir) Tüyleri toprak renginde olan ceylân. * Ceylân yavrusu. * Gecenin beşte veya altıda bir bölümü. * Peygamberimizin merkebinin adı.
yağfîrullah: Allah mağfiret eyler, eylesin, günahlarını örtsün (meâlinde söylenir).
yağma: Zorla mal alma, çapul. * Bir Türk boyu.
yağmager: (C.: Yağmagerân) çapulcu, yağmacı, zorba.
yağmagerî: çapulculuk, yağmacılık.
yah: Buz.
yah-aver: Buzlu şerbet, buzlu su.
yahamîm: (Yahmum. C.) Kara dumanlar.
yahbeste: Buz tutmuş, donmuş, buz bağlamış.
yahçe: Donmuş yağmur taneleri, dolu taneleri.
yahmum: (C.: Yahâmim) Kara duman. * Tütün. * Kara nesne.
yahmur: Yaban eşeği.
yahnî: Et yemeği, yahni. * Azık, zahire. * Pişmiş şey.
yahpare: Buz parçası.
yahte: Benzer, misil, eş, nazir. * Oda. * Küçük küp.
yahtemîl: îhtimal.
yahud: îsterseniz, veyâ. îyisi.
yahudî: Hz. Yakub'un (A.S.) oğullarından Yehuda'ya mensub olan. Beni îsrail. Musevi. (Bak: îsrail)Yahudilerin vaziyetlerine ve seciyelerine işaret eden âyetler şunlardır: 2: 60-66 arası. 5: 62-64 arası ve 17: 4.(Yahudilere müteveccih şu iki hükm-ü Kur'ani, o milletin hayat-ı içtimaiye-i insaniyede dolap hilesiyle çevirdikleri şu iki müdhiş düstur-u umumiyi tazammun eder ki, hayat-ı içtimaiye-i beşeriyeyi sarsan ve sa'y ü ameli, sermaye ile mübareze ettirip, fukarayı zenginlerle çarpıştıran, muzâaf riba yapıp bankaları te'sise sebebiyet veren ve hile ve hud'a ile cem-i mal eden o millet olduğu gibi, mahrum kaldıkları ve daima zulmünü gördükleri hükümetlerden ve galiplerden intikamlarını almak için her çeşit fesat komitelerine karışan ve her nevi ihtilâle parmak karıştıran yine o millet olduğunu ifade ediyor. S.)
yahya (a.s.): Zekeriya'nın (A.S.) oğludur. Beni îsrail Peygamberlerinden ve îsa Aleyhisselâm'ın şeriatı ile amel edenlerden olmuştu. Hz. îsa'dan (A.S.) önce Tevrat'a göre hareket ederdi. Kudüs'ün o zamanki reisi, Hz. Yahya'nın, Hz. Musa şeriatı üzere amel etmediğini ileri sürdüklerinden şehid ettiler.
yahyah: "Beri gel" demektir.
yaîs: (Ye's. den) ümitsiz, kederli, me'yus.
yakaza: (Bak: Yakza)
yakazan: Uyanık kimse. * Tozu yükselen toprak.
yakik: Katı nesne.
yakitî (yakutî): Kırmızı üzüm.
yakiz: (C.: Eykâz) Uyanık.
yakîn: şüphesiz, sağlam ve kat'i olarak bilmek.(Yakin: Ma'rifet ve dirayetin ve emsalinin fevkinde olan ilmin sıfatıdır. îlm-i yakin denir, ma'rifet-i yakin denilmez. Ayn-el yakin: (kelimenin merfu hali ayn-ul yakindir.) Göz ile görür derecede veya görerek, müşahede ederek bilmek. Meselâ; uzakta bir duman görüyoruz. Orada ateşin varlığını ilmen biliyoruz, demektir. Bu bilme derecesine ilm-el yakin deniyor. Ateşe yaklaşıp, gözümüzle görürsek, ona ayn-el yakin bilmek deniyor. Daha da ilerliyerek bütün hislerimizle ateşin varlığını anladık ise; ateşin yakması ve sâir sıfatlarını da bildik ise, bu nevi'den olan ilmimizin derecesine de hakk-al yakin deniyor. (Hakkalyakin: Abdin sıfatları, Cenab-ı Hakk'ın sıfatlarında fâni olup, kendisi onunla ilmen ve şuhuden ve hâlen beka bulmaktadır. ö. Nasuhi)
yakînen: Hiç şübhesiz olarak, kat'i surette.
yakînî: şüphe edilmeyecek ilmi halde, hiç şeksiz bilinmeğe dair.
yakînîyyât: Yakini bir surette bilinenler.
yaktîn: Kabak, kavun ve karpuz gibi dalları yerde yayılan bir nebat adı.
ya'kub (a.s.): Kur'an-ı Kerim'de adı geçen peygamberlerdendir. Yusuf Aleyhisselâm'ın babası ve îshak Aleyhisselâm'ın oğludur. Bir adı da îsrail olduğundan bu sülâleden gelenlere îsrail oğulları mânasına, Beni îsrail denilmektedir. Büyük oğlunun adı Yehud olduğundan sonradan bunlara Yahudi denilmiştir. (Bak: Yusuf A.S.)
yakut: çeşitli renkleri olan kıymetli bir süs taşı.
yakut-u müzab: Erimiş yakut. * Göz yaşı. * Kan. * Kırmızı şarap.
yakut-u zerd: Sarı yakut. * Güneş.
yakza: Uyanıklık. Dikkatte olma.
yakzân: Uyanık.
yakzaten: Uyanık olarak. şuurlu ve dikkatli surette.
yâl: Kuvvet, güç. Boyun, gerdan.
yâl ü bâl: Boybos düzgünlüğü.
yalak: Hayvanların su içmelerine mahsus içi oyuk kütük veya taş. çeşmelerin musluğu altına konulan tasa da bu ad verilir.
yalan: (Bak: Kizb)
yaldiz:iCilâ. * Parlatmağa yarıyan şey.
yale: Sığır boynuzu.
yalmend: Aile reisi. Aile başkanı.
ya'lul: (C.: Yeâlil) Beyaz bulut. * Su üzerinde peydâ olan kabarcık. * çift hörgüçlü deve.
yalvane: Kırlangıç kuşu.
yam: Posta beygiri.
yamak: Yardımcı, yardak, muavin.
ya'mele: îşe dayanıklı cins dişi deve.
ya'mur: (C.: Yeâmir) Bir nevi ağaç. * Oğlak. Kuzu.
yamur: Başının ortasında bir sürü boynuzları olan bir cins geyiğin erkeği.
yan: Hastanın sayıklaması.
yanesun: Anason otu.
ya'nî: (Yâni) Bundan maksat, demek, demek isteniyor ki.
yanî': Kıvama gelmiş, olmuş. Pişkin.
yankesîcî: Biçimine getirerek insanın üzerinden gizlice birşey çalan hırsız.
yâr: Dost, ahbab, tanıdık. * Yardımcı. * âşık. Mâşuk, sevgili.
yâr-i bîvefâ: Vefasız dost.
yâr-i cîhar: (Bak: çar yâr)
yâr-i gar: Hazret-i Peygamber Aleyhissalâtü Vesselâm'ın en sâdık sahabesi Hazret-i Ebubekir Radıyallahü Anh'ın ünvanı. Hicret esnasında en tehlikeli bir zamanda mağaraya girdiklerinde Peygamberimiz Aleyhissalâtü Vesselâm'a sadakatla hizmet ettiğinden bu nam ile anılır. (Bak: Sıddık)
yâr-i kadîm: Eski dost.
yara: Güç, kuvvet, kudret, takat.
yârân: Dostlar. Sâdık arkadaşlar. Sevgililer.
yârân-i aşk: âşıklar, aşk dostları.
yârân-i safâ: Zevk ve eğlence ile vakit geçiren dostlar. Safâ dostları.
yarane: Dostça.
yâre: Bilezik.
yâre: Yara.
yâre-î hîcran: Ayrılık yarası.
yarek: Dölyatağı. Meşime.
yari ümmî: Yazıyı tam yazamayan. * îlmi daha ziyade ilhama istinad eden.
yârî: Yardım. * Dostluk.
yarmend: Dost, muin, yardımcı.
yarres: îmdada yetişen.
yasemîn: Güzel kokulu, beyaz ve güzel çiçekler açan sarmaşık cinsinden bir ağaç.
yasib: Yeşim taşı.
yasif: Yeşim taşı.
yasîn: Yâ Seyyid yâ insan gibi muhtelif manalar rivayet edilir. şifredir Hazret-i Peygamber'in (A.S.M.) fıtraten, hilkaten, edeben ve ahlâken en yüksek olduğu herkesçe bilindiğinden bu isim kendisine verilmiştir. (Bak: Huruf-ı mukattaa)
yasîn suresî: Kur'an-ı Kerim'in 36. suresinin ismidir. Mekkidir.
yasîr: Sol tarafa giden.
ya'sub: Arı beyi. * Emir, bey, reis. * Peygamberimiz Aleyhissalâtü Vesselâm'ın bir atının ismi. * Atın alnındaki beyazlık. * Bir nevi kuş.(Karıncayı emirsiz, arıyı ya'subsuz bırakmayan Kudret-i Ezeliye; elbette beşeri nebisiz bırakmaz. M.)
yâve: Hezeyan. Yalan. Yaygara. Saçma sapan söz. * Sahipsiz hayvan.
yâve-gû: (C.: Yâve-guyân) Saçmasapan konuşan, saçmalayan.
yâver: Yardımcı. Mededkâr. îmdatçı. * En yakın memur. * Devlet büyüklerinin yanında bulunan en yakın memur.
yâver-î ekrem: Cenab-ı Hakk'ın emrinde çalışan en makbul yâver, en kerim olan Hazret-i Muhammed. (A.S.M.)
yâverân: (Yâver. C.) Yâverler. Yardımcılar.
yâverî: Yâverlik, yardımcılık.
yavuz: şiddetli yanan. * A'lâ, fevkalâde. * Pek sert.
yavuz sultan selîm: (Hi: 875-926) Osmanlı Padişahlarından dokuzuncusudur. Sultan Süleyman Han'ın babası, 2. Bayezid Han'ın oğludur.Azim ve sebat örneği olan ve memleket mes'elelerinde en küçük kusurları bile afvedemiyen Yavuz Selim, çaldıran seferine çıkmıştı. Uzun müddet seferde olan askerleri bir gün padişahın çadırına kurşun atacak kadar işi ileri götürdüler. Yavuz Selim hemen çadırından dışarı fırladı; atına atladığı gibi toplu bir halde duran Yeniçerilerin arasına atını sürdü, öfkeli nazarlarla sert sert baktıktan sonra:" -Bre asker kıyafetli korkak herifler! Askeri itaat, emre muhalefetten mi ibarettir? Zahmete katlanmadan zafer kazanmak kande görülmüştür? şecaat ve erliğinden şüphe edenler, rahatını düşünenler geri dönüp karılarının yanlarına gitsinler. Ben buraya kadar zahmetler ihtiyar edip, kemal-i zelilâne bir surette geri dönmek için gelmedim. şemşir-i celâletim altında hamaset ve şecaat göstermek isteyenler benimle beraber gelsinler. Siz gelmezseniz, ben yalnız da giderim...' diyerek atını çaldıran'a doğru sürmüştür. Neticede şah îsmail'e galip geldi. şiiliğin Anadolu'ya yayılmasına mani oldu. Daha sonra Tebriz ve Mısır'ı aldı. Hutbelerde "Haremeyn-i şerifeyn'in Hâdimi" diye ismini okuttu ve ilk Osmanlı Hâlifesi oldu. Osmanlı Devletinin topraklarını iki misline çıkardı. Büyük bir îslâm ittihadı için gayret gösteriyordu. şirpençe denilen bir çıban vesilesi ile Rahmet-i Rahman'a kavuştu. Türbesi, îstanbul'da yaptırdığı Sultan Selim Camii avlusundadır. (R. Aleyh)
yazdeh: Onbir.
yazdehüm: Onbirinci.
ya'zîd: Acı marul.
yeakîb: (Ya'kub. C.) Erkek keklikler.
yealîl: (Ya'lul. C.) Suları berrak ve saf akan göller. * Beyaz bulutlar. * Su üzerinde meydana gelen kabarcıklar. * çift hörgüçlü develer.
yeasîb: (Ya'sub. C.) Reisler, başkanlar, başlar. * Arıbeyleri.
yebab: Yıkık, bozuk, harap, virâne.
yeban: Sahra, çöl. * Issız ve tenha yer.
yebanî: Görgüsüz, kaba. * Yabâni, kırlarda biten. * Sıkılgan, ürkek. (Bak: Yabani)
yebes: Sonradan kuruyan yaş mevzi.
yebrem: "Gelberi" ismiyle bilinen bir cins demir kürek.
yebs: Islak şeyin kuruması.
yebuset: Kuruluk, nemsizlik, rutubetsizlik.
ye'cüc ve me'cüc: Kısa boylu olacakları söylenen ve Kur'an-ı Kerim'de bahsi geçen ve ortalığı fitne ve anarşiye boğacak olan bir kavmin ismi.(Ye'cüc ve Me'cüc hâdisatının icmâli Kur'anda olduğu gibi, rivâyette bir kısım tafsilât var. Ve o tafsilât ise, Kur'anın muhkemâtından olan icmâli gibi muhkem değil, belki bir derece müteşabih sayılır. Onlar te'vil isterler. Belki râvilerin içtihadları karışmasıyla tâbir isterler. Evet  Bunun bir te'vili şudur ki: Kur'an'ın lisan-ı semavisinde "Ye'cüc ve Me'cüc" nâmı verilen Mançur ve Moğol kabileleri, eski zamanda çin-i Maçin'den bir kısım başka kabileleri beraber alarak kaç defa Asya ve Avrupa'yı herc ü merc ettikleri gibi, gelecek zamanlarda dahi dünyayı zir-ü zeber edeceklerine işaret ve kinayedir. Hattâ şimdi de komünistlik içindeki anarşistin ehemmiyetli efrâdı onlardandır. Evet, ihtilâl-i Fransavide hürriyet-perverlik tohumuyla ve aşılamasıyla sosyalistlik türedi, tevellüd etti. Ve sosyalistlik ise bir kısım mukaddesatı tahrip ettiğinden aşıladığı fikir, bilâhare Bolşevikliğe inkılâb etti. Ve Bolşeviklik dahi çok mukaddesat-ı ahlâkıye ve kalbiye ve insaniyeyi bozduğundan; elbette, ektikleri tohumlar hiç bir kayıd ve hürmet tanımayan anarşistlik mahsulünü verecek. çünkü kalb-i insaniden hürmet ve merhamet çıksa; akıl ve zekâvet, o insanları gayet dehşetli ve gaddar canavarlar hükmüne geçirir; daha siyasetle idare edilmez. Ve anarşistlik fikrinin tam yeri ise; hem mazlum kalabalıklı, hem medeniyette ve hâkimiyette geri kalan çapulcu kabileler olacak. Ve o şeraite muvafık insanlar ise; çin-i Maçin'de kırk günlük bir mesafede yapılan ve acâib-i seb'a-i âlemden birisi bulunan Sedd-i çini'nin binasına sebebiyet veren Mançur ve Moğol ve bir kısım Kırgız kabileleridir ki, Kur'an'ın mücmel haberini tefsir eden Zât-ı Ahmediye (Aleyhissalâtü Vesselâm) mu'cizane ve muhakkikane haber vermiş. ş.) (Bak: Mürted)
yed: El. * Mc: Kuvvet, kudret, güç. * Yardım. * Vasıta. * Mülk.
yed-î beyzâ: Musa Aleyhisselâm'ın mu'cize olarak gösterdiği beyaz ve parlak eli. Bu tabir mecaz olarak keramet ve hârikulâde haller ve meziyetler hakkında kullanılır.
yed-î emîn: Kanunen güvenilir kimse olarak seçilen şahıs. * Mahkemece kendisine bir şey emanet olunan kimse. * Emniyetli, tehlikesiz ve korkusuz yer. * Hz. Muhammed'in (A.S.M.) bir lâkabı.
yed-î kudret: Allah'ın kudreti ve kudretinin tasarrufu.
yed-î rahmet: Rahmet eli, Rahmetle ihsan edilmesi.
yed-î tasarruf: Sahibolma, sâhiblik.
yed-î tulâ: En uzun el. * Geniş nüfuz. * Tam, çok geniş ilim ve ihtisas. * Büyük kudret.
yedan: Eller. îki el.
yedeyn: îki el.
yedîyy: El ile dokunmuş.
yedullah: Cenab-ı Hakk'ın kudreti, yardımı.
yefa': Yüksek yer.
yefen: Bunak adam.
yeftenc: Sevgililerin zülüfü kendisine benzetilen siyah renkli büyük bir yılan.
yegân: (Yek. C.) Birler. Tekler. Teker teker.
yegân yegân: Ayrı ayrı. Birer birer.
yegâne: Tek, bir.
yegâne-gî: Teklik, yegâne ve tek oluş.
yegden: Birden, birdenbire.
yegus: Nuh Aleyhisselâm'ın kavmine ait bir put.
yehhîr: Katı ve sert taş. * Serap.
yehma: Sahra, çöl.
yehmum: Kömür gibi simsiyah olan şey. * Zifir ve kara duman. * Cehennem ahalisini ihata eden perde.
yehmur: çok sözlü, çok konuşan adam. * çok çalışkan ve işe cür'etli olan kişi. * Yeri götüren balık.
yehr: înat etmek.
yehud: Yakub (A.S.) ın büyük oğlunun adıdır. (Bak: Ya'kub)
yeîs: (Ye's) ümitsizlik. (Bak: Ye's, Himmet)
yek: Bir, münferid. * Bir oluş, birlik.
yek-âvâz: Tek sesli, bir sesli. * Mc: Bir tarzda, bir şekil üzerine. * Edb: Başından sonuna kadar aynı kuvvette güzel olan manzume.
yek-dü-se: Bir-iki-üç.
yekâyek: Birer birer. Tek tek. * Ansızın.
yekbar: (Yekbâre) Bir defa, bir kere. Bir defada.
yekcîns: Aynı cinsten.
yekçeşm: Tek gözlü. * âhir zamanda gelecek olan Deccal'ın bir ismi. "Sadece dünya hayatını şiddetle isteyip âhireti unutan ve inkâr eden" meâlinde mecazen söylenilmiştir. * Güneş. (Bak: Deccal)
yekdane: Eşi, benzeri olmayan. Tek.
yekdem: Bir nefes, çok az, çok kısa.
yekdest: Bir elli, tek elli. * Bir çeşit, bir cins. * Eskiden yapılmış bir çeşit rende.
yekdîğer: Bir başkası.
yeke: Yalnız, bir, tek.
yeknesak: Devamlı aynı halde olan. Biteviye. Değişmez bir hal.(Yeknesak istirahat döşeğindeki hayat, hayr-ı mahz olan vücuddan ziyade şerr-i mahz olan ademe yakındır ve ona gider. L.)
yekpa: Tek ayaklı. Topal.
yekpare: Tek parçadan meydana gelen. Bütün. Parçasız.
yekreh: Riyasız, doğru.
yekrîşte: Uygun, muvafık, yaraşır. * şefkatli.
yekru(y): îki yüzlülük yapmayan, riyasız. * Hâlis ve itimad edilir dost.
yekruz: Bir günlük. Geçici, muvakkat.
yeksal: Bir yıllık. Bir yaşında.
yeksan: Beraber. Bir. * Düz. * Her zaman.
yekser: Baştan başa. * Ansızın. * Yalnız başına.
yeksüvare: (C.: Yeksüvârân) Yalnız başına ata binen. * Mc: Arkadaşı olmayan kimse.
yekşebe: Bir gecelik.
yekta: Tek, yalnız, eşsiz. * Bir kat.
yektene: Tenha, yalnız başına.
yekûn: Toptan, hepsi. Netice. Toplam. (Arapçada; olur-oluyor mânâsınadır)
yekvücud: Tek kişi gibi. Hep birden.
yekzeban: Söz birliği. Ağız birliği. Sözde beraberlik. * Aynı dili konuşan. Bir dilde.
yel: (C.: Yelân) Pehlivan. şampiyon.
yelan: (Yel. C.) şampiyonlar, pehlivanlar.
yelda: Uzun.
yele: Kuvvetle saldıran. * Otlağa salınmış hayvan sürüsü. * Koşan, koşucu, seğirten. * Bazı hayvanların ensesindeki kıllar.
yeleb: Beyaz deve. * Polat demir. * Toplamak, cem'etmek. * Deriden yapılmış cübbe, zırh ve gömlek. * Kalkan.
yelek(a): Her nesnenin beyazı. * Beyaz keçi.
yelel: üst dişlerin kısa olması.
yelem: Aslâ yemişi olmayan sert ve katı ağaç.
yelemlem: Deri. * Bir yerin adı. (Yemenliler ihramı orada giyerler.)
yelended: Etli, semiz kimse.
yelma': Yalancı. * Serap.
yelmek: (C.: Yelâmık) Kalın kaftan.
yelpez : Yelpaze. * Serinletmek için el ile havalandırma âleti.
yeltenmek:iBir şeye başlamağa niyet etmek. Teşebbüse kalkışmak. özenmek. Taklide çalışmak.
yemame: Ehli güvercin.
yemen: Arap diyarında bir vilayet ismi.
yemhur: Uzun boylu adam. * ît sineği.
yemîn: Sözü Allah'ı (C.C.) zikrederek kuvvetlendirmek. Kasem. * El tutuşarak, Allah'a bağlılıklarını bildirerek, Allah'a ve birbirlerine söz vererek ahitleşmek. * Mübarek. * Sağ taraf, sağ el.
yemîn-î lâğv: Alışkanlıkla veya dil sürçmesiyle veya sehven yapılan yemindir (ki; şer'an kefâret lâzım gelmez).
yemm: Deniz, bahir, derya, umman. * Güvercin kuşu.
yen': Yemişin olgunlaşması.
yenabî': (Yenbu'. C.) Kaynaklar, pınarlar, çeşmeler. * Kedi yavruları.
yenabî'-î ulûm: îlim kaynakları, çeşmeleri.
yenarik: Yassı bilezik.
yenbagî: Münasib, uygun, şâyân. Lâzımgelir, icab eder, gerekir.
yenbu': (C.: Yenâbi) Pınar, kaynak. * Kedi yavrusu.
yenbub: Dikenli bir ağaç.
yengeç:içok ayaklı ve yan yan yürüyen, başının iki tarafında iki kıskacı olan deniz veya durgun sularda yaşayan bir küçük hayvan.
yenhub: Korkak.
yenme: (C.: Yünem) Bir nevi ot.
yera: (Yerâa. C.) Yontulmamış kamış kalemler. Kamışlar. * Ateşböcekleri.
yera': Sığır buzağısı.
yeraa: (C.: Yerâ) Kamış düdük. * Yontulmamış kalem.
yerabî': (Yerbu'. C.) Tarla fareleri.
yerbu': (C.: Yerabi') Arap tavşanı adı verilen yaban faresi.
yerekan: Sarılık hastalığı. * Ekin âfetlerinden bir âfet.
yerer: Katı ve sert nesne.
yerhamükümullah: "Allah (C.C.) size rahmet ve merhamet eylesin" meâlinde dua olup, aksıran kimseye söylenmesi sünnettir. (Bak: Teşmiyet)
yerhum: Erkek kartal.
yerku': şiddetli açlık.
yerma': (C.: Yerâmi) Alçı taşı.
yerun: Ağu, zehir. * Aygır suyu.
ye's: Emelinden kesilmek. ümidsizlik. Nevmid olmak. Matlubunun hâsıl olmasına ümidini kesmek.(Arkadaş! Amele ve taate muvaffak olmayan azaptan korka, ye'se düşer. Böyle me'yusun gözüne, dini mes'elelere münafi edna ve zayıf bir emare, kocaman bir bürhan görünür. Böyle birkaç emareyi elde eder etmez; diğer emarelerin saikasıyla ilân-ı isyan ederek îslâm dairesinden çıkar, şeytanın ordusuna iltihak eder. M.N.) (Bak: Ucb)
ye's-aver: ümitsizlik veren. Me'yus eden.
ye's-efza: Kederi, ye'si ve elemi artıran.
yesag: Kanun, nizam. * Yasak.
yesar: Sol, sol el. * Varlık, zenginlik. * Gençlik. * Bolluk. * Kolaylık.
yesaret: Zenginlik. * Kolaylık.
yesarî: Sola ait. Sol ile alâkalı.
yesbehun: Yüzerler. (manasında)
yeser: Kolaylık, sühulet. * Birinin sağ tarafından gelme. * Yün, ip gibi şeyleri bükme.
yesîr: Az şey, az, kalil. * Kumarbaz. * Kolay.
yesr: öldürmek.
yesrîb: Medine-i Münevvere'nin müslümanlıktan evvelki ismi. (Bak: Medine)
yessîr: Kolaylaştır (meâlinde duâ).
yesteur: Medine yakınında bir yer. * Deve sağrısına yapılan palas. * Belâ. * Bâtıl. * Misvak ağacı.
yesur: Kumarbaz.
yeşb (yeşf-yeşm): Yeşim denilen taş.
yeşk: Köpek dişi adı verilen sivri diş.
yetama: (Yetim. C.) Yetimler. Babaları ölmüş çocuklar.
yetem: (Bak: Yütm)
yetîm: Babası ölmüş olan çocuk. * Tek, eşsiz, yalnız. (çocuk baliğ olduktan sonra yetimlik ondan kalkar. Anası ölene ise daha çok öksüz denir.)
yetîm-hâne: Yetim çocukların bakılıp beslendiği yer.
yetîm-üt tarafeyn: Anası ve babası ölmüş çocuk. Anadan babadan yetim kalmış çocuk.
yetîme: Yetim kız. * Eşsiz.
yetn: Doğum ânında çocuğun ayaklarının evvel çıkması.
yetu': Sütleğen otu.
yeuk: Nuh Aleyhisselâm'ın kavminin putlarından bir putun ismi.
yeus: (Ye's. den) ümitsiz, ümidi kesilmiş, me'yus.
yevm: Gün. Yirmidört saatlik zaman. * Sene. * Asır. Devir. * Devre.
yevm-î fasl: însanların kısım kısım ayrıldığı ve davalarının halledildiği kıyamet günü. Bundan başka kıyamet gününe aşağıdaki isimler de verilir: Yevm-ül cem', yevm-ül cevab, yevm-ül cezâ, yevm-üd din, yevm-ül ahd, yevm-ül feza-ul ekber, yevm-ül haşr, yevm-ül hisâb, yevm-ül ivaz, yevm-ül karar, yevm-ül karia, yevm-ül kıyam, yevm-ül kıyame, yevm-ül mev'ud, yevm-ül miâd, yevm-ül misak, yevm-ül mizan, yevm-ül va'd, yevm-ül vâkıa, yevm-üs suâl, yevm-ül arz.
yevm-î mîsak: Sözleşilen gün. * Kıyâmet Günü.
yevm-î nüşur: Kıyamet günü, mahşer günü. Herkesin amel defterinin açılıp neşredilip gösterileceği gün.
yevm-î şevk: şaban-ı şerifin otuzuncu günü. Ramazan olması zannedilip ancak hilâl görülmedikçe oruç tutulması münasib olmayan gün.
yevm-î tenad: Kıyamet günü.
yevm-îd dîn: Din günü, ceza günü, mâneviyat günü.(...Nasıl dünya; maddiyat ve maddi harekâtın ve amellerin günüdür. Elbette o harekâtın neticelerini ve o hizmetlerinin ücretlerini ve o maneviyatın semeratlarını, belki o fâniyat ve zailâtın bâki ve dâimi eserlerini ve âlem-i misal sinemasıyla ve fotoğrafıyla alınan umum o fâniyat ve zaillerin sahife-i amellerini gösterecek ve neşredecek bir gün gelecektir, diye ifade ediliyor. E.L.)
yevm-ül fetîh: Fetih günü. * Mekke-i Mükerreme'nin fethi.
yevm-ül hamîs: Perşembe günü. Beşinci gün.
yevm-ül hulud: Kıyamet günü.
yevm-ül huruc: Kıyamet günü.
yevm-ün nahr: Zilhiccenin onuncu günü.
yevm-üt telâkî: Kıyamet günü. Ruz-u mahşer.
yevmen fe yevmen: Günden güne, gittikçe.
yevmî: Günlük. Güne ait.
yevmîye: Gündelik. Bir günlük çalışmanın neticesi alınan ücret. * Günlük hadiseleri günü gününe kaydetmeğe yarıyan defter, gazete.
yez: Bağ, bahçe, tarla vs. gibi arazilerin etrafına çekilen dikenli çalı. çit.
yezdan: Cenab-ı Hak. * (Mecusilerce): Hayırları yaratan hayır ilâhı dedikleri mevhum mâbud.
yezdanî: îlâhi. Yezdan'a ait ve müteallik.
yezek: Bekçi, gece bekçisi.
yezîd: (Hi: 26-64) Hz. Muaviye'nin (R.A.) oğlu ve Emeviye Devletinin ikinci halifesi. şam'da doğdu. Zamanında Kerbelâ hâdise-i elimesi meydana geldi.
yezîd bîn ebî süfyan: Ebu Süfyan'ın oğlu. Hz. Muaviye'nin büyük kardeşi idi. Ashab-ı kiramdan ve çok sâlih bir zât olup, Mekke-i Mükerreme'nin fethinde müslüman oldu. Hazret-i Ebu Bekir-is Sıddık Radıyallâhü anh'ın şam'a gönderdiği orduda bir birliğin kumandanı idi. Hz. ömer zamanında Filistin valisi olmuştu. Taundan vefat eyledi. (R.A.)
yoga: Bâtıl Hind felsefe sistemi. Bunlar tam bir dalgınlık ve hareketsizlik ile ve çile çekmekle gayelerine ulaşacaklarını sanarlar.
yogî: Hindistan'da çilecilere (yogalara) verilen isim.
yol-daş: Yol arkadaşı.
yordam:iEdâ. * Alâyiş, tantana, debdebe. * Meleke, çalım, çeviklik, alışkanlık, yatkınlık. çabukluk.
yorum: Uydurma bir kelimedir. (Bak: Tefsir)
yorumlamak: (Bak: Tefsir etmek)
yuce: Damla, katre.
yuda: Hz. îsa'nın (A.S.) havarilerindendir ve onu ihbar edip ihanet etmiştir. Yehuda veya Yuda şem'un da denir. (Ol hangi acib sır ki, çıkar göklere îsa. Kimdir çekilen çarmıha, kimdir yine Yuda. E.L.)
yûdlûn: Tarhun otu.
yug: Boyunduruk.
yuh: (Yuhâ) Güneşin isimlerindendir. * Türkçede, birisine karşı hakaret için söylenen kelimedir. Kalabalıkla haykırılan hakaret kelimesidir. Buna "yuha çekmek" denir.
yuhanna: Hz. îsa'nın (A.S.) havarilerinden birisidir. încillerden birisini yazmıştır. îbranicede Yahya mânasına gelir. Yuhannes, Ohannes, Con (Fr.: Jan) denir.
yunus (a.s.): Beni îsrail peygamberlerinden ve Kur'an-ı Kerim'de bahsi geçenlerdendir. Elyesa (A.S.) dan sonra Ninova şehrine gönderildi. şehir ahalisi kendisine itaat etmediği için müteessir olarak bir gemiye binmiş ve oradan denize atılmış. Cenab-ı Haktan emir almadan şehri terk ettiğinden bu hâl başına gelmişti. Büyük bir balık onu yuttu. Hz. Yunus tam bir iltica ile Allah'a dua etti ve balık onu gece, bir sahil kenarına bırakıverdi. Sıhhat bularak tekrar Ninova şehrinde ahkâm-ı îlâhiyeyi tebliğe devam etti.(îşte Hz. Yunus Aleyhisselâm'ın birinci vaziyetinden yüz derece daha müdhiş bir vaziyetteyiz. Gecemiz istikbaldir. îstikbalimiz nazar-ı gafletle onun gecesinden yüz derece daha karanlık ve dehşetlidir. Denizimiz şu sergerdan küre-i zeminimizdir. Bu denizin her mevcinde binler cenaze bulunuyor. Onun denizinden bin derece daha korkuludur. Bizim heva-yı nefsimiz hutumuz (balığımız) dur. Hayat-ı ebediyemizi sıkıp mahvına çalışıyor. Bu hut, onun hutundan bin derece daha muzırdır. çünkü onun hutu yüz senelik bir hayatı mahveder, bizim hutumuz ise yüz milyon seneler hayatın mahvına çalışıyor. Madem hakiki vaziyetimiz budur biz de Hazret-i Yunus'a (A.S.) iktidâen umum esbabdan yüzümüzü çevirip, doğrudan doğruya Müsebbib-ül Esbab olan Rabbimize iltica edip "Lâ ilâhe illâ ente sübhaneke inni küntü minezzâlimin" demeliyiz. L.)
yunus emre: (Vefat Mi: 1320) Porsuk Nehri'nin Sakarya'ya döküldüğü yere yakın Sarıköy'de doğduğu söylenir. Tasavvufi halk edebiyatının veli şâiri olan Yunus Emre, yaşadığı devirde halk tabakasını irşad ve tenvir etmiştir. Bir çok memleketleri ve bu arada Konya, şam ve Azerbeycan'ı dolaştı. Konya'da Mevlâna ile görüştü. Risalet-in Nasuhiye isminde Mesnevi tarzında bir eser yazdı. şiirleri daha sonra "Divan" adlı bir kitapta toplandı.Mevcudattaki her zerrede Cenab-ı Hakk'ın varlık ve birliğini okutturan Bediüzzaman Said Nursi Hazretleri, bir eserinde, sinek kanadının hârika san'atından, tevhide delil ve alâmet olduğundan bahsederken şöyle der:"- Bir sineğin kanadı, vücudu ne kadar hârika bir san'at-ı Rabbaniye olduğuna lâtifâne bir işaret olarak meşhur Yunus Emre'nin bu fıkrası ne güzel bildirir:Bir sineğin kanadın, kırk kağnıya yüklettim. Kırkı da çekemedi, şöyle kaldı yazılı..."
yunus suresî: Kur'an-ı Kerim'in 10. suresidir. Mekkidir.
yusuf (a.s.): Hz. Yakub'un (A.S.) oniki oğlundan en küçüğü idi. Babası kendisini çok severdi. Gördüğü bir rüyayı babası tabir ederek peygamber olacağını ve bütün kardeşlerinin kendisine itaat edeceklerini söyledi. Kardeşleri kendisini kıskandıkları için bir hile ile izini kaybetmek istediler ve bir kuyuya attılar. Oradan Mısır'a giden kervancılar aldılar. Mısır'da köle diye sattılar. Sarayda Mısır Maliye Nâzırı'nın yanında hizmet ederdi. Güzelliği, temizliği dillere destan oldu. Mısır Azizi'nin karısı Zeliha'nın iftirasına uğrayarak bir müddet hapiste, zindanda kaldı. Orada peygamberlikle müşerref oldu. Mısır Meliki'nin gördüğü rüyayı en sahih olarak Hz. Yusuf (A.S.) tabir ederek bir müddet sonra hapisten çıktı. Rüyadaki tabir gibi yedi sene bolluk oldu. Ve ondan sonra da yedi sene kıtlık başlamıştı. Hz. Yusuf da Hazine Nâzırı tayin edildi. Her taraftan mahsul, yiyecek almağa gelirlerdi. Kenan illerinde hasta ve Yusufuna ağlamakla gözleri görmez olan Hz. Yakub'un evlâdları da mahsul almak için geldiler. Hz. Yusuf evvelâ onları tanımazdan geldi, sonra onlara iyilik etti ve babalarını da Mısır'a davet etti. Yusuf'un gömleğini gözüne sürmekle Hz. Yakub'un gözleri de açılmıştı. Yusuf (A.S.) Mısır'a aziz oldu, Zeliha ile evlendi. Kardeşleri, babası da Mısır'a davet edildi ve mes'udane bir hayata kavuştular. Kısas-ı Enbiya)(Hz. Yusuf (kendisi) Cenab-ı Hak'tan vefatını istedi ve vefat etti. O saadete mazhar oldu. Demek o dünyevi lezzetli saadetten daha cazibedar bir saadet ve ferahlı bir vaziyet, kabrin arkasında vardır ki, Hazret-i Yusuf Aleyhisselâm gibi hakikatbin bir zat, o gayet lezzetli dünyevi vaziyet içinde, gayet acı olan mevti istedi, tâ öteki saadete mazhar olsun...îşte Kur'an-ı Hakim'in şu belâgatına bak ki, Kıssa-i Yusuf'un hâtimesini ne suretle haber verdi. O haberde dinleyenlere elem ve teessüf değil, belki bir müjde ve bir sürur ilâve ediyor. Hem irşad ediyor ki; kabrin arkası için çalışınız, hakiki saadet ve lezzet ondadır... Hem Hz. Yusuf'un âli sıddıkiyyetini gösteriyor ve diyor: Dünyanın en parlak ve en sürurlu hâleti dahi ona gaflet vermiyor, onu meftun etmiyor, yine âhireti istiyor. M.)
yusuf suresî: Kur'an-ı Kerim'in 12. suresidir. Mekkidir.
yuşa (a.s.) : Hz. Musa'dan (A.S.) sonra peygamber olmuş ve Beni îsrail'i çöllerden kurtarmıştı. Ondan sonra pek çok reisler Yahudilerin idaresinde bulundu, bazan da hâkimsiz kalarak esaret hayatı yaşadılar. Tâ bir müddet sonra îsmail (A.S.) hâkim oldu. Onbir sene Beni îsrail'i idare etti. Sonra içlerinden bir melik olmasını istediler. îsmail (A.S.) Tâlut'u intihab eyledi. Beni îsrail meliklerinin birincisi Tâlut oldu. Tâlut saltanata geçtikten sonra Hz. îsmail'in (A.S.) tedbiri üzere Beni îsrail'den bir ordu tertib etti ve Filistin üzerine yürüdü. Düşmanları Amelika ordusu karşı geldi. Reisleri Câlut meydana çıkıp er istedi. Tâlut tarafından Hz. Dâvut çıktı ve Câlut'u öldürdü. Bir müddet sonra devlete, Beni îsrail'e Hz. Dâvut (A.S.) hâkim oldu. Amelika ile sonradan bir muharebede Tâlut öldü. Dâvut (A.S.) nübüvvetle saltanatı cem' eyledi. Kudüs'ü pay-i taht eyledi. Kırk sene idareyi Musa'nın (A.S.) şeriatı üzerine Beni îsrail'i idare eyledi.
yuz: Kaplanı andırır yırtıcı bir hayvan, pars.
yuze: El açan, dilenci.
yübs: Kuruluk.
yübuset: Kuruluk.
yüdî: (Yed. C.) Eller.
yümkîn: Olabilir, mümkün olur.
yümn: (Yümün) Kuvvetli, uğur, bereket.
yümn-î îman: Kuvvetli imandan gelen bereket ve kuvvet, saadet.
yümna: Sağ taraf, sağ el.
yümne: Yemen alacalarından bir alaca kumaş.
yümnî: Uğura, berekete ait. Uğurlu.
yümum: (Yemm. C.) Denizler.
yürna: Kına.
yüscan: Yeşil taylasanlar.
yüsr (yüsür): Kolaylık. Genişlik. Rahatlık. Zenginlik. Gına. Refah.
yüsra: Sol taraf. Sol el. (Eyser'in müennes)
yüsret: Kolaylık, sühulet. Rahat.
yüsrug: Ot arasında olan kırmızı bir böcek.
yüsur: Ekşi yüzlü olmak.
yüsür: Kolaylık, sühulet, yüsr.
yütm: (Bu kelime esasen infirad mânasına gelir) Bir çocuğun pederi vefat etmekle pedersiz kalması ki: Bu, yalnız insanlara mahsustur. Hayvanatta ise vâlidesiz kalmaya denir. Yetim de denir. (L.R.)
yüus: (Ye's. C.) Yeisler, ümitsizlikler, kederler.